,path,length,frequency,relevant cases,# relevant,participating,# participating,non-participating,# non-participating
0,"(('enter', ('Request For Payment FINAL_APPROVED by SUPERVISOR', 'Request Payment')),)",1,52,"{0, 1, 2, 3, 4, 5, 6, 7, 8, 9, 10, 11, 12, 14, 15, 16, 17, 18, 20, 21, 22, 23, 24, 25, 27, 28, 29, 30, 31, 32, 33, 34, 35, 36, 37, 38, 39, 42, 43, 44, 45, 46, 47, 48, 49, 50, 51, 52, 53, 54, 55, 56, 57, 58, 59, 60, 61, 62, 64, 65, 66, 67, 68, 69, 70, 71, 72, 73, 74, 75, 78, 79, 80, 81, 83, 84, 85, 86, 88, 89, 90, 91, 92, 93, 94, 95, 96, 97, 98, 99, 100, 101, 102, 103, 104, 105, 106, 107, 108, 109, 110, 111, 112, 113, 114, 116, 118, 123, 124, 125, 126, 127, 128, 129, 130, 131, 132, 133, 134, 135, 136, 137, 138, 139, 140, 141, 143, 144, 145, 146, 147, 148, 149, 150, 151, 153, 154, 155, 156, 158, 159, 160, 161, 162, 163, 164, 165, 166, 167, 168, 169, 171, 172, 175, 176, 179, 180, 181, 182, 183, 184, 185, 186, 187, 188, 189, 190, 191, 192, 193, 194, 195, 196, 198, 199, 200, 201, 202, 203, 204, 205, 206, 207, 208, 209, 210, 211, 212, 213, 214, 215, 216, 217, 218, 219, 220, 221, 222, 223, 224, 225, 226, 227, 228, 229, 230, 231, 232, 234, 235, 236, 237, 238, 239, 240, 241, 242, 243, 244, 245, 246, 247, 248, 249, 250, 251, 252, 253, 254, 256, 257, 258, 259, 260, 261, 262, 263, 264, 265, 266, 267, 268, 269, 271, 272, 273, 274, 275, 276, 277, 278, 279, 280, 281, 282, 283, 284, 285, 286, 287, 288, 289, 290, 291, 292, 293, 294, 295, 296, 297, 298, 300, 301, 302, 303, 305, 307, 310, 311, 312, 313, 314, 315, 316, 317, 318, 321, 322, 323, 324, 325, 326, 327, 331, 332, 333, 334, 335, 336, 337, 338, 339, 340, 341, 342, 343, 344, 345, 346, 348, 349, 350, 351, 352, 353, 356, 357, 358, 359, 360, 361, 362, 363, 364, 365, 366, 367, 368, 369, 370, 372, 373, 375, 376, 377, 378, 379, 380, 382, 383, 384, 385, 386, 387, 388, 389, 390, 391, 392, 393, 394, 395, 396, 397, 398, 399, 400, 401, 402, 403, 404, 405, 406, 407, 408, 409, 410, 411, 414, 415, 416, 417, 418, 419, 420, 421, 422, 423, 424, 425, 426, 427, 428, 429, 430, 431, 433, 434, 435, 436, 437, 438, 439, 440, 441, 443, 444, 445, 446, 447, 449, 450, 451, 452, 453, 454, 456, 457, 458, 459, 460, 461, 462, 463, 464, 466, 467, 468, 469, 470, 471, 473, 474, 475, 476, 477, 478, 479, 481, 482, 483, 484, 486, 487, 488, 489, 490, 491, 492, 493, 494, 495, 496, 497, 498, 499, 500, 501, 502, 503, 504, 505, 506, 508, 509, 510, 511, 512, 513, 514, 515, 516, 518, 519, 520, 521, 522, 523, 524, 525, 526, 527, 528, 530, 531, 533, 534, 535, 536, 537, 538, 539, 540, 541, 542, 543, 544, 545, 546, 547, 548, 549, 550, 551, 552, 553, 554, 555, 556, 557, 558, 559, 560, 561, 562, 563, 565, 566, 567, 568, 569, 570, 571, 572, 573, 574, 575, 576, 577, 578, 580, 582, 583, 584, 585, 586, 590, 591, 593, 594, 596, 597, 598, 599, 600, 601, 602, 603, 604, 605, 606, 607, 608, 610, 611, 612, 613, 614, 616, 617, 618, 620, 621, 622, 623, 624, 625, 626, 627, 628, 629, 631, 632, 633, 634, 635, 636, 637, 638, 639, 640, 641, 642, 643, 644, 645, 646, 647, 648, 649, 650, 651, 652, 653, 654, 655, 656, 657, 658, 659, 660, 661, 662, 663, 664, 665, 666, 667, 668, 669, 670, 671, 672, 673, 674, 675, 676, 677, 678, 679, 680, 681, 682, 683, 684, 685, 686, 687, 688, 689, 690, 693, 695, 696, 697, 698, 699, 700, 701, 702, 703, 704, 705, 706, 707, 708, 709, 710, 711, 712, 713, 714, 715, 716, 717, 718, 719, 720, 721, 722, 723, 724, 725, 726, 727, 728, 729, 730, 731, 732, 733, 734, 735, 736, 737, 738, 739, 740, 741, 742, 743, 744, 745, 746, 748, 749, 750, 751, 752, 753, 754, 755, 756, 757, 758, 759, 760, 761, 762, 763, 764, 765, 766, 767, 768, 769, 770, 771, 773, 774, 775, 776, 777, 778, 779, 780, 781, 782, 783, 784, 785, 786, 787, 788, 789, 790, 791, 792, 794, 795, 796, 797, 798, 799, 800, 801, 802, 803, 804, 805, 806, 807, 808, 809, 810, 811, 812, 813, 814, 815, 816, 817, 819, 820, 821, 824, 825, 826, 828, 829, 830, 831, 832, 833, 834, 835, 836, 837, 838, 839, 840, 841, 842, 843, 844, 845, 846, 847, 848, 849, 850, 851, 852, 854, 855, 856, 857, 858, 859, 860, 861, 862, 864, 865, 866, 867, 868, 869, 870, 871, 872, 873, 874, 875, 876, 877, 878, 879, 880, 881, 882, 883, 884, 885, 886, 887, 888, 889, 890, 891, 892, 893, 894, 895, 896, 897, 898, 899, 900, 901, 902, 903, 904, 905, 906, 907, 908, 909, 910, 911, 912, 913, 914, 915, 916, 917, 918, 919, 920, 921, 922, 923, 924, 925, 926, 927, 928, 929, 930, 931, 932, 933, 935, 936, 937, 939, 940, 941, 942, 943, 944, 945, 946, 947, 948, 949, 950, 951, 952, 953, 954, 955, 956, 957, 958, 959, 960, 961, 962, 963, 964, 965, 966, 967, 968, 969, 970, 971, 972, 973, 974, 975, 976, 977, 978, 979, 980, 981, 982, 983, 984, 985, 986, 987, 988, 989, 990, 991, 992, 993, 994, 996, 997, 999, 1000, 1001, 1002, 1003, 1004, 1005, 1006, 1007, 1008, 1009, 1010, 1011, 1012, 1013, 1014, 1015, 1016, 1017, 1018, 1019, 1020, 1021, 1022, 1023, 1024, 1025, 1026, 1028, 1029, 1030, 1031, 1032, 1033, 1034, 1035, 1036, 1037, 1038, 1039, 1040, 1041, 1042, 1043, 1044, 1045, 1046, 1047, 1048, 1050, 1051, 1052, 1053, 1054, 1055, 1056, 1057, 1058, 1059, 1060, 1061, 1063, 1064, 1065, 1066, 1067, 1069, 1070, 1071, 1073, 1074, 1075, 1076, 1077, 1078, 1079, 1080, 1081, 1082, 1083, 1085, 1086, 1087, 1088, 1089, 1090, 1092, 1093, 1094, 1095, 1096, 1097, 1098, 1099, 1100, 1101, 1103, 1104, 1105, 1106, 1107, 1108, 1109, 1110, 1111, 1112, 1113, 1114, 1115, 1116, 1117, 1118, 1119, 1120, 1121, 1122, 1123, 1124, 1125, 1126, 1127, 1128, 1129, 1130, 1131, 1132, 1133, 1134, 1135, 1136, 1137, 1138, 1140, 1141, 1142, 1143, 1144, 1145, 1146, 1147, 1148, 1149, 1150, 1151, 1152, 1153, 1154, 1155, 1156, 1157, 1158, 1159, 1160, 1161, 1162, 1163, 1165, 1166, 1167, 1168, 1169, 1170, 1171, 1172, 1173, 1174, 1175, 1176, 1177, 1178, 1179, 1180, 1181, 1182, 1183, 1184, 1185, 1186, 1187, 1188, 1189, 1190, 1191, 1192, 1193, 1194, 1195, 1196, 1197, 1198, 1199, 1200, 1201, 1202, 1203, 1204, 1205, 1206, 1207, 1208, 1209, 1210, 1211, 1212, 1213, 1214, 1215, 1216, 1217, 1218, 1219, 1220, 1221, 1222, 1223, 1224, 1225, 1226, 1227, 1228, 1229, 1230, 1231, 1232, 1233, 1234, 1235, 1236, 1237, 1238, 1239, 1240, 1241, 1242, 1243, 1244, 1245, 1246, 1247, 1248, 1249, 1250, 1251, 1252, 1253, 1254, 1255, 1258, 1259, 1260, 1262, 1263, 1264, 1265, 1267, 1268, 1269, 1270, 1271, 1272, 1273, 1274, 1275, 1276, 1277, 1278, 1279, 1280, 1281, 1282, 1283, 1284, 1285, 1286, 1287, 1288, 1289, 1290, 1291, 1292, 1293, 1294, 1295, 1298, 1299, 1300, 1301, 1302, 1303, 1304, 1305, 1306, 1307, 1308, 1309, 1310, 1311, 1313, 1314, 1315, 1316, 1317, 1318, 1320, 1321, 1323, 1324, 1325, 1326, 1327, 1328, 1329, 1330, 1331, 1332, 1333, 1334, 1335, 1336, 1337, 1338, 1339, 1340, 1342, 1343, 1344, 1345, 1346, 1347, 1348, 1349, 1350, 1351, 1352, 1353, 1354, 1355, 1356, 1357, 1358, 1359, 1360, 1361, 1362, 1364, 1365, 1366, 1367, 1368, 1369, 1370, 1371, 1372, 1373, 1374, 1375, 1376, 1377, 1378, 1379, 1380, 1381, 1382, 1383, 1384, 1385, 1386, 1387, 1388, 1389, 1390, 1391, 1392, 1393, 1394, 1395, 1396, 1397, 1399, 1400, 1401, 1402, 1403, 1404, 1405, 1406, 1407, 1408, 1409, 1410, 1411, 1412, 1413, 1414, 1415, 1416, 1418, 1419, 1420, 1421, 1422, 1423, 1424, 1426, 1427, 1428, 1429, 1430, 1431, 1432, 1433, 1434, 1435, 1436, 1437, 1439, 1440, 1441, 1442, 1443, 1445, 1446, 1447, 1448, 1449, 1450, 1451, 1452, 1453, 1454, 1455, 1456, 1457, 1458, 1459, 1460, 1461, 1462, 1464, 1465, 1466, 1467, 1468, 1469, 1470, 1471, 1472, 1473, 1474, 1475, 1476, 1477, 1478, 1479, 1481, 1482, 1483, 1484, 1485, 1487, 1488, 1489, 1491, 1492, 1493, 1494, 1495, 1496, 1499, 1500, 1501, 1502, 1503, 1504, 1505, 1506, 1507, 1508, 1509, 1510, 1511, 1512, 1513, 1514, 1515, 1516, 1517, 1518, 1519, 1520, 1521, 1522, 1523, 1524, 1525, 1526, 1527, 1528, 1529, 1530, 1531, 1532, 1533, 1534, 1535, 1536, 1538, 1539, 1540, 1541, 1542, 1543, 1544, 1545, 1546, 1548, 1549, 1550, 1551, 1552, 1553, 1554, 1556, 1557, 1558, 1559, 1560, 1561, 1562, 1563, 1564, 1565, 1566, 1567, 1568, 1569, 1570, 1571, 1572, 1573, 1574, 1575, 1576, 1577, 1578, 1579, 1580, 1581, 1582, 1583, 1584, 1585, 1586, 1587, 1588, 1589, 1590, 1591, 1592, 1593, 1594, 1595, 1596, 1597, 1598, 1599, 1600, 1601, 1602, 1603, 1604, 1605, 1606, 1607, 1608, 1609, 1610, 1612, 1613, 1614, 1615, 1616, 1617, 1618, 1619, 1620, 1621, 1622, 1623, 1624, 1625, 1626, 1627, 1628, 1629, 1630, 1631, 1632, 1633, 1634, 1635, 1636, 1637, 1638, 1639, 1640, 1641, 1642, 1643, 1644, 1645, 1646, 1647, 1648, 1649, 1650, 1651, 1652, 1653, 1654, 1655, 1656, 1657, 1658, 1659, 1660, 1661, 1662, 1663, 1664, 1665, 1666, 1667, 1668, 1669, 1670, 1671, 1672, 1673, 1674, 1675, 1676, 1678, 1679, 1680, 1681, 1682, 1683, 1684, 1685, 1686, 1687, 1688, 1689, 1690, 1691, 1692, 1693, 1694, 1695, 1696, 1697, 1698, 1699, 1700, 1701, 1702, 1703, 1704, 1705, 1706, 1707, 1708, 1709, 1710, 1711, 1712, 1713, 1714, 1715, 1716, 1717, 1718, 1719, 1720, 1721, 1722, 1723, 1724, 1725, 1726, 1727, 1728, 1729, 1730, 1731, 1732, 1734, 1735, 1736, 1737, 1738, 1739, 1740, 1741, 1742, 1743, 1744, 1745, 1746, 1747, 1748, 1749, 1752, 1753, 1754, 1755, 1756, 1757, 1758, 1759, 1760, 1761, 1762, 1764, 1765, 1766, 1767, 1768, 1769, 1770, 1771, 1772, 1773, 1774, 1775, 1776, 1778, 1779, 1780, 1781, 1782, 1783, 1784, 1785, 1786, 1787, 1788, 1789, 1790, 1791, 1792, 1793, 1795, 1796, 1797, 1798, 1799, 1800, 1801, 1802, 1803, 1804, 1805, 1806, 1807, 1808, 1809, 1810, 1811, 1812, 1813, 1814, 1815, 1816, 1817, 1818, 1819, 1820, 1821, 1822, 1823, 1824, 1825, 1826, 1827, 1828, 1829, 1830, 1831, 1832, 1833, 1834, 1835, 1836, 1837, 1838, 1839, 1840, 1841, 1842, 1843, 1844, 1845, 1846, 1847, 1848, 1849, 1850, 1851, 1852, 1853, 1854, 1855, 1857, 1858, 1859, 1860, 1861, 1862, 1863, 1864, 1865, 1866, 1867, 1868, 1869, 1870, 1871, 1872, 1873, 1874, 1875, 1876, 1877, 1878, 1879, 1880, 1881, 1882, 1883, 1884, 1885, 1886, 1887, 1888, 1889, 1890, 1891, 1892, 1893, 1894, 1895, 1896, 1897, 1898, 1899, 1900, 1901, 1902, 1903, 1904, 1905, 1907, 1908, 1909, 1910, 1911, 1912, 1914, 1915, 1916, 1918, 1919, 1920, 1921, 1922, 1923, 1924, 1925, 1926, 1927, 1928, 1929, 1930, 1931, 1932, 1934, 1936, 1937, 1938, 1939, 1940, 1941, 1942, 1943, 1944, 1945, 1946, 1947, 1948, 1949, 1950, 1951, 1952, 1954, 1955, 1956, 1957, 1958, 1959, 1960, 1961, 1962, 1963, 1964, 1965, 1966, 1967, 1968, 1969, 1970, 1971, 1972, 1973, 1974, 1975, 1976, 1977, 1978, 1979, 1980, 1981, 1982, 1983, 1984, 1985, 1986, 1987, 1988, 1990, 1991, 1992, 1993, 1994, 1995, 1996, 1997, 1998, 1999, 2000, 2001, 2002, 2003, 2004, 2005, 2006, 2007, 2008, 2009, 2010, 2011, 2012, 2014, 2015, 2016, 2017, 2018, 2019, 2020, 2021, 2022, 2023, 2024, 2025, 2026, 2027, 2028, 2029, 2030, 2031, 2032, 2033, 2034, 2035, 2036, 2037, 2038, 2039, 2040, 2041, 2042, 2043, 2044, 2045, 2046, 2047, 2049, 2050, 2051, 2052, 2053, 2055, 2056, 2057, 2058, 2059, 2060, 2061, 2062, 2063, 2064, 2065, 2066, 2067, 2068, 2069, 2070, 2071, 2073, 2074, 2075, 2076, 2077, 2079, 2080, 2081, 2082, 2083, 2084, 2085, 2086, 2087, 2088, 2089, 2090, 2091, 2092, 2094, 2095, 2096, 2097, 2098, 2099, 2100, 2101, 2102, 2103, 2104, 2106, 2107, 2108, 2109, 2110, 2111, 2112, 2113, 2114, 2115, 2116, 2117, 2118, 2119, 2120, 2121, 2122, 2123, 2124, 2125, 2126, 2128, 2129, 2130, 2131, 2132, 2133, 2134, 2135, 2137, 2138, 2139, 2140, 2141, 2142, 2143, 2144, 2146, 2147, 2148, 2149, 2150, 2151, 2152, 2153, 2154, 2155, 2156, 2157, 2158, 2159, 2160, 2161, 2162, 2163, 2164, 2166, 2167, 2168, 2169, 2170, 2171, 2172, 2173, 2174, 2175, 2176, 2177, 2178, 2179, 2180, 2181, 2182, 2183, 2184, 2185, 2186, 2187, 2188, 2189, 2190, 2191, 2192, 2193, 2194, 2195, 2196, 2197, 2198, 2200, 2201, 2202, 2203, 2204, 2205, 2206, 2207, 2208, 2209, 2210, 2211, 2212, 2213, 2214, 2215, 2216, 2217, 2218, 2219, 2220, 2221, 2222, 2223, 2224, 2225, 2226, 2228, 2229, 2230, 2231, 2232, 2233, 2234, 2235, 2236, 2237, 2239, 2240, 2241, 2242, 2243, 2244, 2245, 2246, 2247, 2248, 2249, 2250, 2251, 2252, 2253, 2254, 2255, 2259, 2260, 2261, 2262, 2263, 2264, 2265, 2266, 2267, 2268, 2269, 2270, 2271, 2272, 2273, 2274, 2275, 2276, 2277, 2280, 2281, 2282, 2283, 2284, 2285, 2287, 2288, 2289, 2290, 2291, 2292, 2293, 2294, 2295, 2296, 2297, 2298, 2299, 2300, 2301, 2302, 2303, 2304, 2305, 2306, 2307, 2309, 2310, 2311, 2312, 2313, 2315, 2316, 2317, 2318, 2319, 2320, 2321, 2322, 2323, 2324, 2325, 2327, 2328, 2329, 2330, 2331, 2332, 2333, 2334, 2335, 2336, 2337, 2338, 2339, 2340, 2341, 2342, 2344, 2345, 2346, 2347, 2348, 2349, 2350, 2351, 2352, 2353, 2354, 2355, 2356, 2357, 2358, 2359, 2360, 2361, 2362, 2363, 2364, 2365, 2366, 2367, 2368, 2369, 2370, 2371, 2373, 2374, 2375, 2376, 2377, 2378, 2379, 2380, 2381, 2382, 2383, 2384, 2385, 2386, 2387, 2388, 2389, 2390, 2391, 2392, 2393, 2394, 2395, 2396, 2397, 2398, 2399, 2401, 2402, 2403, 2404, 2405, 2406, 2407, 2408, 2409, 2410, 2411, 2412, 2413, 2414, 2415, 2416, 2419, 2420, 2421, 2422, 2423, 2424, 2425, 2426, 2427, 2428, 2429, 2430, 2431, 2432, 2433, 2434, 2435, 2436, 2437, 2438, 2439, 2440, 2441, 2442, 2443, 2444, 2445, 2448, 2449, 2450, 2452, 2453, 2454, 2455, 2456, 2457, 2458, 2459, 2460, 2461, 2462, 2463, 2464, 2465, 2466, 2467, 2469, 2470, 2471, 2472, 2473, 2474, 2475, 2476, 2477, 2478, 2479, 2480, 2481, 2482, 2483, 2484, 2485, 2486, 2487, 2488, 2489, 2490, 2491, 2492, 2494, 2495, 2496, 2497, 2499, 2500, 2501, 2503, 2504, 2505, 2506, 2508, 2509, 2510, 2511, 2512, 2513, 2514, 2515, 2516, 2517, 2518, 2519, 2520, 2521, 2522, 2523, 2524, 2525, 2526, 2527, 2528, 2529, 2530, 2531, 2532, 2533, 2534, 2535, 2536, 2537, 2538, 2540, 2541, 2543, 2544, 2546, 2547, 2548, 2549, 2550, 2551, 2552, 2553, 2554, 2555, 2556, 2557, 2558, 2559, 2560, 2561, 2562, 2563, 2564, 2566, 2567, 2568, 2569, 2570, 2572, 2574, 2575, 2576, 2577, 2578, 2579, 2580, 2581, 2582, 2583, 2584, 2585, 2586, 2587, 2590, 2591, 2592, 2593, 2594, 2595, 2596, 2597, 2598, 2599, 2600, 2601, 2603, 2604, 2605, 2606, 2607, 2608, 2609, 2610, 2611, 2612, 2613, 2614, 2615, 2616, 2617, 2620, 2621, 2622, 2623, 2624, 2625, 2626, 2627, 2628, 2629, 2630, 2631, 2632, 2633, 2635, 2636, 2637, 2639, 2640, 2641, 2642, 2643, 2644, 2645, 2646, 2647, 2648, 2649, 2650, 2652, 2653, 2654, 2655, 2656, 2657, 2658, 2659, 2660, 2662, 2664, 2666, 2667, 2668, 2669, 2671, 2672, 2673, 2674, 2677, 2679, 2680, 2681, 2682, 2683, 2684, 2685, 2686, 2687, 2688, 2689, 2690, 2691, 2692, 2693, 2694, 2695, 2696, 2697, 2698, 2699, 2700, 2701, 2703, 2704, 2705, 2706, 2707, 2708, 2709, 2710, 2711, 2712, 2713, 2715, 2716, 2717, 2718, 2720, 2721, 2723, 2724, 2725, 2726, 2727, 2728, 2729, 2730, 2731, 2732, 2733, 2734, 2735, 2736, 2737, 2738, 2739, 2740, 2741, 2744, 2745, 2746, 2747, 2748, 2749, 2750, 2751, 2753, 2754, 2755, 2756, 2757, 2758, 2759, 2760, 2761, 2762, 2763, 2764, 2765, 2766, 2768, 2769, 2770, 2771, 2772, 2773, 2774, 2775, 2776, 2777, 2779, 2780, 2782, 2783, 2784, 2785, 2786, 2787, 2789, 2790, 2791, 2792, 2793, 2794, 2795, 2796, 2797, 2798, 2799, 2800, 2801, 2802, 2803, 2804, 2805, 2806, 2807, 2808, 2809, 2811, 2812, 2813, 2814, 2815, 2816, 2817, 2818, 2819, 2820, 2821, 2822, 2823, 2825, 2826, 2827, 2828, 2830, 2831, 2832, 2833, 2834, 2835, 2836, 2837, 2838, 2839, 2840, 2841, 2842, 2843, 2844, 2845, 2846, 2847, 2848, 2849, 2850, 2851, 2852, 2853, 2854, 2855, 2856, 2857, 2858, 2859, 2860, 2861, 2862, 2863, 2865, 2866, 2867, 2868, 2869, 2870, 2871, 2872, 2873, 2874, 2875, 2877, 2878, 2880, 2883, 2884, 2886, 2887, 2888, 2889, 2890, 2891, 2892, 2893, 2894, 2895, 2896, 2897, 2898, 2899, 2900, 2901, 2902, 2903, 2904, 2905, 2906, 2907, 2908, 2909, 2910, 2911, 2912, 2914, 2915, 2916, 2917, 2918, 2919, 2920, 2921, 2923, 2924, 2925, 2926, 2927, 2930, 2931, 2932, 2933, 2934, 2935, 2937, 2938, 2939, 2940, 2941, 2942, 2943, 2944, 2945, 2946, 2947, 2949, 2950, 2951, 2952, 2953, 2955, 2956, 2957, 2959, 2960, 2961, 2962, 2963, 2965, 2966, 2967, 2968, 2969, 2970, 2971, 2972, 2973, 2974, 2975, 2976, 2977, 2978, 2979, 2980, 2981, 2982, 2983, 2984, 2985, 2986, 2987, 2988, 2989, 2990, 2991, 2992, 2993, 2994, 2995, 2996, 2997, 2998, 2999, 3000, 3001, 3002, 3003, 3004, 3005, 3006, 3007, 3008, 3009, 3010, 3011, 3012, 3014, 3015, 3016, 3017, 3018, 3019, 3020, 3022, 3023, 3024, 3025, 3026, 3027, 3028, 3029, 3030, 3031, 3032, 3033, 3034, 3035, 3036, 3037, 3038, 3039, 3040, 3042, 3043, 3044, 3045, 3046, 3047, 3048, 3049, 3050, 3051, 3052, 3053, 3054, 3055, 3057, 3058, 3059, 3060, 3061, 3062, 3063, 3064, 3065, 3066, 3067, 3068, 3070, 3071, 3072, 3073, 3074, 3075, 3076, 3077, 3079, 3080, 3081, 3082, 3083, 3084, 3086, 3087, 3088, 3089, 3090, 3091, 3093, 3094, 3095, 3096, 3097, 3098, 3099, 3100, 3101, 3102, 3103, 3104, 3105, 3106, 3107, 3108, 3109, 3110, 3111, 3112, 3113, 3114, 3115, 3116, 3118, 3119, 3120, 3121, 3122, 3123, 3124, 3125, 3126, 3127, 3128, 3131, 3132, 3133, 3134, 3135, 3136, 3137, 3138, 3139, 3142, 3143, 3144, 3146, 3147, 3149, 3150, 3151, 3152, 3153, 3155, 3156, 3157, 3158, 3159, 3160, 3162, 3163, 3164, 3165, 3166, 3167, 3169, 3170, 3171, 3172, 3173, 3174, 3175, 3176, 3177, 3178, 3179, 3180, 3181, 3182, 3183, 3184, 3185, 3186, 3187, 3188, 3189, 3190, 3191, 3192, 3193, 3194, 3195, 3196, 3197, 3198, 3199, 3200, 3201, 3202, 3203, 3204, 3205, 3206, 3207, 3208, 3209, 3210, 3211, 3212, 3213, 3214, 3215, 3216, 3217, 3218, 3219, 3222, 3223, 3224, 3225, 3226, 3227, 3228, 3229, 3231, 3232, 3233, 3234, 3236, 3240, 3241, 3242, 3243, 3244, 3245, 3247, 3248, 3249, 3250, 3251, 3252, 3253, 3254, 3255, 3256, 3258, 3259, 3260, 3261, 3262, 3263, 3265, 3269, 3270, 3271, 3272, 3273, 3276, 3277, 3279, 3280, 3281, 3282, 3283, 3284, 3285, 3286, 3287, 3288, 3289, 3291, 3292, 3293, 3294, 3295, 3296, 3298, 3299, 3300, 3301, 3302, 3303, 3304, 3305, 3306, 3307, 3310, 3311, 3312, 3313, 3314, 3316, 3317, 3318, 3319, 3320, 3321, 3322, 3323, 3325, 3326, 3327, 3328, 3329, 3330, 3331, 3332, 3333, 3334, 3335, 3337, 3338, 3339, 3340, 3341, 3342, 3343, 3344, 3345, 3346, 3347, 3349, 3350, 3351, 3352, 3353, 3354, 3355, 3356, 3357, 3358, 3359, 3360, 3362, 3363, 3364, 3366, 3367, 3368, 3369, 3370, 3371, 3372, 3373, 3374, 3375, 3376, 3377, 3378, 3379, 3380, 3381, 3382, 3383, 3384, 3386, 3387, 3388, 3389, 3390, 3391, 3392, 3393, 3394, 3396, 3397, 3398, 3399, 3400, 3401, 3402, 3403, 3404, 3405, 3406, 3407, 3408, 3410, 3411, 3412, 3413, 3414, 3415, 3416, 3417, 3418, 3419, 3421, 3422, 3423, 3424, 3426, 3427, 3428, 3429, 3430, 3431, 3432, 3433, 3434, 3435, 3436, 3437, 3438, 3439, 3440, 3441, 3442, 3443, 3444, 3445, 3446, 3447, 3448, 3449, 3450, 3451, 3452, 3453, 3454, 3455, 3456, 3457, 3459, 3460, 3461, 3462, 3465, 3466, 3467, 3468, 3469, 3470, 3471, 3472, 3473, 3474, 3476, 3477, 3480, 3481, 3482, 3483, 3484, 3485, 3486, 3487, 3488, 3489, 3490, 3491, 3492, 3493, 3494, 3495, 3497, 3498, 3499, 3500, 3501, 3502, 3503, 3504, 3505, 3506, 3507, 3509, 3510, 3511, 3512, 3513, 3514, 3515, 3516, 3519, 3520, 3521, 3522, 3523, 3525, 3526, 3527, 3528, 3529, 3530, 3531, 3532, 3533, 3534, 3535, 3536, 3538, 3539, 3540, 3541, 3542, 3543, 3544, 3545, 3546, 3547, 3548, 3549, 3550, 3551, 3552, 3553, 3556, 3557, 3558, 3562, 3563, 3564, 3565, 3566, 3567, 3568, 3569, 3570, 3571, 3572, 3573, 3574, 3575, 3576, 3577, 3578, 3580, 3581, 3582, 3583, 3584, 3585, 3586, 3588, 3589, 3591, 3592, 3593, 3594, 3595, 3596, 3598, 3599, 3600, 3601, 3602, 3603, 3604, 3605, 3606, 3607, 3608, 3609, 3610, 3611, 3612, 3613, 3614, 3615, 3616, 3617, 3618, 3620, 3621, 3622, 3623, 3624, 3625, 3626, 3627, 3628, 3629, 3630, 3631, 3632, 3633, 3634, 3635, 3636, 3637, 3638, 3639, 3640, 3642, 3644, 3645, 3646, 3647, 3648, 3649, 3650, 3651, 3652, 3653, 3655, 3656, 3657, 3658, 3660, 3661, 3662, 3663, 3664, 3665, 3666, 3667, 3668, 3669, 3670, 3671, 3672, 3673, 3674, 3675, 3676, 3677, 3678, 3679, 3680, 3681, 3682, 3683, 3684, 3685, 3686, 3687, 3688, 3689, 3690, 3691, 3692, 3693, 3694, 3696, 3697, 3698, 3699, 3700, 3701, 3702, 3703, 3704, 3705, 3706, 3707, 3708, 3709, 3710, 3711, 3712, 3713, 3716, 3717, 3718, 3719, 3721, 3722, 3724, 3728, 3729, 3730, 3731, 3732, 3733, 3734, 3735, 3736, 3737, 3738, 3739, 3740, 3743, 3744, 3748, 3749, 3750, 3751, 3752, 3753, 3754, 3756, 3757, 3758, 3759, 3760, 3761, 3762, 3763, 3764, 3765, 3766, 3767, 3768, 3769, 3770, 3772, 3773, 3774, 3775, 3776, 3777, 3778, 3779, 3781, 3782, 3783, 3784, 3785, 3786, 3787, 3788, 3789, 3790, 3791, 3792, 3793, 3794, 3795, 3796, 3797, 3798, 3799, 3800, 3801, 3802, 3803, 3804, 3805, 3806, 3807, 3808, 3809, 3810, 3811, 3812, 3813, 3814, 3815, 3817, 3818, 3819, 3820, 3821, 3822, 3823, 3825, 3826, 3827, 3828, 3829, 3830, 3831, 3832, 3833, 3834, 3835, 3836, 3837, 3838, 3839, 3840, 3841, 3843, 3844, 3845, 3846, 3847, 3848, 3849, 3850, 3851, 3852, 3853, 3854, 3855, 3856, 3857, 3858, 3859, 3860, 3861, 3862, 3863, 3864, 3866, 3867, 3868, 3869, 3870, 3871, 3872, 3873, 3874, 3875, 3877, 3878, 3879, 3880, 3884, 3886, 3887, 3888, 3889, 3890, 3891, 3892, 3893, 3894, 3895, 3896, 3897, 3898, 3899, 3900, 3901, 3902, 3903, 3904, 3905, 3906, 3907, 3908, 3910, 3912, 3913, 3915, 3917, 3918, 3919, 3920, 3921, 3922, 3923, 3924, 3925, 3926, 3927, 3928, 3929, 3930, 3932, 3933, 3934, 3935, 3936, 3937, 3938, 3939, 3940, 3941, 3943, 3944, 3945, 3946, 3947, 3948, 3949, 3950, 3951, 3952, 3953, 3954, 3955, 3956, 3957, 3958, 3959, 3960, 3962, 3963, 3964, 3965, 3966, 3967, 3969, 3972, 3973, 3974, 3975, 3976, 3977, 3978, 3979, 3980, 3981, 3982, 3983, 3984, 3985, 3986, 3987, 3988, 3989, 3990, 3991, 3992, 3993, 3994, 3995, 3996, 3997, 3998, 3999, 4000, 4001, 4002, 4003, 4004, 4005, 4006, 4007, 4008, 4009, 4010, 4011, 4012, 4013, 4014, 4016, 4017, 4018, 4019, 4020, 4021, 4022, 4023, 4024, 4025, 4026, 4027, 4028, 4029, 4030, 4031, 4032, 4033, 4034, 4037, 4038, 4039, 4040, 4041, 4042, 4043, 4044, 4045, 4046, 4047, 4049, 4050, 4053, 4054, 4055, 4056, 4057, 4058, 4059, 4060, 4061, 4062, 4063, 4067, 4068, 4069, 4070, 4071, 4072, 4073, 4074, 4075, 4076, 4077, 4078, 4079, 4080, 4081, 4082, 4083, 4084, 4085, 4086, 4087, 4088, 4089, 4090, 4091, 4092, 4093, 4094, 4095, 4096, 4097, 4098, 4099, 4100, 4101, 4102, 4103, 4104, 4105, 4106, 4107, 4108, 4109, 4111, 4112, 4113, 4114, 4115, 4116, 4117, 4118, 4119, 4120, 4121, 4122, 4123, 4124, 4125, 4126, 4127, 4128, 4129, 4130, 4131, 4132, 4133, 4134, 4135, 4136, 4137, 4138, 4139, 4140, 4141, 4142, 4143, 4144, 4145, 4147, 4148, 4149, 4150, 4151, 4152, 4153, 4154, 4155, 4156, 4157, 4158, 4159, 4160, 4161, 4163, 4164, 4165, 4166, 4167, 4168, 4169, 4170, 4171, 4172, 4173, 4174, 4175, 4176, 4177, 4178, 4179, 4181, 4182, 4183, 4184, 4185, 4186, 4187, 4188, 4189, 4190, 4191, 4192, 4193, 4194, 4195, 4196, 4197, 4198, 4200, 4201, 4202, 4203, 4204, 4205, 4206, 4207, 4208, 4209, 4210, 4211, 4212, 4213, 4214, 4215, 4216, 4217, 4218, 4219, 4221, 4222, 4223, 4224, 4225, 4226, 4227, 4228, 4229, 4230, 4231, 4232, 4233, 4234, 4235, 4237, 4238, 4239, 4240, 4241, 4242, 4243, 4244, 4245, 4246, 4247, 4248, 4249, 4250, 4251, 4252, 4253, 4254, 4255, 4256, 4257, 4258, 4259, 4260, 4261, 4262, 4263, 4264, 4265, 4266, 4267, 4269, 4270, 4271, 4272, 4273, 4275, 4276, 4277, 4278, 4279, 4280, 4281, 4283, 4284, 4286, 4287, 4288, 4289, 4290, 4292, 4293, 4294, 4295, 4297, 4298, 4299, 4300, 4301, 4302, 4303, 4304, 4305, 4306, 4307, 4308, 4309, 4310, 4311, 4312, 4313, 4314, 4315, 4316, 4317, 4318, 4319, 4320, 4321, 4322, 4323, 4325, 4326, 4327, 4328, 4329, 4330, 4331, 4332, 4333, 4334, 4335, 4336, 4337, 4339, 4340, 4341, 4342, 4343, 4344, 4345, 4346, 4347, 4348, 4349, 4350, 4351, 4352, 4353, 4354, 4356, 4357, 4358, 4359, 4361, 4362, 4363, 4364, 4365, 4366, 4367, 4368, 4369, 4370, 4371, 4372, 4373, 4374, 4375, 4376, 4377, 4378, 4379, 4380, 4381, 4382, 4383, 4384, 4385, 4386, 4387, 4388, 4389, 4390, 4391, 4392, 4393, 4394, 4395, 4396, 4397, 4398, 4399, 4400, 4401, 4402, 4403, 4404, 4405, 4406, 4407, 4408, 4409, 4410, 4411, 4412, 4413, 4414, 4415, 4416, 4417, 4418, 4419, 4420, 4421, 4422, 4423, 4424, 4425, 4426, 4427, 4428, 4429, 4430, 4432, 4433, 4434, 4435, 4436, 4437, 4438, 4439, 4440, 4441, 4442, 4443, 4444, 4445, 4446, 4447, 4448, 4449, 4450, 4451, 4452, 4453, 4455, 4456, 4457, 4458, 4459, 4460, 4461, 4463, 4465, 4466, 4467, 4468, 4469, 4471, 4472, 4473, 4474, 4477, 4478, 4479, 4480, 4481, 4482, 4483, 4484, 4485, 4486, 4487, 4488, 4489, 4490, 4491, 4492, 4493, 4494, 4495, 4496, 4497, 4498, 4499, 4500, 4501, 4502, 4503, 4504, 4505, 4506, 4507, 4508, 4509, 4510, 4511, 4512, 4513, 4514, 4515, 4516, 4517, 4518, 4519, 4520, 4521, 4522, 4523, 4524, 4525, 4526, 4527, 4528, 4529, 4530, 4531, 4532, 4533, 4534, 4535, 4536, 4537, 4538, 4539, 4540, 4541, 4542, 4543, 4544, 4545, 4546, 4547, 4548, 4549, 4551, 4552, 4553, 4554, 4555, 4556, 4557, 4558, 4559, 4560, 4561, 4562, 4563, 4564, 4565, 4566, 4567, 4568, 4569, 4570, 4571, 4572, 4573, 4574, 4575, 4576, 4577, 4578, 4579, 4580, 4581, 4582, 4583, 4584, 4585, 4586, 4587, 4588, 4589, 4590, 4591, 4593, 4594, 4595, 4596, 4597, 4598, 4599, 4600, 4601, 4602, 4603, 4604, 4605, 4606, 4607, 4608, 4610, 4611, 4612, 4613, 4614, 4615, 4616, 4618, 4619, 4620, 4621, 4622, 4623, 4624, 4625, 4626, 4627, 4628, 4629, 4630, 4632, 4633, 4634, 4635, 4636, 4637, 4639, 4640, 4641, 4642, 4643, 4644, 4645, 4646, 4647, 4648, 4650, 4651, 4652, 4653, 4654, 4655, 4656, 4657, 4658, 4659, 4660, 4661, 4662, 4663, 4664, 4665, 4666, 4667, 4668, 4669, 4670, 4671, 4672, 4673, 4674, 4675, 4676, 4677, 4678, 4679, 4680, 4681, 4682, 4683, 4684, 4685, 4686, 4687, 4688, 4689, 4690, 4691, 4692, 4693, 4694, 4695, 4696, 4697, 4698, 4699, 4700, 4701, 4702, 4703, 4704, 4705, 4706, 4707, 4708, 4709, 4710, 4711, 4712, 4713, 4715, 4716, 4717, 4718, 4719, 4720, 4722, 4723, 4724, 4725, 4726, 4727, 4728, 4729, 4730, 4731, 4732, 4733, 4734, 4735, 4736, 4737, 4738, 4739, 4740, 4741, 4742, 4743, 4744, 4745, 4746, 4747, 4748, 4749, 4750, 4751, 4752, 4753, 4754, 4755, 4756, 4757, 4758, 4759, 4760, 4761, 4762, 4763, 4764, 4765, 4767, 4768, 4770, 4771, 4772, 4773, 4774, 4775, 4776, 4777, 4778, 4779, 4780, 4781, 4783, 4784, 4785, 4788, 4789, 4790, 4791, 4792, 4793, 4794, 4795, 4796, 4797, 4798, 4799, 4800, 4801, 4802, 4803, 4804, 4805, 4806, 4807, 4808, 4809, 4810, 4811, 4813, 4814, 4815, 4816, 4817, 4818, 4819, 4820, 4821, 4822, 4823, 4826, 4827, 4828, 4829, 4831, 4832, 4833, 4834, 4835, 4836, 4837, 4838, 4839, 4840, 4841, 4842, 4843, 4844, 4845, 4846, 4847, 4848, 4849, 4850, 4851, 4852, 4853, 4854, 4855, 4856, 4857, 4858, 4859, 4860, 4861, 4862, 4863, 4864, 4865, 4866, 4867, 4868, 4869, 4871, 4872, 4873, 4874, 4875, 4876, 4877, 4878, 4879, 4880, 4881, 4882, 4883, 4884, 4885, 4887, 4888, 4889, 4890, 4891, 4892, 4893, 4894, 4895, 4897, 4898, 4899, 4900, 4901, 4902, 4903, 4904, 4905, 4906, 4907, 4908, 4909, 4910, 4911, 4912, 4914, 4915, 4916, 4917, 4918, 4919, 4920, 4921, 4922, 4923, 4925, 4926, 4927, 4928, 4929, 4930, 4931, 4932, 4933, 4934, 4935, 4936, 4937, 4938, 4939, 4940, 4942, 4943, 4944, 4945, 4946, 4947, 4948, 4949, 4950, 4951, 4952, 4953, 4954, 4955, 4956, 4957, 4958, 4959, 4960, 4961, 4962, 4963, 4964, 4965, 4967, 4968, 4969, 4970, 4971, 4972, 4973, 4974, 4975, 4977, 4978, 4979, 4980, 4981, 4982, 4983, 4984, 4986, 4987, 4988, 4989, 4990, 4991, 4993, 4994, 4995, 4996, 4997, 4998, 4999, 5000, 5001, 5002, 5003, 5004, 5005, 5006, 5007, 5009, 5010, 5011, 5012, 5013, 5014, 5015, 5016, 5017, 5018, 5019, 5020, 5021, 5022, 5023, 5024, 5025, 5026, 5027, 5028, 5029, 5031, 5032, 5033, 5034, 5035, 5036, 5037, 5038, 5039, 5040, 5041, 5042, 5043, 5044, 5045, 5046, 5047, 5048, 5049, 5050, 5051, 5052, 5055, 5056, 5057, 5058, 5059, 5060, 5061, 5062, 5063, 5064, 5065, 5066, 5067, 5068, 5069, 5070, 5071, 5072, 5073, 5074, 5075, 5076, 5077, 5078, 5079, 5080, 5081, 5082, 5083, 5084, 5085, 5086, 5087, 5090, 5091, 5092, 5093, 5095, 5096, 5097, 5098, 5099, 5100, 5101, 5102, 5103, 5104, 5105, 5106, 5107, 5108, 5109, 5110, 5111, 5112, 5113, 5114, 5115, 5116, 5117, 5118, 5119, 5120, 5121, 5122, 5123, 5124, 5125, 5126, 5127, 5128, 5129, 5130, 5131, 5132, 5133, 5134, 5135, 5136, 5137, 5138, 5139, 5140, 5141, 5142, 5143, 5144, 5145, 5148, 5149, 5150, 5151, 5152, 5155, 5156, 5157, 5158, 5159, 5160, 5161, 5162, 5163, 5164, 5165, 5166, 5167, 5168, 5169, 5170, 5171, 5172, 5174, 5175, 5176, 5178, 5179, 5181, 5182, 5183, 5185, 5186, 5187, 5188, 5190, 5191, 5192, 5193, 5194, 5195, 5196, 5197, 5198, 5199, 5200, 5201, 5202, 5203, 5204, 5205, 5206, 5207, 5208, 5209, 5210, 5211, 5212, 5213, 5214, 5215, 5216, 5217, 5218, 5219, 5220, 5221, 5224, 5225, 5226, 5229, 5230, 5231, 5232, 5233, 5236, 5237, 5238, 5239, 5240, 5241, 5242, 5243, 5245, 5246, 5247, 5248, 5249, 5250, 5251, 5252, 5253, 5256, 5257, 5258, 5259, 5260, 5261, 5262, 5263, 5264, 5265, 5266, 5267, 5268, 5269, 5270, 5271, 5272, 5273, 5274, 5275, 5276, 5277, 5278, 5279, 5280, 5281, 5282, 5283, 5284, 5285, 5286, 5287, 5288, 5289, 5290, 5291, 5292, 5294, 5295, 5296, 5297, 5298, 5299, 5300, 5301, 5302, 5303, 5304, 5305, 5306, 5307, 5308, 5309, 5310, 5311, 5312, 5313, 5314, 5315, 5316, 5317, 5319, 5320, 5321, 5323, 5324, 5325, 5326, 5327, 5328, 5329, 5330, 5331, 5333, 5334, 5335, 5336, 5337, 5338, 5339, 5340, 5341, 5342, 5343, 5344, 5345, 5346, 5347, 5348, 5350, 5351, 5352, 5353, 5354, 5355, 5356, 5357, 5358, 5359, 5361, 5362, 5363, 5364, 5365, 5366, 5367, 5368, 5369, 5370, 5371, 5372, 5373, 5375, 5376, 5377, 5378, 5379, 5380, 5381, 5383, 5384, 5385, 5386, 5387, 5388, 5389, 5390, 5391, 5392, 5393, 5394, 5396, 5397, 5398, 5399, 5400, 5401, 5402, 5403, 5404, 5405, 5406, 5407, 5408, 5409, 5410, 5411, 5412, 5413, 5414, 5416, 5417, 5418, 5419, 5420, 5422, 5423, 5424, 5425, 5426, 5427, 5428, 5429, 5430, 5431, 5432, 5433, 5434, 5435, 5437, 5438, 5439, 5440, 5441, 5442, 5443, 5444, 5445, 5446, 5447, 5448, 5449, 5450, 5451, 5452, 5453, 5454, 5455, 5456, 5457, 5458, 5459, 5460, 5461, 5462, 5463, 5464, 5465, 5466, 5467, 5468, 5469, 5470, 5471, 5472, 5473, 5474, 5475, 5476, 5477, 5478, 5479, 5480, 5481, 5482, 5483, 5484, 5485, 5486, 5487, 5488, 5489, 5490, 5491, 5492, 5493, 5494, 5495, 5496, 5497, 5498, 5499, 5500, 5501, 5502, 5503, 5504, 5505, 5506, 5507, 5508, 5509, 5510, 5511, 5512, 5513, 5514, 5515, 5516, 5517, 5518, 5519, 5520, 5521, 5522, 5523, 5524, 5525, 5526, 5527, 5529, 5530, 5531, 5532, 5533, 5534, 5535, 5536, 5537, 5538, 5539, 5540, 5541, 5542, 5543, 5544, 5545, 5547, 5548, 5549, 5550, 5551, 5552, 5554, 5555, 5556, 5557, 5558, 5559, 5560, 5561, 5562, 5563, 5564, 5565, 5566, 5567, 5568, 5569, 5570, 5571, 5572, 5573, 5574, 5575, 5576, 5577, 5578, 5579, 5580, 5581, 5582, 5583, 5584, 5585, 5586, 5587, 5588, 5589, 5590, 5591, 5592, 5593, 5594, 5595, 5596, 5597, 5598, 5600, 5601, 5602, 5603, 5604, 5605, 5606, 5607, 5608, 5609, 5610, 5612, 5613, 5614, 5615, 5616, 5617, 5618, 5620, 5622, 5623, 5624, 5625, 5626, 5627, 5628, 5629, 5630, 5631, 5633, 5634, 5635, 5636, 5637, 5639, 5640, 5642, 5643, 5645, 5646, 5647, 5648, 5649, 5650, 5651, 5652, 5653, 5654, 5655, 5656, 5657, 5658, 5659, 5660, 5661, 5662, 5663, 5664, 5665, 5666, 5667, 5668, 5669, 5670, 5671, 5672, 5673, 5674, 5676, 5677, 5678, 5679, 5680, 5681, 5682, 5683, 5684, 5685, 5686, 5688, 5689, 5690, 5691, 5692, 5693, 5694, 5695, 5696, 5697, 5698, 5699, 5700, 5701, 5702, 5703, 5704, 5705, 5706, 5707, 5708, 5709, 5711, 5712, 5713, 5714, 5716, 5717, 5718, 5720, 5721, 5722, 5723, 5724, 5726, 5728, 5729, 5730, 5731, 5732, 5733, 5734, 5735, 5736, 5737, 5739, 5740, 5741, 5742, 5743, 5744, 5745, 5746, 5747, 5748, 5749, 5751, 5752, 5753, 5754, 5755, 5756, 5757, 5758, 5759, 5760, 5761, 5762, 5763, 5764, 5765, 5766, 5767, 5768, 5769, 5771, 5772, 5773, 5774, 5775, 5776, 5777, 5778, 5779, 5780, 5781, 5782, 5783, 5784, 5785, 5786, 5787, 5788, 5789, 5791, 5792, 5793, 5794, 5795, 5796, 5797, 5798, 5799, 5800, 5801, 5802, 5803, 5804, 5805, 5806, 5808, 5809, 5810, 5811, 5813, 5814, 5815, 5816, 5817, 5819, 5820, 5821, 5822, 5823, 5825, 5826, 5827, 5828, 5829, 5830, 5831, 5832, 5833, 5834, 5835, 5836, 5837, 5838, 5839, 5840, 5841, 5842, 5843, 5844, 5846, 5847, 5848, 5849, 5850, 5851, 5852, 5853, 5854, 5855, 5856, 5857, 5858, 5859, 5860, 5861, 5862, 5863, 5864, 5865, 5866, 5868, 5869, 5870, 5871, 5872, 5874, 5875, 5876, 5877, 5878, 5880, 5881, 5882, 5883, 5884, 5886, 5887, 5888, 5889, 5890, 5891, 5892, 5893, 5894, 5895, 5896, 5897, 5898, 5899, 5900, 5901, 5902, 5903, 5904, 5905, 5907, 5908, 5909, 5910, 5912, 5913, 5914, 5915, 5916, 5917, 5918, 5919, 5920, 5921, 5922, 5924, 5925, 5926, 5927, 5928, 5929, 5932, 5933, 5934, 5935, 5936, 5937, 5938, 5939, 5940, 5942, 5943, 5944, 5945, 5946, 5947, 5948, 5949, 5950, 5952, 5953, 5954, 5955, 5956, 5957, 5960, 5962, 5963, 5965, 5966, 5967, 5968, 5969, 5970, 5971, 5972, 5973, 5974, 5975, 5976, 5977, 5978, 5979, 5980, 5981, 5983, 5984, 5985, 5986, 5987, 5988, 5989, 5991, 5992, 5993, 5994, 5995, 5996, 5997, 5998, 5999, 6000, 6001, 6002, 6003, 6004, 6005, 6006, 6007, 6008, 6009, 6010, 6011, 6012, 6013, 6015, 6016, 6017, 6018, 6019, 6021, 6022, 6023, 6024, 6025, 6027, 6028, 6029, 6030, 6031, 6032, 6034, 6036, 6037, 6040, 6041, 6042, 6043, 6044, 6045, 6046, 6047, 6048, 6049, 6051, 6052, 6053, 6055, 6056, 6057, 6058, 6059, 6060, 6061, 6063, 6064, 6065, 6066, 6067, 6068, 6069, 6070, 6071, 6072, 6073, 6074, 6075, 6076, 6077, 6078, 6079, 6080, 6081, 6083, 6084, 6085, 6086, 6087, 6088, 6089, 6090, 6091, 6092, 6093, 6094, 6095, 6096, 6097, 6099, 6100, 6101, 6102, 6103, 6104, 6105, 6106, 6107, 6108, 6109, 6111, 6112, 6113, 6114, 6115, 6116, 6117, 6119, 6120, 6121, 6122, 6123, 6124, 6126, 6127, 6128, 6129, 6130, 6131, 6132, 6133, 6134, 6135, 6136, 6137, 6139, 6140, 6141, 6142, 6143, 6144, 6145, 6146, 6147, 6148, 6149, 6150, 6151, 6152, 6153, 6154, 6155, 6156, 6157, 6158, 6159, 6160, 6161, 6162, 6163, 6164, 6165, 6166, 6167, 6168, 6169, 6170, 6171, 6172, 6173, 6174, 6175, 6176, 6178, 6179, 6180, 6181, 6182, 6183, 6184, 6185, 6186, 6187, 6189, 6190, 6191, 6192, 6193, 6194, 6195, 6196, 6197, 6198, 6200, 6201, 6202, 6203, 6204, 6205, 6206, 6207, 6208, 6209, 6210, 6211, 6212, 6213, 6214, 6215, 6216, 6217, 6218, 6220, 6221, 6222, 6223, 6224, 6225, 6226, 6227, 6228, 6229, 6230, 6231, 6232, 6233, 6234, 6235, 6236, 6237, 6238, 6239, 6240, 6241, 6242, 6243, 6244, 6245, 6246, 6247, 6248, 6249, 6250, 6251, 6252, 6253, 6254, 6255, 6256, 6257, 6258, 6259, 6260, 6261, 6262, 6263, 6264, 6265, 6266, 6267, 6269, 6270, 6271, 6272, 6273, 6274, 6275, 6276, 6277, 6278, 6279, 6280, 6281, 6282, 6283, 6284, 6285, 6286, 6287, 6288, 6289, 6290, 6291, 6292, 6293, 6294, 6295, 6296, 6297, 6298, 6300, 6301, 6302, 6303, 6304, 6305, 6306, 6307, 6308, 6309, 6310, 6311, 6313, 6314, 6315, 6316, 6317, 6318, 6319, 6320, 6321, 6322, 6323, 6324, 6325, 6326, 6327, 6328, 6329, 6330, 6331, 6332, 6333, 6334, 6335, 6336, 6338, 6339, 6340, 6341, 6342, 6343, 6344, 6345, 6346, 6347, 6348, 6349, 6350, 6351, 6352, 6353, 6354, 6355, 6356, 6357, 6358, 6359, 6360, 6361, 6362, 6363, 6364, 6369, 6370, 6371, 6372, 6373, 6374, 6375, 6376, 6377, 6378, 6379, 6380, 6381, 6382, 6383, 6384, 6385, 6386, 6387, 6388, 6389, 6390, 6391, 6392, 6393, 6394, 6395, 6396, 6399, 6401, 6402, 6404, 6405, 6407, 6408, 6410, 6411, 6412, 6413, 6414, 6415, 6416, 6417, 6418, 6419, 6420, 6421, 6422, 6423, 6424, 6425, 6426, 6427, 6428, 6429, 6430, 6431, 6433, 6434, 6435, 6436, 6437, 6438, 6439, 6440, 6441, 6442, 6443, 6444, 6445, 6446, 6447, 6448, 6449, 6450, 6452, 6453, 6454, 6455, 6457, 6458, 6460, 6461, 6462, 6463, 6464, 6467, 6468, 6469, 6470, 6471, 6472, 6473, 6474, 6475, 6476, 6477, 6478, 6479, 6481, 6482, 6483, 6484, 6485, 6486, 6487, 6488, 6489, 6491, 6492, 6493, 6494, 6495, 6496, 6497, 6498, 6499, 6500, 6501, 6502, 6503, 6504, 6505, 6506, 6507, 6508, 6509, 6510, 6511, 6512, 6513, 6514, 6515, 6516, 6517, 6518, 6519, 6520, 6521, 6522, 6523, 6524, 6525, 6526, 6527, 6528, 6529, 6530, 6531, 6532, 6533, 6534, 6535, 6536, 6537, 6538, 6539, 6540, 6541, 6542, 6543, 6544, 6545, 6547, 6548, 6552, 6553, 6554, 6555, 6556, 6557, 6558, 6559, 6560, 6561, 6562, 6563, 6564, 6565, 6566, 6568, 6569, 6570, 6571, 6572, 6573, 6575, 6576, 6577, 6578, 6579, 6580, 6581, 6582, 6583, 6584, 6585, 6586, 6587, 6589, 6590, 6591, 6592, 6593, 6594, 6595, 6596, 6597, 6598, 6600, 6601, 6602, 6603, 6604, 6605, 6606, 6607, 6608, 6609, 6610, 6611, 6612, 6613, 6614, 6615, 6616, 6617, 6618, 6619, 6620, 6621, 6622, 6623, 6624, 6625, 6626, 6627, 6628, 6629, 6630, 6631, 6632, 6633, 6634, 6635, 6636, 6637, 6639, 6640, 6641, 6642, 6643, 6644, 6645, 6646, 6647, 6648, 6649, 6650, 6651, 6652, 6653, 6654, 6655, 6656, 6657, 6658, 6659, 6660, 6661, 6662, 6663, 6664, 6665, 6666, 6667, 6668, 6669, 6670, 6671, 6672, 6673, 6675, 6676, 6677, 6678, 6679, 6680, 6681, 6682, 6683, 6684, 6685, 6686, 6687, 6688, 6689, 6690, 6691, 6692, 6693, 6694, 6695, 6696, 6697, 6698, 6699, 6700, 6701, 6702, 6703, 6704, 6705, 6706, 6707, 6708, 6709, 6710, 6711, 6712, 6713, 6714, 6715, 6716, 6717, 6718, 6719, 6720, 6721, 6722, 6723, 6724, 6725, 6726, 6727, 6728, 6729, 6730, 6731, 6732, 6733, 6734, 6735, 6736, 6737, 6738, 6739, 6740, 6741, 6742, 6743, 6744, 6745, 6747, 6748, 6750, 6751, 6752, 6753, 6754, 6755, 6756, 6757, 6759, 6760, 6762, 6764, 6765, 6766, 6767, 6768, 6769, 6770, 6771, 6773, 6774, 6775, 6776, 6777, 6778, 6779, 6780, 6781, 6782, 6783, 6784, 6785, 6786, 6787, 6788, 6789, 6790, 6791, 6792, 6793}",6261,"{4099, 4100, 4101, 4102, 4103, 6515, 4116, 4117, 6517, 4130, 4142, 6522, 6523, 4186, 4187, 6531, 4193, 4204, 4207, 4209, 4210, 4211, 4221, 6538, 6542, 4252, 6544, 2474, 6545, 2475, 6548, 2481, 2482, 6555, 2486, 6557, 2487, 6558, 2488, 6559, 4332, 6560, 2490, 6561, 2491, 4358, 6566, 2496, 4379, 4386, 2500, 4392, 4393, 4398, 2504, 2505, 2506, 2508, 4429, 6581, 4442, 4445, 4447, 4450, 4451, 6584, 4458, 6585, 4465, 4469, 4472, 2517, 2518, 6589, 4482, 4483, 4484, 4485, 4486, 4487, 4488, 4489, 4490, 4492, 4493, 4494, 4496, 2523, 6594, 2524, 4514, 4515, 4518, 6597, 4524, 6598, 2529, 4537, 4538, 4539, 4540, 4541, 4542, 4544, 4545, 6602, 4547, 4549, 4551, 4552, 4553, 4555, 4556, 4557, 4558, 4559, 4562, 4563, 6606, 4566, 4567, 4568, 4569, 4570, 6607, 4572, 4575, 4577, 4578, 4588, 4589, 4595, 4598, 4606, 4607, 4621, 4622, 4624, 6618, 4626, 4627, 6619, 4640, 4647, 4650, 2553, 4654, 4656, 4657, 4663, 4664, 4669, 6627, 4673, 4676, 4677, 4680, 4687, 4690, 4692, 6632, 4698, 4699, 4700, 4701, 4702, 4703, 4704, 4705, 4706, 4707, 4708, 4709, 4710, 4711, 4712, 4713, 4715, 4716, 4717, 4718, 4719, 4725, 4727, 4729, 4735, 4739, 4740, 4741, 4743, 4747, 4748, 4750, 4752, 4753, 4755, 6644, 4757, 4764, 4765, 2575, 4767, 4772, 4773, 4774, 4776, 4777, 4779, 4780, 4784, 4785, 4788, 2580, 4790, 4791, 4793, 4794, 4795, 4798, 4799, 4803, 4807, 4810, 4815, 4816, 4817, 4827, 4828, 4829, 4833, 4835, 4836, 4838, 4839, 4840, 4842, 4844, 4845, 4846, 4848, 4858, 4859, 4861, 4864, 4865, 4867, 4872, 4876, 4878, 4884, 4887, 4888, 4892, 4893, 4894, 4895, 4897, 4900, 4903, 4904, 4906, 4908, 4910, 4911, 4916, 4919, 4920, 4923, 4926, 4928, 4929, 4933, 4934, 4935, 4937, 4938, 4939, 4943, 4944, 4945, 4946, 4947, 4949, 4952, 4956, 4961, 4964, 4965, 4967, 4968, 4970, 4972, 4973, 4974, 4975, 4978, 4979, 4980, 4982, 4984, 4986, 4994, 4996, 4997, 4998, 4999, 5001, 5002, 5003, 5004, 5005, 5006, 5007, 5011, 5012, 5013, 5014, 5016, 5017, 5018, 5019, 5022, 5024, 5025, 5026, 5027, 5028, 5031, 5032, 5036, 5037, 5038, 5039, 5040, 5041, 5042, 5043, 5044, 5045, 5048, 5051, 5058, 5062, 5066, 5067, 5068, 5069, 5071, 5072, 5073, 5074, 5075, 5076, 5077, 5078, 5080, 5081, 5082, 5083, 5084, 5085, 5086, 5087, 989, 5090, 5091, 5092, 5093, 5095, 5096, 5097, 5098, 5099, 5101, 5102, 5105, 5107, 5108, 5109, 5110, 5111, 5114, 5116, 5117, 5121, 5122, 5124, 5125, 5126, 5127, 5128, 5129, 5132, 5134, 5136, 5139, 5140, 5143, 5149, 5156, 5160, 5163, 5164, 5165, 5168, 5169, 5171, 5172, 5174, 5175, 1081, 5178, 5181, 5182, 5183, 5186, 5187, 5192, 5193, 5197, 5198, 5199, 5200, 5201, 5202, 5203, 5205, 1110, 5206, 5207, 5208, 5209, 5210, 5211, 5212, 1117, 5214, 5215, 5216, 5217, 5218, 5219, 5224, 5226, 5229, 5230, 5231, 5232, 5233, 5236, 5238, 5239, 1145, 1149, 5246, 5248, 1155, 5253, 1160, 5261, 1169, 1170, 5268, 5270, 5273, 5274, 5275, 1177, 1180, 1181, 1185, 1187, 5284, 5285, 1188, 1191, 1197, 1200, 1201, 1203, 1204, 1205, 1206, 1207, 1208, 1209, 1210, 1212, 1213, 1215, 5312, 1216, 5315, 1219, 1220, 1221, 5319, 1222, 1223, 1224, 5320, 1226, 1225, 5321, 1228, 5328, 1231, 1236, 5333, 5336, 1242, 5339, 5340, 5344, 5350, 5351, 1260, 5359, 1263, 1264, 1265, 5364, 1271, 5369, 5370, 5372, 5373, 5375, 5376, 5379, 5380, 1283, 5383, 5384, 5385, 1293, 5391, 1295, 5394, 1298, 1300, 5398, 5399, 1304, 1305, 5402, 5403, 5404, 5405, 1307, 5407, 1308, 5409, 1309, 5411, 1310, 1311, 5414, 1313, 1314, 5417, 1315, 5419, 1316, 1318, 1321, 1323, 1324, 1325, 1327, 5427, 1328, 1329, 5430, 1330, 1331, 1332, 1334, 1335, 1336, 5437, 5438, 5431, 1338, 1339, 5442, 1340, 1342, 1349, 5445, 1344, 1345, 5448, 5449, 1346, 1347, 1348, 1350, 5454, 1352, 1353, 1354, 1356, 5459, 1357, 5461, 5462, 5463, 1366, 5465, 5466, 1367, 5468, 1368, 1369, 5471, 5472, 1370, 1372, 1373, 5476, 5477, 1375, 1377, 1379, 1380, 1385, 1386, 1387, 5485, 5486, 5487, 1388, 1390, 5490, 5491, 1392, 5493, 5496, 5499, 5501, 5502, 1405, 1406, 5505, 1407, 5507, 5508, 5509, 1413, 5511, 5512, 5516, 5517, 5518, 5520, 5523, 5524, 5525, 5529, 1433, 5531, 1436, 1439, 1442, 1443, 1446, 1447, 5544, 5545, 1448, 1449, 1450, 1451, 5542, 5551, 1453, 1454, 1455, 1456, 5556, 1457, 5558, 5559, 1458, 1459, 1464, 1466, 1467, 5562, 5563, 1470, 1471, 1472, 5570, 5564, 5572, 1474, 5565, 1476, 1477, 5575, 5578, 5579, 1481, 5581, 1484, 1485, 1487, 1489, 5586, 5587, 5585, 5589, 5590, 1491, 1493, 5593, 5594, 5595, 1495, 1496, 1501, 1502, 5600, 1504, 1505, 5603, 1507, 5605, 1511, 5608, 5609, 5610, 5612, 5613, 5617, 5618, 1521, 5622, 5623, 5624, 5631, 1536, 5633, 1538, 5636, 5637, 5640, 5645, 5647, 5652, 5653, 5654, 5655, 5656, 5657, 5658, 5659, 5660, 1556, 1563, 5663, 5664, 5665, 5666, 5667, 5668, 5669, 1566, 1569, 5672, 1571, 1572, 1575, 1576, 5671, 5678, 1578, 5680, 5681, 1579, 1580, 1581, 1582, 5686, 1587, 1588, 5689, 5683, 5691, 5692, 5693, 5694, 1590, 1591, 1593, 5698, 1594, 5700, 1596, 1597, 1598, 5696, 1602, 5699, 1604, 1605, 1606, 5703, 1609, 1610, 5705, 5707, 1613, 5716, 1614, 5709, 5712, 1619, 1620, 1622, 1624, 1625, 5724, 1630, 5726, 1632, 1633, 1634, 1635, 5730, 1638, 5736, 5737, 1643, 1648, 1649, 5745, 5746, 5747, 5748, 1654, 5751, 1656, 1658, 1659, 5756, 5757, 1662, 1663, 1664, 1665, 5758, 1667, 1668, 1669, 1670, 5760, 5762, 5763, 1674, 5764, 5765, 5771, 1678, 5772, 1680, 1681, 5778, 5779, 5780, 5785, 5786, 1691, 5788, 5791, 5800, 5803, 5805, 5806, 5820, 5825, 5829, 1737, 5833, 5835, 5838, 5841, 5842, 5843, 5844, 5846, 5847, 5848, 5849, 5850, 1755, 5851, 5852, 5853, 5858, 5860, 5861, 5862, 5863, 5868, 5869, 1775, 5871, 5872, 5875, 5883, 5884, 1791, 1792, 1793, 5889, 5890, 5892, 5894, 5895, 5896, 5898, 5901, 5904, 1812, 5908, 5909, 5913, 5914, 1819, 5916, 5917, 5922, 5927, 5929, 5934, 5936, 5937, 5939, 5942, 5943, 5944, 1850, 5946, 5947, 5948, 5949, 5950, 1857, 1858, 1859, 5955, 5956, 1862, 5957, 1864, 5960, 5962, 1867, 5965, 5966, 1871, 5967, 5968, 5969, 5970, 5971, 5972, 5973, 5974, 1880, 5975, 5976, 1883, 5977, 5978, 5979, 5980, 5983, 5984, 5985, 5987, 5988, 5989, 1895, 5991, 1897, 1898, 5992, 1900, 5997, 5998, 1901, 6000, 1902, 6002, 1903, 6004, 6003, 6005, 6006, 6007, 1907, 1908, 6010, 6011, 1910, 1911, 1912, 1915, 1916, 1918, 1919, 1920, 1922, 1923, 1924, 6022, 1928, 1929, 6023, 1931, 6024, 6028, 1934, 6032, 1937, 1939, 1940, 1941, 1945, 1946, 6042, 6043, 1951, 6052, 6053, 1958, 6056, 1966, 6066, 6073, 6076, 6077, 6080, 1993, 6089, 6090, 1997, 1999, 2001, 6099, 6100, 2005, 2006, 6105, 6107, 2012, 2016, 6112, 6114, 2019, 6115, 6117, 2023, 6120, 2027, 2028, 6131, 6132, 6135, 6136, 2040, 6137, 6140, 2047, 2051, 2053, 2056, 2057, 2058, 2060, 2061, 2062, 6158, 2064, 2065, 2066, 2067, 6161, 2069, 2070, 2071, 6164, 2073, 2074, 2075, 6167, 2077, 6175, 6176, 6179, 2084, 2085, 6180, 6186, 6187, 6189, 6190, 6191, 6194, 6196, 6197, 2106, 6202, 6203, 2109, 6204, 2111, 6206, 6207, 2114, 6208, 6209, 6210, 6211, 6212, 6213, 6214, 6215, 6218, 6220, 6223, 6224, 6225, 6227, 6230, 6231, 6232, 6233, 2139, 2143, 6245, 2150, 6247, 6248, 6250, 2155, 6251, 6252, 6257, 2164, 2166, 2168, 2169, 6266, 2172, 2173, 2174, 6269, 6270, 6271, 6273, 6275, 6276, 2181, 6278, 6279, 2183, 2184, 6280, 2186, 6281, 2188, 6286, 2189, 6282, 2191, 6283, 6284, 2194, 2195, 2196, 2197, 6287, 6288, 6292, 6293, 6294, 6295, 6297, 6298, 6300, 6301, 6302, 6303, 2210, 2211, 6304, 6305, 6306, 6307, 6308, 6309, 6310, 6311, 6313, 6314, 6315, 6316, 6317, 6318, 6319, 6320, 6321, 6322, 6323, 6324, 6325, 2232, 6326, 6327, 6328, 6329, 6330, 6331, 6332, 6333, 6335, 6336, 6338, 6339, 6340, 6341, 6342, 6343, 6344, 2250, 2252, 6345, 6346, 6347, 6348, 6349, 6350, 6351, 6352, 6354, 6355, 6356, 6357, 6358, 6360, 6361, 6362, 6363, 6364, 2269, 2272, 6369, 6370, 2275, 2276, 6371, 6373, 6374, 6375, 6377, 6378, 6381, 6379, 6380, 6382, 6383, 6384, 6385, 6386, 6387, 6390, 6391, 6392, 6393, 6394, 2298, 2299, 6395, 6396, 2302, 6399, 2304, 2305, 6401, 6402, 6404, 6405, 6407, 2312, 2313, 6408, 6410, 2316, 6411, 6412, 6413, 6414, 6415, 2322, 6416, 6417, 6418, 6419, 6420, 6421, 6422, 6423, 6424, 6425, 6426, 6427, 2335, 2336, 6428, 6429, 6435, 6430, 6437, 2339, 6431, 6433, 2342, 6434, 2344, 6436, 6438, 2347, 6439, 2349, 2350, 2351, 2354, 2355, 2356, 6445, 6446, 6447, 6448, 2362, 6452, 6453, 6454, 2366, 2367, 6464, 2368, 2369, 2371, 6460, 6461, 6462, 2375, 6463, 6467, 6468, 2379, 6469, 2381, 2382, 6479, 2384, 2385, 6473, 6474, 6475, 6476, 6477, 2391, 6481, 6482, 6483, 6484, 6485, 2397, 2398, 2399, 6487, 6488, 2402, 6491, 6492, 6501, 2405, 2406, 6495, 2409, 2410, 2411, 6508, 2412, 2413, 6511, 6512, 6513, 6514, 2415, 6516, 2416, 2420, 2421, 6520, 6518, 6519, 2423, 6521, 6525, 6526, 2424, 6528, 6529, 2425, 6524, 2429, 6527, 2430, 6530, 2437, 2438, 2439, 2440, 2441, 2442, 2443, 6534, 6535, 6536, 6537, 2449, 6539, 6540, 6541, 2453, 6543, 6553, 6554, 6547, 6556, 2460, 2462, 6552, 2464, 2465, 6562, 6563, 6564, 6565, 2466, 2467, 6568, 6569, 6570, 6571, 6572, 6573, 2469, 6575, 6576, 6577, 6578, 6579, 6580, 2476, 2478, 6583, 2479, 2480, 6586, 6587, 2484, 2485, 6590, 6591, 6592, 6593, 2489, 6595, 6596, 2492, 2494, 2495, 6600, 6601, 2499, 6603, 6604, 6605, 2501, 2503, 6608, 6609, 6610, 6611, 6612, 6613, 6614, 2511, 2513, 2514, 2515, 2516, 6620, 6621, 6622, 6623, 6624, 6625, 2521, 2522, 6628, 6629, 2525, 2526, 2527, 2528, 6634, 6626, 6636, 6637, 6630, 6631, 2536, 6641, 6642, 6643, 6635, 6645, 2543, 2546, 6648, 6649, 6650, 6651, 6652, 6653, 2552, 6655, 6656, 6657, 6658, 6659, 6660, 6661, 6662, 6663, 6664, 2562, 6666, 2569, 6668, 6669, 6670, 6671, 6672, 6673, 2570, 6675, 6676, 6677, 6678, 6679, 6680, 6681, 6682, 6683, 6684, 6685, 6686, 6687, 6688, 6689, 6690, 6693, 6694, 6696, 6697, 6698, 6699, 6701, 6702, 6707, 6708, 2611, 6710, 2613, 2616, 6713, 6716, 2620, 2628, 2631, 6728, 2632, 2637, 2641, 2648, 2655, 2656, 2672, 2682, 2692, 2693, 2694, 2695, 2696, 2697, 2698, 2699, 2700, 2701, 2707, 2709, 2711, 2716, 2728, 2730, 2733, 2734, 2735, 2736, 2739, 2748, 2771, 2775, 2777, 2780, 2785, 2787, 2790, 2793, 2796, 2798, 2799, 2801, 2806, 2808, 5443, 2823, 2825, 2826, 2827, 2832, 2839, 2844, 2845, 2849, 2861, 2862, 2863, 2865, 2867, 2868, 2869, 2870, 2872, 2873, 2878, 2880, 2884, 2886, 2888, 2890, 2891, 2893, 2896, 2897, 2898, 2899, 2900, 2901, 2903, 2904, 2908, 2909, 2912, 2916, 2918, 3015, 3207, 3209, 3211, 3222, 3225, 3228, 3229, 3234, 3241, 3244, 3248, 3249, 3250, 3253, 3256, 3258, 3265, 3271, 3272, 3273, 3276, 3277, 3291, 3294, 3300, 3303, 3305, 3306, 3307, 5993, 3318, 3328, 5994, 3352, 5995, 3387, 5996, 5566, 3430, 3433, 5567, 3444, 3446, 3450, 3454, 3455, 3456, 3462, 3466, 3468, 3471, 3482, 3483, 3484, 3485, 3486, 3488, 3495, 3499, 3500, 3502, 3503, 3507, 3509, 3512, 3522, 3525, 3527, 3529, 3532, 3536, 3538, 3542, 3546, 3550, 3551, 3615, 3664, 3668, 3678, 3679, 3680, 3682, 3685, 3688, 6008, 3693, 3698, 3705, 3706, 3710, 3716, 3717, 3729, 6440, 3732, 6441, 3736, 3738, 6442, 6443, 6444, 3758, 3760, 3761, 3762, 3763, 3764, 3768, 1564, 6449, 3776, 3777, 3779, 3783, 3785, 3786, 3789, 3790, 6012, 3792, 3794, 3797, 3799, 3801, 3804, 3805, 3811, 3812, 3813, 3814, 6457, 3815, 6013, 3819, 6458, 3823, 3825, 3827, 3830, 3833, 3841, 3844, 3848, 3849, 3851, 3853, 3854, 3855, 3860, 3861, 3862, 3863, 3864, 3866, 3867, 3870, 3872, 3873, 3875, 3877, 3878, 3879, 3880, 6470, 3886, 3887, 3888, 3889, 3890, 3891, 3892, 6471, 3894, 3895, 3896, 3897, 6472, 3904, 3905, 3906, 3908, 3910, 3913, 3915, 3917, 3918, 3920, 6478, 3924, 3925, 3935, 3939, 3940, 3947, 3948, 3949, 3950, 3952, 3953, 3957, 6486, 3963, 3967, 3973, 6489, 3978, 3979, 3980, 3981, 5676, 3988, 3991, 3993, 3994, 3995, 3998, 4000, 6494, 4002, 4004, 4005, 6496, 6497, 4019, 6498, 4025, 6499, 4031, 4032, 6500, 4039, 4040, 6502, 4042, 4046, 6503, 4047, 6504, 4053, 6505, 4057, 6506, 4063, 6507, 4068, 4069, 4070, 6509, 4080, 6510, 4084, 4086, 4089}",1941,"{0, 1, 2, 3, 4, 5, 6, 7, 8, 9, 10, 11, 12, 14, 15, 16, 17, 18, 20, 21, 22, 23, 24, 25, 27, 28, 29, 30, 31, 32, 33, 34, 35, 36, 37, 38, 39, 42, 43, 44, 45, 46, 47, 48, 49, 50, 51, 52, 53, 54, 55, 56, 57, 58, 59, 60, 61, 62, 64, 65, 66, 67, 68, 69, 70, 71, 72, 73, 74, 75, 78, 79, 80, 81, 83, 84, 85, 86, 88, 89, 90, 91, 92, 93, 94, 95, 96, 97, 98, 99, 100, 101, 102, 103, 104, 105, 106, 107, 108, 109, 110, 111, 112, 113, 114, 116, 118, 123, 124, 125, 126, 127, 128, 129, 130, 131, 132, 133, 134, 135, 136, 137, 138, 139, 140, 141, 143, 144, 145, 146, 147, 148, 149, 150, 151, 153, 154, 155, 156, 158, 159, 160, 161, 162, 163, 164, 165, 166, 167, 168, 169, 171, 172, 175, 176, 179, 180, 181, 182, 183, 184, 185, 186, 187, 188, 189, 190, 191, 192, 193, 194, 195, 196, 198, 199, 200, 201, 202, 203, 204, 205, 206, 207, 208, 209, 210, 211, 212, 213, 214, 215, 216, 217, 218, 219, 220, 221, 222, 223, 224, 225, 226, 227, 228, 229, 230, 231, 232, 234, 235, 236, 237, 238, 239, 240, 241, 242, 243, 244, 245, 246, 247, 248, 249, 250, 251, 252, 253, 254, 256, 257, 258, 259, 260, 261, 262, 263, 264, 265, 266, 267, 268, 269, 271, 272, 273, 274, 275, 276, 277, 278, 279, 280, 281, 282, 283, 284, 285, 286, 287, 288, 289, 290, 291, 292, 293, 294, 295, 296, 297, 298, 300, 301, 302, 303, 305, 307, 310, 311, 312, 313, 314, 315, 316, 317, 318, 321, 322, 323, 324, 325, 326, 327, 331, 332, 333, 334, 335, 336, 337, 338, 339, 340, 341, 342, 343, 344, 345, 346, 348, 349, 350, 351, 352, 353, 356, 357, 358, 359, 360, 361, 362, 363, 364, 365, 366, 367, 368, 369, 370, 372, 373, 375, 376, 377, 378, 379, 380, 382, 383, 384, 385, 386, 387, 388, 389, 390, 391, 392, 393, 394, 395, 396, 397, 398, 399, 400, 401, 402, 403, 404, 405, 406, 407, 408, 409, 410, 411, 414, 415, 416, 417, 418, 419, 420, 421, 422, 423, 424, 425, 426, 427, 428, 429, 430, 431, 433, 434, 435, 436, 437, 438, 439, 440, 441, 443, 444, 445, 446, 447, 449, 450, 451, 452, 453, 454, 456, 457, 458, 459, 460, 461, 462, 463, 464, 466, 467, 468, 469, 470, 471, 473, 474, 475, 476, 477, 478, 479, 481, 482, 483, 484, 486, 487, 488, 489, 490, 491, 492, 493, 494, 495, 496, 497, 498, 499, 500, 501, 502, 503, 504, 505, 506, 508, 509, 510, 511, 512, 513, 514, 515, 516, 518, 519, 520, 521, 522, 523, 524, 525, 526, 527, 528, 530, 531, 533, 534, 535, 536, 537, 538, 539, 540, 541, 542, 543, 544, 545, 546, 547, 548, 549, 550, 551, 552, 553, 554, 555, 556, 557, 558, 559, 560, 561, 562, 563, 565, 566, 567, 568, 569, 570, 571, 572, 573, 574, 575, 576, 577, 578, 580, 582, 583, 584, 585, 586, 590, 591, 593, 594, 596, 597, 598, 599, 600, 601, 602, 603, 604, 605, 606, 607, 608, 610, 611, 612, 613, 614, 616, 617, 618, 620, 621, 622, 623, 624, 625, 626, 627, 628, 629, 631, 632, 633, 634, 635, 636, 637, 638, 639, 640, 641, 642, 643, 644, 645, 646, 647, 648, 649, 650, 651, 652, 653, 654, 655, 656, 657, 658, 659, 660, 661, 662, 663, 664, 665, 666, 667, 668, 669, 670, 671, 672, 673, 674, 675, 676, 677, 678, 679, 680, 681, 682, 683, 684, 685, 686, 687, 688, 689, 690, 693, 695, 696, 697, 698, 699, 700, 701, 702, 703, 704, 705, 706, 707, 708, 709, 710, 711, 712, 713, 714, 715, 716, 717, 718, 719, 720, 721, 722, 723, 724, 725, 726, 727, 728, 729, 730, 731, 732, 733, 734, 735, 736, 737, 738, 739, 740, 741, 742, 743, 744, 745, 746, 748, 749, 750, 751, 752, 753, 754, 755, 756, 757, 758, 759, 760, 761, 762, 763, 764, 765, 766, 767, 768, 769, 770, 771, 773, 774, 775, 776, 777, 778, 779, 780, 781, 782, 783, 784, 785, 786, 787, 788, 789, 790, 791, 792, 794, 795, 796, 797, 798, 799, 800, 801, 802, 803, 804, 805, 806, 807, 808, 809, 810, 811, 812, 813, 814, 815, 816, 817, 819, 820, 821, 824, 825, 826, 828, 829, 830, 831, 832, 833, 834, 835, 836, 837, 838, 839, 840, 841, 842, 843, 844, 845, 846, 847, 848, 849, 850, 851, 852, 854, 855, 856, 857, 858, 859, 860, 861, 862, 864, 865, 866, 867, 868, 869, 870, 871, 872, 873, 874, 875, 876, 877, 878, 879, 880, 881, 882, 883, 884, 885, 886, 887, 888, 889, 890, 891, 892, 893, 894, 895, 896, 897, 898, 899, 900, 901, 902, 903, 904, 905, 906, 907, 908, 909, 910, 911, 912, 913, 914, 915, 916, 917, 918, 919, 920, 921, 922, 923, 924, 925, 926, 927, 928, 929, 930, 931, 932, 933, 935, 936, 937, 939, 940, 941, 942, 943, 944, 945, 946, 947, 948, 949, 950, 951, 952, 953, 954, 955, 956, 957, 958, 959, 960, 961, 962, 963, 964, 965, 966, 967, 968, 969, 970, 971, 972, 973, 974, 975, 976, 977, 978, 979, 980, 981, 982, 983, 984, 985, 986, 987, 988, 990, 991, 992, 993, 994, 996, 997, 999, 1000, 1001, 1002, 1003, 1004, 1005, 1006, 1007, 1008, 1009, 1010, 1011, 1012, 1013, 1014, 1015, 1016, 1017, 1018, 1019, 1020, 1021, 1022, 1023, 1024, 1025, 1026, 1028, 1029, 1030, 1031, 1032, 1033, 1034, 1035, 1036, 1037, 1038, 1039, 1040, 1041, 1042, 1043, 1044, 1045, 1046, 1047, 1048, 1050, 1051, 1052, 1053, 1054, 1055, 1056, 1057, 1058, 1059, 1060, 1061, 1063, 1064, 1065, 1066, 1067, 1069, 1070, 1071, 1073, 1074, 1075, 1076, 1077, 1078, 1079, 1080, 1082, 1083, 1085, 1086, 1087, 1088, 1089, 1090, 1092, 1093, 1094, 1095, 1096, 1097, 1098, 1099, 1100, 1101, 1103, 1104, 1105, 1106, 1107, 1108, 1109, 1111, 1112, 1113, 1114, 1115, 1116, 1118, 1119, 1120, 1121, 1122, 1123, 1124, 1125, 1126, 1127, 1128, 1129, 1130, 1131, 1132, 1133, 1134, 1135, 1136, 1137, 1138, 1140, 1141, 1142, 1143, 1144, 1146, 1147, 1148, 1150, 1151, 1152, 1153, 1154, 1156, 1157, 1158, 1159, 1161, 1162, 1163, 1165, 1166, 1167, 1168, 1171, 1172, 1173, 1174, 1175, 1176, 1178, 1179, 1182, 1183, 1184, 1186, 1189, 1190, 1192, 1193, 1194, 1195, 1196, 1198, 1199, 1202, 1211, 1214, 1217, 1218, 1227, 1229, 1230, 1232, 1233, 1234, 1235, 1237, 1238, 1239, 1240, 1241, 1243, 1244, 1245, 1246, 1247, 1248, 1249, 1250, 1251, 1252, 1253, 1254, 1255, 1258, 1259, 1262, 1267, 1268, 1269, 1270, 1272, 1273, 1274, 1275, 1276, 1277, 1278, 1279, 1280, 1281, 1282, 1284, 1285, 1286, 1287, 1288, 1289, 1290, 1291, 1292, 1294, 1299, 1301, 1302, 1303, 1306, 1317, 1320, 1326, 1333, 1337, 1343, 1351, 1355, 1358, 1359, 1360, 1361, 1362, 1364, 1365, 1371, 1374, 1376, 1378, 1381, 1382, 1383, 1384, 1389, 1391, 1393, 1394, 1395, 1396, 1397, 1399, 1400, 1401, 1402, 1403, 1404, 1408, 1409, 1410, 1411, 1412, 1414, 1415, 1416, 1418, 1419, 1420, 1421, 1422, 1423, 1424, 1426, 1427, 1428, 1429, 1430, 1431, 1432, 1434, 1435, 1437, 1440, 1441, 1445, 1452, 1460, 1461, 1462, 1465, 1468, 1469, 1473, 1475, 1478, 1479, 1482, 1483, 1488, 1492, 1494, 1499, 1500, 1503, 1506, 1508, 1509, 1510, 1512, 1513, 1514, 1515, 1516, 1517, 1518, 1519, 1520, 1522, 1523, 1524, 1525, 1526, 1527, 1528, 1529, 1530, 1531, 1532, 1533, 1534, 1535, 1539, 1540, 1541, 1542, 1543, 1544, 1545, 1546, 1548, 1549, 1550, 1551, 1552, 1553, 1554, 1557, 1558, 1559, 1560, 1561, 1562, 1565, 1567, 1568, 1570, 1573, 1574, 1577, 1583, 1584, 1585, 1586, 1589, 1592, 1595, 1599, 1600, 1601, 1603, 1607, 1608, 1612, 1615, 1616, 1617, 1618, 1621, 1623, 1626, 1627, 1628, 1629, 1631, 1636, 1637, 1639, 1640, 1641, 1642, 1644, 1645, 1646, 1647, 1650, 1651, 1652, 1653, 1655, 1657, 1660, 1661, 1666, 1671, 1672, 1673, 1675, 1676, 1679, 1682, 1683, 1684, 1685, 1686, 1687, 1688, 1689, 1690, 1692, 1693, 1694, 1695, 1696, 1697, 1698, 1699, 1700, 1701, 1702, 1703, 1704, 1705, 1706, 1707, 1708, 1709, 1710, 1711, 1712, 1713, 1714, 1715, 1716, 1717, 1718, 1719, 1720, 1721, 1722, 1723, 1724, 1725, 1726, 1727, 1728, 1729, 1730, 1731, 1732, 1734, 1735, 1736, 1738, 1739, 1740, 1741, 1742, 1743, 1744, 1745, 1746, 1747, 1748, 1749, 1752, 1753, 1754, 1756, 1757, 1758, 1759, 1760, 1761, 1762, 1764, 1765, 1766, 1767, 1768, 1769, 1770, 1771, 1772, 1773, 1774, 1776, 1778, 1779, 1780, 1781, 1782, 1783, 1784, 1785, 1786, 1787, 1788, 1789, 1790, 1795, 1796, 1797, 1798, 1799, 1800, 1801, 1802, 1803, 1804, 1805, 1806, 1807, 1808, 1809, 1810, 1811, 1813, 1814, 1815, 1816, 1817, 1818, 1820, 1821, 1822, 1823, 1824, 1825, 1826, 1827, 1828, 1829, 1830, 1831, 1832, 1833, 1834, 1835, 1836, 1837, 1838, 1839, 1840, 1841, 1842, 1843, 1844, 1845, 1846, 1847, 1848, 1849, 1851, 1852, 1853, 1854, 1855, 1860, 1861, 1863, 1865, 1866, 1868, 1869, 1870, 1872, 1873, 1874, 1875, 1876, 1877, 1878, 1879, 1881, 1882, 1884, 1885, 1886, 1887, 1888, 1889, 1890, 1891, 1892, 1893, 1894, 1896, 1899, 1904, 1905, 1909, 1914, 1921, 1925, 1926, 1927, 1930, 1932, 1936, 1938, 1942, 1943, 1944, 1947, 1948, 1949, 1950, 1952, 1954, 1955, 1956, 1957, 1959, 1960, 1961, 1962, 1963, 1964, 1965, 1967, 1968, 1969, 1970, 1971, 1972, 1973, 1974, 1975, 1976, 1977, 1978, 1979, 1980, 1981, 1982, 1983, 1984, 1985, 1986, 1987, 1988, 1990, 1991, 1992, 1994, 1995, 1996, 1998, 2000, 2002, 2003, 2004, 2007, 2008, 2009, 2010, 2011, 2014, 2015, 2017, 2018, 2020, 2021, 2022, 2024, 2025, 2026, 2029, 2030, 2031, 2032, 2033, 2034, 2035, 2036, 2037, 2038, 2039, 2041, 2042, 2043, 2044, 2045, 2046, 2049, 2050, 2052, 2055, 2059, 2063, 2068, 2076, 2079, 2080, 2081, 2082, 2083, 2086, 2087, 2088, 2089, 2090, 2091, 2092, 2094, 2095, 2096, 2097, 2098, 2099, 2100, 2101, 2102, 2103, 2104, 2107, 2108, 2110, 2112, 2113, 2115, 2116, 2117, 2118, 2119, 2120, 2121, 2122, 2123, 2124, 2125, 2126, 2128, 2129, 2130, 2131, 2132, 2133, 2134, 2135, 2137, 2138, 2140, 2141, 2142, 2144, 2146, 2147, 2148, 2149, 2151, 2152, 2153, 2154, 2156, 2157, 2158, 2159, 2160, 2161, 2162, 2163, 2167, 2170, 2171, 2175, 2176, 2177, 2178, 2179, 2180, 2182, 2185, 2187, 2190, 2192, 2193, 2198, 2200, 2201, 2202, 2203, 2204, 2205, 2206, 2207, 2208, 2209, 2212, 2213, 2214, 2215, 2216, 2217, 2218, 2219, 2220, 2221, 2222, 2223, 2224, 2225, 2226, 2228, 2229, 2230, 2231, 2233, 2234, 2235, 2236, 2237, 2239, 2240, 2241, 2242, 2243, 2244, 2245, 2246, 2247, 2248, 2249, 2251, 2253, 2254, 2255, 2259, 2260, 2261, 2262, 2263, 2264, 2265, 2266, 2267, 2268, 2270, 2271, 2273, 2274, 2277, 2280, 2281, 2282, 2283, 2284, 2285, 2287, 2288, 2289, 2290, 2291, 2292, 2293, 2294, 2295, 2296, 2297, 2300, 2301, 2303, 2306, 2307, 2309, 2310, 2311, 2315, 2317, 2318, 2319, 2320, 2321, 2323, 2324, 2325, 2327, 2328, 2329, 2330, 2331, 2332, 2333, 2334, 2337, 2338, 2340, 2341, 2345, 2346, 2348, 2352, 2353, 2357, 2358, 2359, 2360, 2361, 2363, 2364, 2365, 2370, 2373, 2374, 2376, 2377, 2378, 2380, 2383, 2386, 2387, 2388, 2389, 2390, 2392, 2393, 2394, 2395, 2396, 2401, 2403, 2404, 2407, 2408, 2414, 2419, 2422, 2426, 2427, 2428, 2431, 2432, 2433, 2434, 2435, 2436, 2444, 2445, 2448, 2450, 2452, 2454, 2455, 2456, 2457, 2458, 2459, 2461, 2463, 2470, 2471, 2472, 2473, 2477, 2483, 2497, 2509, 2510, 2512, 2519, 2520, 2530, 2531, 2532, 2533, 2534, 2535, 2537, 2538, 2540, 2541, 2544, 2547, 2548, 2549, 2550, 2551, 2554, 2555, 2556, 2557, 2558, 2559, 2560, 2561, 2563, 2564, 2566, 2567, 2568, 2572, 2574, 2576, 2577, 2578, 2579, 2581, 2582, 2583, 2584, 2585, 2586, 2587, 2590, 2591, 2592, 2593, 2594, 2595, 2596, 2597, 2598, 2599, 2600, 2601, 2603, 2604, 2605, 2606, 2607, 2608, 2609, 2610, 2612, 2614, 2615, 2617, 2621, 2622, 2623, 2624, 2625, 2626, 2627, 2629, 2630, 2633, 2635, 2636, 2639, 2640, 2642, 2643, 2644, 2645, 2646, 2647, 2649, 2650, 2652, 2653, 2654, 2657, 2658, 2659, 2660, 2662, 2664, 2666, 2667, 2668, 2669, 2671, 2673, 2674, 2677, 2679, 2680, 2681, 2683, 2684, 2685, 2686, 2687, 2688, 2689, 2690, 2691, 2703, 2704, 2705, 2706, 2708, 2710, 2712, 2713, 2715, 2717, 2718, 2720, 2721, 2723, 2724, 2725, 2726, 2727, 2729, 2731, 2732, 2737, 2738, 2740, 2741, 2744, 2745, 2746, 2747, 2749, 2750, 2751, 2753, 2754, 2755, 2756, 2757, 2758, 2759, 2760, 2761, 2762, 2763, 2764, 2765, 2766, 2768, 2769, 2770, 2772, 2773, 2774, 2776, 2779, 2782, 2783, 2784, 2786, 2789, 2791, 2792, 2794, 2795, 2797, 2800, 2802, 2803, 2804, 2805, 2807, 2809, 2811, 2812, 2813, 2814, 2815, 2816, 2817, 2818, 2819, 2820, 2821, 2822, 2828, 2830, 2831, 2833, 2834, 2835, 2836, 2837, 2838, 2840, 2841, 2842, 2843, 2846, 2847, 2848, 2850, 2851, 2852, 2853, 2854, 2855, 2856, 2857, 2858, 2859, 2860, 2866, 2871, 2874, 2875, 2877, 2883, 2887, 2889, 2892, 2894, 2895, 2902, 2905, 2906, 2907, 2910, 2911, 2914, 2915, 2917, 2919, 2920, 2921, 2923, 2924, 2925, 2926, 2927, 2930, 2931, 2932, 2933, 2934, 2935, 2937, 2938, 2939, 2940, 2941, 2942, 2943, 2944, 2945, 2946, 2947, 2949, 2950, 2951, 2952, 2953, 2955, 2956, 2957, 2959, 2960, 2961, 2962, 2963, 2965, 2966, 2967, 2968, 2969, 2970, 2971, 2972, 2973, 2974, 2975, 2976, 2977, 2978, 2979, 2980, 2981, 2982, 2983, 2984, 2985, 2986, 2987, 2988, 2989, 2990, 2991, 2992, 2993, 2994, 2995, 2996, 2997, 2998, 2999, 3000, 3001, 3002, 3003, 3004, 3005, 3006, 3007, 3008, 3009, 3010, 3011, 3012, 3014, 3016, 3017, 3018, 3019, 3020, 3022, 3023, 3024, 3025, 3026, 3027, 3028, 3029, 3030, 3031, 3032, 3033, 3034, 3035, 3036, 3037, 3038, 3039, 3040, 3042, 3043, 3044, 3045, 3046, 3047, 3048, 3049, 3050, 3051, 3052, 3053, 3054, 3055, 3057, 3058, 3059, 3060, 3061, 3062, 3063, 3064, 3065, 3066, 3067, 3068, 3070, 3071, 3072, 3073, 3074, 3075, 3076, 3077, 3079, 3080, 3081, 3082, 3083, 3084, 3086, 3087, 3088, 3089, 3090, 3091, 3093, 3094, 3095, 3096, 3097, 3098, 3099, 3100, 3101, 3102, 3103, 3104, 3105, 3106, 3107, 3108, 3109, 3110, 3111, 3112, 3113, 3114, 3115, 3116, 3118, 3119, 3120, 3121, 3122, 3123, 3124, 3125, 3126, 3127, 3128, 3131, 3132, 3133, 3134, 3135, 3136, 3137, 3138, 3139, 3142, 3143, 3144, 3146, 3147, 3149, 3150, 3151, 3152, 3153, 3155, 3156, 3157, 3158, 3159, 3160, 3162, 3163, 3164, 3165, 3166, 3167, 3169, 3170, 3171, 3172, 3173, 3174, 3175, 3176, 3177, 3178, 3179, 3180, 3181, 3182, 3183, 3184, 3185, 3186, 3187, 3188, 3189, 3190, 3191, 3192, 3193, 3194, 3195, 3196, 3197, 3198, 3199, 3200, 3201, 3202, 3203, 3204, 3205, 3206, 3208, 3210, 3212, 3213, 3214, 3215, 3216, 3217, 3218, 3219, 3223, 3224, 3226, 3227, 3231, 3232, 3233, 3236, 3240, 3242, 3243, 3245, 3247, 3251, 3252, 3254, 3255, 3259, 3260, 3261, 3262, 3263, 3269, 3270, 3279, 3280, 3281, 3282, 3283, 3284, 3285, 3286, 3287, 3288, 3289, 3292, 3293, 3295, 3296, 3298, 3299, 3301, 3302, 3304, 3310, 3311, 3312, 3313, 3314, 3316, 3317, 3319, 3320, 3321, 3322, 3323, 3325, 3326, 3327, 3329, 3330, 3331, 3332, 3333, 3334, 3335, 3337, 3338, 3339, 3340, 3341, 3342, 3343, 3344, 3345, 3346, 3347, 3349, 3350, 3351, 3353, 3354, 3355, 3356, 3357, 3358, 3359, 3360, 3362, 3363, 3364, 3366, 3367, 3368, 3369, 3370, 3371, 3372, 3373, 3374, 3375, 3376, 3377, 3378, 3379, 3380, 3381, 3382, 3383, 3384, 3386, 3388, 3389, 3390, 3391, 3392, 3393, 3394, 3396, 3397, 3398, 3399, 3400, 3401, 3402, 3403, 3404, 3405, 3406, 3407, 3408, 3410, 3411, 3412, 3413, 3414, 3415, 3416, 3417, 3418, 3419, 3421, 3422, 3423, 3424, 3426, 3427, 3428, 3429, 3431, 3432, 3434, 3435, 3436, 3437, 3438, 3439, 3440, 3441, 3442, 3443, 3445, 3447, 3448, 3449, 3451, 3452, 3453, 3457, 3459, 3460, 3461, 3465, 3467, 3469, 3470, 3472, 3473, 3474, 3476, 3477, 3480, 3481, 3487, 3489, 3490, 3491, 3492, 3493, 3494, 3497, 3498, 3501, 3504, 3505, 3506, 3510, 3511, 3513, 3514, 3515, 3516, 3519, 3520, 3521, 3523, 3526, 3528, 3530, 3531, 3533, 3534, 3535, 3539, 3540, 3541, 3543, 3544, 3545, 3547, 3548, 3549, 3552, 3553, 3556, 3557, 3558, 3562, 3563, 3564, 3565, 3566, 3567, 3568, 3569, 3570, 3571, 3572, 3573, 3574, 3575, 3576, 3577, 3578, 3580, 3581, 3582, 3583, 3584, 3585, 3586, 3588, 3589, 3591, 3592, 3593, 3594, 3595, 3596, 3598, 3599, 3600, 3601, 3602, 3603, 3604, 3605, 3606, 3607, 3608, 3609, 3610, 3611, 3612, 3613, 3614, 3616, 3617, 3618, 3620, 3621, 3622, 3623, 3624, 3625, 3626, 3627, 3628, 3629, 3630, 3631, 3632, 3633, 3634, 3635, 3636, 3637, 3638, 3639, 3640, 3642, 3644, 3645, 3646, 3647, 3648, 3649, 3650, 3651, 3652, 3653, 3655, 3656, 3657, 3658, 3660, 3661, 3662, 3663, 3665, 3666, 3667, 3669, 3670, 3671, 3672, 3673, 3674, 3675, 3676, 3677, 3681, 3683, 3684, 3686, 3687, 3689, 3690, 3691, 3692, 3694, 3696, 3697, 3699, 3700, 3701, 3702, 3703, 3704, 3707, 3708, 3709, 3711, 3712, 3713, 3718, 3719, 3721, 3722, 3724, 3728, 3730, 3731, 3733, 3734, 3735, 3737, 3739, 3740, 3743, 3744, 3748, 3749, 3750, 3751, 3752, 3753, 3754, 3756, 3757, 3759, 3765, 3766, 3767, 3769, 3770, 3772, 3773, 3774, 3775, 3778, 3781, 3782, 3784, 3787, 3788, 3791, 3793, 3795, 3796, 3798, 3800, 3802, 3803, 3806, 3807, 3808, 3809, 3810, 3817, 3818, 3820, 3821, 3822, 3826, 3828, 3829, 3831, 3832, 3834, 3835, 3836, 3837, 3838, 3839, 3840, 3843, 3845, 3846, 3847, 3850, 3852, 3856, 3857, 3858, 3859, 3868, 3869, 3871, 3874, 3884, 3893, 3898, 3899, 3900, 3901, 3902, 3903, 3907, 3912, 3919, 3921, 3922, 3923, 3926, 3927, 3928, 3929, 3930, 3932, 3933, 3934, 3936, 3937, 3938, 3941, 3943, 3944, 3945, 3946, 3951, 3954, 3955, 3956, 3958, 3959, 3960, 3962, 3964, 3965, 3966, 3969, 3972, 3974, 3975, 3976, 3977, 3982, 3983, 3984, 3985, 3986, 3987, 3989, 3990, 3992, 3996, 3997, 3999, 4001, 4003, 4006, 4007, 4008, 4009, 4010, 4011, 4012, 4013, 4014, 4016, 4017, 4018, 4020, 4021, 4022, 4023, 4024, 4026, 4027, 4028, 4029, 4030, 4033, 4034, 4037, 4038, 4041, 4043, 4044, 4045, 4049, 4050, 4054, 4055, 4056, 4058, 4059, 4060, 4061, 4062, 4067, 4071, 4072, 4073, 4074, 4075, 4076, 4077, 4078, 4079, 4081, 4082, 4083, 4085, 4087, 4088, 4090, 4091, 4092, 4093, 4094, 4095, 4096, 4097, 4098, 4104, 4105, 4106, 4107, 4108, 4109, 4111, 4112, 4113, 4114, 4115, 4118, 4119, 4120, 4121, 4122, 4123, 4124, 4125, 4126, 4127, 4128, 4129, 4131, 4132, 4133, 4134, 4135, 4136, 4137, 4138, 4139, 4140, 4141, 4143, 4144, 4145, 4147, 4148, 4149, 4150, 4151, 4152, 4153, 4154, 4155, 4156, 4157, 4158, 4159, 4160, 4161, 4163, 4164, 4165, 4166, 4167, 4168, 4169, 4170, 4171, 4172, 4173, 4174, 4175, 4176, 4177, 4178, 4179, 4181, 4182, 4183, 4184, 4185, 4188, 4189, 4190, 4191, 4192, 4194, 4195, 4196, 4197, 4198, 4200, 4201, 4202, 4203, 4205, 4206, 4208, 4212, 4213, 4214, 4215, 4216, 4217, 4218, 4219, 4222, 4223, 4224, 4225, 4226, 4227, 4228, 4229, 4230, 4231, 4232, 4233, 4234, 4235, 4237, 4238, 4239, 4240, 4241, 4242, 4243, 4244, 4245, 4246, 4247, 4248, 4249, 4250, 4251, 4253, 4254, 4255, 4256, 4257, 4258, 4259, 4260, 4261, 4262, 4263, 4264, 4265, 4266, 4267, 4269, 4270, 4271, 4272, 4273, 4275, 4276, 4277, 4278, 4279, 4280, 4281, 4283, 4284, 4286, 4287, 4288, 4289, 4290, 4292, 4293, 4294, 4295, 4297, 4298, 4299, 4300, 4301, 4302, 4303, 4304, 4305, 4306, 4307, 4308, 4309, 4310, 4311, 4312, 4313, 4314, 4315, 4316, 4317, 4318, 4319, 4320, 4321, 4322, 4323, 4325, 4326, 4327, 4328, 4329, 4330, 4331, 4333, 4334, 4335, 4336, 4337, 4339, 4340, 4341, 4342, 4343, 4344, 4345, 4346, 4347, 4348, 4349, 4350, 4351, 4352, 4353, 4354, 4356, 4357, 4359, 4361, 4362, 4363, 4364, 4365, 4366, 4367, 4368, 4369, 4370, 4371, 4372, 4373, 4374, 4375, 4376, 4377, 4378, 4380, 4381, 4382, 4383, 4384, 4385, 4387, 4388, 4389, 4390, 4391, 4394, 4395, 4396, 4397, 4399, 4400, 4401, 4402, 4403, 4404, 4405, 4406, 4407, 4408, 4409, 4410, 4411, 4412, 4413, 4414, 4415, 4416, 4417, 4418, 4419, 4420, 4421, 4422, 4423, 4424, 4425, 4426, 4427, 4428, 4430, 4432, 4433, 4434, 4435, 4436, 4437, 4438, 4439, 4440, 4441, 4443, 4444, 4446, 4448, 4449, 4452, 4453, 4455, 4456, 4457, 4459, 4460, 4461, 4463, 4466, 4467, 4468, 4471, 4473, 4474, 4477, 4478, 4479, 4480, 4481, 4491, 4495, 4497, 4498, 4499, 4500, 4501, 4502, 4503, 4504, 4505, 4506, 4507, 4508, 4509, 4510, 4511, 4512, 4513, 4516, 4517, 4519, 4520, 4521, 4522, 4523, 4525, 4526, 4527, 4528, 4529, 4530, 4531, 4532, 4533, 4534, 4535, 4536, 4543, 4546, 4548, 4554, 4560, 4561, 4564, 4565, 4571, 4573, 4574, 4576, 4579, 4580, 4581, 4582, 4583, 4584, 4585, 4586, 4587, 4590, 4591, 4593, 4594, 4596, 4597, 4599, 4600, 4601, 4602, 4603, 4604, 4605, 4608, 4610, 4611, 4612, 4613, 4614, 4615, 4616, 4618, 4619, 4620, 4623, 4625, 4628, 4629, 4630, 4632, 4633, 4634, 4635, 4636, 4637, 4639, 4641, 4642, 4643, 4644, 4645, 4646, 4648, 4651, 4652, 4653, 4655, 4658, 4659, 4660, 4661, 4662, 4665, 4666, 4667, 4668, 4670, 4671, 4672, 4674, 4675, 4678, 4679, 4681, 4682, 4683, 4684, 4685, 4686, 4688, 4689, 4691, 4693, 4694, 4695, 4696, 4697, 4720, 4722, 4723, 4724, 4726, 4728, 4730, 4731, 4732, 4733, 4734, 4736, 4737, 4738, 4742, 4744, 4745, 4746, 4749, 4751, 4754, 4756, 4758, 4759, 4760, 4761, 4762, 4763, 4768, 4770, 4771, 4775, 4778, 4781, 4783, 4789, 4792, 4796, 4797, 4800, 4801, 4802, 4804, 4805, 4806, 4808, 4809, 4811, 4813, 4814, 4818, 4819, 4820, 4821, 4822, 4823, 4826, 4831, 4832, 4834, 4837, 4841, 4843, 4847, 4849, 4850, 4851, 4852, 4853, 4854, 4855, 4856, 4857, 4860, 4862, 4863, 4866, 4868, 4869, 4871, 4873, 4874, 4875, 4877, 4879, 4880, 4881, 4882, 4883, 4885, 4889, 4890, 4891, 4898, 4899, 4901, 4902, 4905, 4907, 4909, 4912, 4914, 4915, 4917, 4918, 4921, 4922, 4925, 4927, 4930, 4931, 4932, 4936, 4940, 4942, 4948, 4950, 4951, 4953, 4954, 4955, 4957, 4958, 4959, 4960, 4962, 4963, 4969, 4971, 4977, 4981, 4983, 4987, 4988, 4989, 4990, 4991, 4993, 4995, 5000, 5009, 5010, 5015, 5020, 5021, 5023, 5029, 5033, 5034, 5035, 5046, 5047, 5049, 5050, 5052, 5055, 5056, 5057, 5059, 5060, 5061, 5063, 5064, 5065, 5070, 5079, 5100, 5103, 5104, 5106, 5112, 5113, 5115, 5118, 5119, 5120, 5123, 5130, 5131, 5133, 5135, 5137, 5138, 5141, 5142, 5144, 5145, 5148, 5150, 5151, 5152, 5155, 5157, 5158, 5159, 5161, 5162, 5166, 5167, 5170, 5176, 5179, 5185, 5188, 5190, 5191, 5194, 5195, 5196, 5204, 5213, 5220, 5221, 5225, 5237, 5240, 5241, 5242, 5243, 5245, 5247, 5249, 5250, 5251, 5252, 5256, 5257, 5258, 5259, 5260, 5262, 5263, 5264, 5265, 5266, 5267, 5269, 5271, 5272, 5276, 5277, 5278, 5279, 5280, 5281, 5282, 5283, 5286, 5287, 5288, 5289, 5290, 5291, 5292, 5294, 5295, 5296, 5297, 5298, 5299, 5300, 5301, 5302, 5303, 5304, 5305, 5306, 5307, 5308, 5309, 5310, 5311, 5313, 5314, 5316, 5317, 5323, 5324, 5325, 5326, 5327, 5329, 5330, 5331, 5334, 5335, 5337, 5338, 5341, 5342, 5343, 5345, 5346, 5347, 5348, 5352, 5353, 5354, 5355, 5356, 5357, 5358, 5361, 5362, 5363, 5365, 5366, 5367, 5368, 5371, 5377, 5378, 5381, 5386, 5387, 5388, 5389, 5390, 5392, 5393, 5396, 5397, 5400, 5401, 5406, 5408, 5410, 5412, 5413, 5416, 5418, 5420, 5422, 5423, 5424, 5425, 5426, 5428, 5429, 5432, 5433, 5434, 5435, 5439, 5440, 5441, 5444, 5446, 5447, 5450, 5451, 5452, 5453, 5455, 5456, 5457, 5458, 5460, 5464, 5467, 5469, 5470, 5473, 5474, 5475, 5478, 5479, 5480, 5481, 5482, 5483, 5484, 5488, 5489, 5492, 5494, 5495, 5497, 5498, 5500, 5503, 5504, 5506, 5510, 5513, 5514, 5515, 5519, 5521, 5522, 5526, 5527, 5530, 5532, 5533, 5534, 5535, 5536, 5537, 5538, 5539, 5540, 5541, 5543, 5547, 5548, 5549, 5550, 5552, 5554, 5555, 5557, 5560, 5561, 5568, 5569, 5571, 5573, 5574, 5576, 5577, 5580, 5582, 5583, 5584, 5588, 5591, 5592, 5596, 5597, 5598, 5601, 5602, 5604, 5606, 5607, 5614, 5615, 5616, 5620, 5625, 5626, 5627, 5628, 5629, 5630, 5634, 5635, 5639, 5642, 5643, 5646, 5648, 5649, 5650, 5651, 5661, 5662, 5670, 5673, 5674, 5677, 5679, 5682, 5684, 5685, 5688, 5690, 5695, 5697, 5701, 5702, 5704, 5706, 5708, 5711, 5713, 5714, 5717, 5718, 5720, 5721, 5722, 5723, 5728, 5729, 5731, 5732, 5733, 5734, 5735, 5739, 5740, 5741, 5742, 5743, 5744, 5749, 5752, 5753, 5754, 5755, 5759, 5761, 5766, 5767, 5768, 5769, 5773, 5774, 5775, 5776, 5777, 5781, 5782, 5783, 5784, 5787, 5789, 5792, 5793, 5794, 5795, 5796, 5797, 5798, 5799, 5801, 5802, 5804, 5808, 5809, 5810, 5811, 5813, 5814, 5815, 5816, 5817, 5819, 5821, 5822, 5823, 5826, 5827, 5828, 5830, 5831, 5832, 5834, 5836, 5837, 5839, 5840, 5854, 5855, 5856, 5857, 5859, 5864, 5865, 5866, 5870, 5874, 5876, 5877, 5878, 5880, 5881, 5882, 5886, 5887, 5888, 5891, 5893, 5897, 5899, 5900, 5902, 5903, 5905, 5907, 5910, 5912, 5915, 5918, 5919, 5920, 5921, 5924, 5925, 5926, 5928, 5932, 5933, 5935, 5938, 5940, 5945, 5952, 5953, 5954, 5963, 5981, 5986, 5999, 6001, 6009, 6015, 6016, 6017, 6018, 6019, 6021, 6025, 6027, 6029, 6030, 6031, 6034, 6036, 6037, 6040, 6041, 6044, 6045, 6046, 6047, 6048, 6049, 6051, 6055, 6057, 6058, 6059, 6060, 6061, 6063, 6064, 6065, 6067, 6068, 6069, 6070, 6071, 6072, 6074, 6075, 6078, 6079, 6081, 6083, 6084, 6085, 6086, 6087, 6088, 6091, 6092, 6093, 6094, 6095, 6096, 6097, 6101, 6102, 6103, 6104, 6106, 6108, 6109, 6111, 6113, 6116, 6119, 6121, 6122, 6123, 6124, 6126, 6127, 6128, 6129, 6130, 6133, 6134, 6139, 6141, 6142, 6143, 6144, 6145, 6146, 6147, 6148, 6149, 6150, 6151, 6152, 6153, 6154, 6155, 6156, 6157, 6159, 6160, 6162, 6163, 6165, 6166, 6168, 6169, 6170, 6171, 6172, 6173, 6174, 6178, 6181, 6182, 6183, 6184, 6185, 6192, 6193, 6195, 6198, 6200, 6201, 6205, 6216, 6217, 6221, 6222, 6226, 6228, 6229, 6234, 6235, 6236, 6237, 6238, 6239, 6240, 6241, 6242, 6243, 6244, 6246, 6249, 6253, 6254, 6255, 6256, 6258, 6259, 6260, 6261, 6262, 6263, 6264, 6265, 6267, 6272, 6274, 6277, 6285, 6289, 6290, 6291, 6296, 6334, 6353, 6359, 6372, 6376, 6388, 6389, 6450, 6455, 6493, 6532, 6533, 6582, 6615, 6616, 6617, 6633, 6639, 6640, 6646, 6647, 6654, 6665, 6667, 6691, 6692, 6695, 6700, 6703, 6704, 6705, 6706, 6709, 6711, 6712, 6714, 6715, 6717, 6718, 6719, 6720, 6721, 6722, 6723, 6724, 6725, 6726, 6727, 6729, 6730, 6731, 6732, 6733, 6734, 6735, 6736, 6737, 6738, 6739, 6740, 6741, 6742, 6743, 6744, 6745, 6747, 6748, 6750, 6751, 6752, 6753, 6754, 6755, 6756, 6757, 6759, 6760, 6762, 6764, 6765, 6766, 6767, 6768, 6769, 6770, 6771, 6773, 6774, 6775, 6776, 6777, 6778, 6779, 6780, 6781, 6782, 6783, 6784, 6785, 6786, 6787, 6788, 6789, 6790, 6791, 6792, 6793}",4320
1,"(('enter', ('Request Payment', 'Payment Handled')),)",1,53,"{0, 1, 2, 3, 4, 5, 6, 7, 8, 9, 10, 11, 12, 13, 14, 15, 16, 17, 18, 20, 21, 22, 23, 24, 25, 27, 28, 29, 30, 31, 32, 33, 34, 35, 36, 37, 38, 39, 42, 43, 44, 45, 46, 47, 48, 49, 50, 51, 52, 53, 54, 55, 56, 57, 58, 59, 60, 61, 62, 64, 65, 66, 67, 68, 69, 70, 71, 72, 73, 74, 75, 78, 79, 80, 81, 83, 84, 85, 86, 88, 89, 90, 91, 92, 93, 94, 95, 96, 97, 98, 99, 100, 101, 102, 103, 104, 105, 106, 107, 108, 109, 110, 111, 112, 113, 114, 115, 116, 117, 118, 123, 124, 125, 126, 127, 128, 129, 130, 131, 132, 133, 134, 135, 136, 137, 138, 139, 140, 141, 143, 144, 145, 146, 147, 148, 149, 150, 151, 153, 154, 155, 156, 158, 159, 160, 161, 162, 163, 164, 165, 166, 167, 168, 169, 171, 172, 175, 176, 179, 180, 181, 182, 183, 184, 185, 186, 187, 188, 189, 190, 191, 192, 193, 194, 195, 196, 198, 199, 200, 201, 202, 203, 204, 205, 206, 207, 208, 209, 210, 211, 212, 213, 214, 215, 216, 217, 218, 219, 220, 221, 222, 223, 224, 225, 226, 227, 228, 229, 230, 231, 232, 234, 235, 236, 237, 238, 239, 240, 241, 242, 243, 244, 245, 246, 247, 248, 249, 250, 251, 252, 253, 254, 256, 257, 258, 259, 260, 261, 262, 263, 264, 265, 266, 267, 268, 269, 271, 272, 273, 274, 275, 276, 277, 278, 279, 280, 281, 282, 283, 284, 285, 286, 287, 288, 289, 290, 291, 292, 293, 294, 295, 296, 297, 298, 300, 301, 302, 303, 305, 307, 310, 311, 312, 313, 314, 315, 316, 317, 318, 321, 322, 323, 324, 325, 326, 327, 331, 332, 333, 334, 335, 336, 337, 338, 339, 340, 341, 342, 343, 344, 345, 346, 348, 349, 350, 351, 352, 353, 356, 357, 358, 359, 360, 361, 362, 363, 364, 365, 366, 367, 368, 369, 370, 372, 373, 375, 376, 377, 378, 379, 380, 382, 383, 384, 385, 386, 387, 388, 389, 390, 391, 392, 393, 394, 395, 396, 397, 398, 399, 400, 401, 402, 403, 404, 405, 406, 407, 408, 409, 410, 411, 414, 415, 416, 417, 418, 419, 420, 421, 422, 423, 424, 425, 426, 427, 428, 429, 430, 431, 433, 434, 435, 436, 437, 438, 439, 440, 441, 443, 444, 445, 446, 447, 449, 450, 451, 452, 453, 454, 456, 457, 458, 459, 460, 461, 462, 463, 464, 465, 466, 467, 468, 469, 470, 471, 472, 473, 474, 475, 476, 477, 478, 479, 481, 482, 483, 484, 486, 487, 488, 489, 490, 491, 492, 493, 494, 495, 496, 497, 498, 499, 500, 501, 502, 503, 504, 505, 506, 507, 508, 509, 510, 511, 512, 513, 514, 515, 516, 518, 519, 520, 521, 522, 523, 524, 525, 526, 527, 528, 530, 531, 532, 533, 534, 535, 536, 537, 538, 539, 540, 541, 542, 543, 544, 545, 546, 547, 548, 549, 550, 551, 552, 553, 554, 555, 556, 557, 558, 559, 560, 561, 562, 563, 564, 565, 566, 567, 568, 569, 570, 571, 572, 573, 574, 575, 576, 577, 578, 580, 582, 583, 584, 585, 586, 590, 591, 592, 593, 594, 596, 597, 598, 599, 600, 601, 602, 603, 604, 605, 606, 607, 608, 609, 610, 611, 612, 613, 614, 616, 617, 618, 620, 621, 622, 623, 624, 625, 626, 627, 628, 629, 631, 632, 633, 634, 635, 636, 637, 638, 639, 640, 641, 642, 643, 644, 645, 646, 647, 648, 649, 650, 651, 652, 653, 654, 655, 656, 657, 658, 659, 660, 661, 662, 663, 664, 665, 666, 667, 668, 669, 670, 671, 672, 673, 674, 675, 676, 677, 678, 679, 680, 681, 682, 683, 684, 685, 686, 687, 688, 689, 690, 693, 695, 696, 697, 698, 699, 700, 701, 702, 703, 704, 705, 706, 707, 708, 709, 710, 711, 712, 713, 714, 715, 716, 717, 718, 719, 720, 721, 722, 723, 724, 725, 726, 727, 728, 729, 730, 731, 732, 733, 734, 735, 736, 737, 738, 739, 740, 741, 742, 743, 744, 745, 746, 748, 749, 750, 751, 752, 753, 754, 755, 756, 757, 758, 759, 760, 761, 762, 763, 764, 765, 766, 767, 768, 769, 770, 771, 773, 774, 775, 776, 777, 778, 779, 780, 781, 782, 783, 784, 785, 786, 787, 788, 789, 790, 791, 792, 794, 795, 796, 797, 798, 799, 800, 801, 802, 803, 804, 805, 806, 807, 808, 809, 810, 811, 812, 813, 814, 815, 816, 817, 819, 820, 821, 824, 825, 826, 828, 829, 830, 831, 832, 833, 834, 835, 836, 837, 838, 839, 840, 841, 842, 843, 844, 845, 846, 847, 848, 849, 850, 851, 852, 854, 855, 856, 857, 858, 859, 860, 861, 862, 864, 865, 866, 867, 868, 869, 870, 871, 872, 873, 874, 875, 876, 877, 878, 879, 880, 881, 882, 883, 884, 885, 886, 887, 888, 889, 890, 891, 892, 893, 894, 895, 896, 897, 898, 899, 900, 901, 902, 903, 904, 905, 906, 907, 908, 909, 910, 911, 912, 913, 914, 915, 916, 917, 918, 919, 920, 921, 922, 923, 924, 925, 926, 927, 928, 929, 930, 931, 932, 933, 935, 936, 937, 939, 940, 941, 942, 943, 944, 945, 946, 947, 948, 949, 950, 951, 952, 953, 954, 955, 956, 957, 958, 959, 960, 961, 962, 963, 964, 965, 966, 967, 968, 969, 970, 971, 972, 973, 974, 975, 976, 977, 978, 979, 980, 981, 982, 983, 984, 985, 986, 987, 988, 989, 990, 991, 992, 993, 994, 996, 997, 998, 999, 1000, 1001, 1002, 1003, 1004, 1005, 1006, 1007, 1008, 1009, 1010, 1011, 1012, 1013, 1014, 1015, 1016, 1017, 1018, 1019, 1020, 1021, 1022, 1023, 1024, 1025, 1026, 1028, 1029, 1030, 1031, 1032, 1033, 1034, 1036, 1037, 1038, 1039, 1040, 1041, 1042, 1043, 1044, 1045, 1046, 1047, 1048, 1050, 1051, 1052, 1053, 1054, 1055, 1056, 1057, 1058, 1059, 1060, 1061, 1063, 1064, 1065, 1066, 1067, 1069, 1070, 1071, 1072, 1073, 1074, 1075, 1076, 1077, 1078, 1079, 1080, 1081, 1082, 1083, 1085, 1086, 1087, 1088, 1089, 1090, 1092, 1093, 1094, 1095, 1096, 1097, 1098, 1099, 1100, 1101, 1103, 1104, 1105, 1106, 1107, 1108, 1109, 1110, 1111, 1112, 1113, 1114, 1115, 1116, 1117, 1118, 1119, 1120, 1121, 1122, 1123, 1124, 1125, 1126, 1127, 1128, 1129, 1130, 1131, 1132, 1133, 1134, 1135, 1136, 1137, 1138, 1139, 1140, 1141, 1142, 1143, 1144, 1145, 1146, 1147, 1148, 1149, 1150, 1151, 1152, 1153, 1154, 1155, 1156, 1157, 1158, 1159, 1160, 1161, 1162, 1163, 1164, 1165, 1166, 1167, 1168, 1169, 1170, 1171, 1172, 1173, 1174, 1175, 1176, 1177, 1178, 1179, 1180, 1181, 1182, 1183, 1184, 1185, 1186, 1187, 1188, 1189, 1190, 1191, 1192, 1193, 1194, 1195, 1196, 1197, 1198, 1199, 1200, 1201, 1202, 1203, 1204, 1205, 1206, 1207, 1208, 1209, 1210, 1211, 1212, 1213, 1214, 1215, 1216, 1217, 1218, 1219, 1220, 1221, 1222, 1223, 1224, 1225, 1226, 1227, 1228, 1229, 1230, 1231, 1232, 1233, 1234, 1235, 1236, 1237, 1238, 1239, 1240, 1241, 1242, 1243, 1244, 1245, 1246, 1247, 1248, 1249, 1250, 1251, 1252, 1253, 1254, 1255, 1258, 1259, 1260, 1262, 1263, 1264, 1265, 1267, 1268, 1269, 1270, 1271, 1272, 1273, 1274, 1275, 1276, 1277, 1278, 1279, 1280, 1281, 1282, 1283, 1284, 1285, 1286, 1287, 1288, 1289, 1290, 1291, 1292, 1293, 1294, 1295, 1297, 1298, 1299, 1300, 1301, 1302, 1303, 1304, 1305, 1306, 1307, 1308, 1309, 1310, 1311, 1313, 1314, 1315, 1316, 1317, 1318, 1320, 1321, 1323, 1324, 1325, 1326, 1327, 1328, 1329, 1330, 1331, 1332, 1333, 1334, 1335, 1336, 1337, 1338, 1339, 1340, 1342, 1343, 1344, 1345, 1346, 1347, 1348, 1349, 1350, 1351, 1352, 1353, 1354, 1355, 1356, 1357, 1358, 1359, 1360, 1361, 1362, 1363, 1364, 1365, 1366, 1367, 1368, 1369, 1370, 1371, 1372, 1373, 1374, 1375, 1376, 1377, 1378, 1379, 1380, 1381, 1382, 1383, 1384, 1385, 1386, 1387, 1388, 1389, 1390, 1391, 1392, 1393, 1394, 1395, 1396, 1397, 1399, 1400, 1401, 1402, 1403, 1404, 1405, 1406, 1407, 1408, 1409, 1410, 1411, 1412, 1413, 1414, 1415, 1416, 1418, 1419, 1420, 1421, 1422, 1423, 1424, 1426, 1427, 1428, 1429, 1430, 1431, 1432, 1433, 1434, 1435, 1436, 1437, 1439, 1440, 1441, 1442, 1443, 1445, 1446, 1447, 1448, 1449, 1450, 1451, 1452, 1453, 1454, 1455, 1456, 1457, 1458, 1459, 1460, 1461, 1462, 1464, 1465, 1466, 1467, 1468, 1469, 1470, 1471, 1472, 1473, 1474, 1475, 1476, 1477, 1478, 1479, 1481, 1482, 1483, 1484, 1485, 1487, 1488, 1489, 1490, 1491, 1492, 1493, 1494, 1495, 1496, 1499, 1500, 1501, 1502, 1503, 1504, 1505, 1506, 1507, 1508, 1509, 1510, 1511, 1512, 1513, 1514, 1515, 1516, 1517, 1518, 1519, 1520, 1521, 1522, 1523, 1524, 1525, 1526, 1527, 1528, 1529, 1530, 1531, 1532, 1533, 1534, 1535, 1536, 1538, 1539, 1540, 1541, 1542, 1543, 1544, 1545, 1546, 1548, 1549, 1550, 1551, 1552, 1553, 1554, 1556, 1557, 1558, 1559, 1560, 1561, 1562, 1563, 1564, 1565, 1566, 1567, 1568, 1569, 1570, 1571, 1572, 1573, 1574, 1575, 1576, 1577, 1578, 1579, 1580, 1581, 1582, 1583, 1584, 1585, 1586, 1587, 1588, 1589, 1590, 1591, 1592, 1593, 1594, 1595, 1596, 1597, 1598, 1599, 1600, 1601, 1602, 1603, 1604, 1605, 1606, 1607, 1608, 1609, 1610, 1612, 1613, 1614, 1615, 1616, 1617, 1618, 1619, 1620, 1621, 1622, 1623, 1624, 1625, 1626, 1627, 1628, 1629, 1630, 1631, 1632, 1633, 1634, 1635, 1636, 1637, 1638, 1639, 1640, 1641, 1642, 1643, 1644, 1645, 1646, 1647, 1648, 1649, 1650, 1651, 1652, 1653, 1654, 1655, 1656, 1657, 1658, 1659, 1660, 1661, 1662, 1663, 1664, 1665, 1666, 1667, 1668, 1669, 1670, 1671, 1672, 1673, 1674, 1675, 1676, 1678, 1679, 1680, 1681, 1682, 1683, 1684, 1685, 1686, 1687, 1688, 1689, 1690, 1691, 1692, 1693, 1694, 1695, 1696, 1697, 1698, 1699, 1700, 1701, 1702, 1703, 1704, 1705, 1706, 1707, 1708, 1709, 1710, 1711, 1712, 1713, 1714, 1715, 1716, 1717, 1718, 1719, 1720, 1721, 1722, 1723, 1724, 1725, 1726, 1727, 1728, 1729, 1730, 1731, 1732, 1734, 1735, 1736, 1737, 1738, 1739, 1740, 1741, 1742, 1743, 1744, 1745, 1746, 1747, 1748, 1749, 1752, 1753, 1754, 1755, 1756, 1757, 1758, 1759, 1760, 1761, 1762, 1764, 1765, 1766, 1767, 1768, 1769, 1770, 1771, 1772, 1773, 1774, 1775, 1776, 1778, 1779, 1780, 1781, 1782, 1783, 1784, 1785, 1786, 1787, 1788, 1789, 1790, 1791, 1792, 1793, 1795, 1796, 1797, 1798, 1799, 1800, 1801, 1802, 1803, 1804, 1805, 1806, 1807, 1808, 1809, 1810, 1811, 1812, 1813, 1814, 1815, 1816, 1817, 1818, 1819, 1820, 1821, 1822, 1823, 1824, 1825, 1826, 1827, 1828, 1829, 1830, 1831, 1832, 1833, 1834, 1835, 1836, 1837, 1838, 1839, 1840, 1841, 1842, 1843, 1844, 1845, 1846, 1847, 1848, 1849, 1850, 1851, 1852, 1853, 1854, 1855, 1857, 1858, 1859, 1860, 1861, 1862, 1863, 1864, 1865, 1866, 1867, 1868, 1869, 1870, 1871, 1872, 1873, 1874, 1875, 1876, 1877, 1878, 1879, 1880, 1881, 1882, 1883, 1884, 1885, 1886, 1887, 1888, 1889, 1890, 1891, 1892, 1893, 1894, 1895, 1896, 1897, 1898, 1899, 1900, 1901, 1902, 1903, 1904, 1905, 1907, 1908, 1909, 1910, 1911, 1912, 1914, 1915, 1916, 1918, 1919, 1920, 1921, 1922, 1923, 1924, 1925, 1926, 1927, 1928, 1929, 1930, 1931, 1932, 1934, 1936, 1937, 1938, 1939, 1940, 1941, 1942, 1943, 1944, 1945, 1946, 1947, 1948, 1949, 1950, 1951, 1952, 1954, 1955, 1956, 1957, 1958, 1959, 1960, 1961, 1962, 1963, 1964, 1965, 1966, 1967, 1968, 1969, 1970, 1971, 1972, 1973, 1974, 1975, 1976, 1977, 1978, 1979, 1980, 1981, 1982, 1983, 1984, 1985, 1986, 1987, 1988, 1990, 1991, 1992, 1993, 1994, 1995, 1996, 1997, 1998, 1999, 2000, 2001, 2002, 2003, 2004, 2005, 2006, 2007, 2008, 2009, 2010, 2011, 2012, 2014, 2015, 2016, 2017, 2018, 2019, 2020, 2021, 2022, 2023, 2024, 2025, 2026, 2027, 2028, 2029, 2030, 2031, 2032, 2033, 2034, 2035, 2036, 2037, 2038, 2039, 2040, 2041, 2042, 2043, 2044, 2045, 2046, 2047, 2048, 2049, 2050, 2051, 2052, 2053, 2055, 2056, 2057, 2058, 2059, 2060, 2061, 2062, 2063, 2064, 2065, 2066, 2067, 2068, 2069, 2070, 2071, 2073, 2074, 2075, 2076, 2077, 2079, 2080, 2081, 2082, 2083, 2084, 2085, 2086, 2087, 2088, 2089, 2090, 2091, 2092, 2094, 2095, 2096, 2097, 2098, 2099, 2100, 2101, 2102, 2103, 2104, 2106, 2107, 2108, 2109, 2110, 2111, 2112, 2113, 2114, 2115, 2116, 2117, 2118, 2119, 2120, 2121, 2122, 2123, 2124, 2125, 2126, 2128, 2129, 2130, 2131, 2132, 2133, 2134, 2135, 2137, 2138, 2139, 2140, 2141, 2142, 2143, 2144, 2146, 2147, 2148, 2149, 2150, 2151, 2152, 2153, 2154, 2155, 2156, 2157, 2158, 2159, 2160, 2161, 2162, 2163, 2164, 2166, 2167, 2168, 2169, 2170, 2171, 2172, 2173, 2174, 2175, 2176, 2177, 2178, 2179, 2180, 2181, 2182, 2183, 2184, 2185, 2186, 2187, 2188, 2189, 2190, 2191, 2192, 2193, 2194, 2195, 2196, 2197, 2198, 2200, 2201, 2202, 2203, 2204, 2205, 2206, 2207, 2208, 2209, 2210, 2211, 2212, 2213, 2214, 2215, 2216, 2217, 2218, 2219, 2220, 2221, 2222, 2223, 2224, 2225, 2226, 2228, 2229, 2230, 2231, 2232, 2233, 2234, 2235, 2236, 2237, 2239, 2240, 2241, 2242, 2243, 2244, 2245, 2246, 2247, 2248, 2249, 2250, 2251, 2252, 2253, 2254, 2255, 2259, 2260, 2261, 2262, 2263, 2264, 2265, 2266, 2267, 2268, 2269, 2270, 2271, 2272, 2273, 2274, 2275, 2276, 2277, 2280, 2281, 2282, 2283, 2284, 2285, 2287, 2288, 2289, 2290, 2291, 2292, 2293, 2294, 2295, 2296, 2297, 2298, 2299, 2300, 2301, 2302, 2303, 2304, 2305, 2306, 2307, 2309, 2310, 2311, 2312, 2313, 2315, 2316, 2317, 2318, 2319, 2320, 2321, 2322, 2323, 2324, 2325, 2327, 2328, 2329, 2330, 2331, 2332, 2333, 2334, 2335, 2336, 2337, 2338, 2339, 2340, 2341, 2342, 2344, 2345, 2346, 2347, 2348, 2349, 2350, 2351, 2352, 2353, 2354, 2355, 2356, 2357, 2358, 2359, 2360, 2361, 2362, 2363, 2364, 2365, 2366, 2367, 2368, 2369, 2370, 2371, 2373, 2374, 2375, 2376, 2377, 2378, 2379, 2380, 2381, 2382, 2383, 2384, 2385, 2386, 2387, 2388, 2389, 2390, 2391, 2392, 2393, 2394, 2395, 2396, 2397, 2398, 2399, 2401, 2402, 2403, 2404, 2405, 2406, 2407, 2408, 2409, 2410, 2411, 2412, 2413, 2414, 2415, 2416, 2419, 2420, 2421, 2422, 2423, 2424, 2425, 2426, 2427, 2428, 2429, 2430, 2431, 2432, 2433, 2434, 2435, 2436, 2437, 2438, 2439, 2440, 2441, 2442, 2443, 2444, 2445, 2446, 2448, 2449, 2450, 2452, 2453, 2454, 2455, 2456, 2457, 2458, 2459, 2460, 2461, 2462, 2463, 2464, 2465, 2466, 2467, 2469, 2470, 2471, 2472, 2473, 2474, 2475, 2476, 2477, 2478, 2479, 2480, 2481, 2482, 2483, 2484, 2485, 2486, 2487, 2488, 2489, 2490, 2491, 2492, 2494, 2495, 2496, 2497, 2499, 2500, 2501, 2503, 2504, 2505, 2506, 2508, 2509, 2510, 2511, 2512, 2513, 2514, 2515, 2516, 2517, 2518, 2519, 2520, 2521, 2522, 2523, 2524, 2525, 2526, 2527, 2528, 2529, 2530, 2531, 2532, 2533, 2534, 2535, 2536, 2537, 2538, 2540, 2541, 2542, 2543, 2544, 2546, 2547, 2548, 2549, 2550, 2551, 2552, 2553, 2554, 2555, 2556, 2557, 2558, 2559, 2560, 2561, 2562, 2563, 2564, 2566, 2567, 2568, 2569, 2570, 2572, 2574, 2575, 2576, 2577, 2578, 2579, 2580, 2581, 2582, 2583, 2584, 2585, 2586, 2587, 2590, 2591, 2592, 2593, 2594, 2595, 2596, 2597, 2598, 2599, 2600, 2601, 2603, 2604, 2605, 2606, 2607, 2608, 2609, 2610, 2611, 2612, 2613, 2614, 2615, 2616, 2617, 2620, 2621, 2622, 2623, 2624, 2625, 2626, 2627, 2628, 2629, 2630, 2631, 2632, 2633, 2635, 2636, 2637, 2638, 2639, 2640, 2641, 2642, 2643, 2644, 2645, 2646, 2647, 2648, 2649, 2650, 2652, 2653, 2654, 2655, 2656, 2657, 2658, 2659, 2660, 2662, 2664, 2666, 2667, 2668, 2669, 2671, 2672, 2673, 2674, 2677, 2679, 2680, 2681, 2682, 2683, 2684, 2685, 2686, 2687, 2688, 2689, 2690, 2691, 2692, 2693, 2694, 2695, 2696, 2697, 2698, 2699, 2700, 2701, 2703, 2704, 2705, 2706, 2707, 2708, 2709, 2710, 2711, 2712, 2713, 2715, 2716, 2717, 2718, 2720, 2721, 2723, 2724, 2725, 2726, 2727, 2728, 2729, 2730, 2731, 2732, 2733, 2734, 2735, 2736, 2737, 2738, 2739, 2740, 2741, 2744, 2745, 2746, 2747, 2748, 2749, 2750, 2751, 2753, 2754, 2755, 2756, 2757, 2758, 2759, 2760, 2761, 2762, 2763, 2764, 2765, 2766, 2768, 2769, 2770, 2771, 2772, 2773, 2774, 2775, 2776, 2777, 2779, 2780, 2782, 2783, 2784, 2785, 2786, 2787, 2789, 2790, 2791, 2792, 2793, 2794, 2795, 2796, 2797, 2798, 2799, 2800, 2801, 2802, 2803, 2804, 2805, 2806, 2807, 2808, 2809, 2811, 2812, 2813, 2814, 2815, 2816, 2817, 2818, 2819, 2820, 2821, 2822, 2823, 2825, 2826, 2827, 2828, 2830, 2831, 2832, 2833, 2834, 2835, 2836, 2837, 2838, 2839, 2840, 2841, 2842, 2843, 2844, 2845, 2846, 2847, 2848, 2849, 2850, 2851, 2852, 2853, 2854, 2855, 2856, 2857, 2858, 2859, 2860, 2861, 2862, 2863, 2865, 2866, 2867, 2868, 2869, 2870, 2871, 2872, 2873, 2874, 2875, 2877, 2878, 2880, 2883, 2884, 2886, 2887, 2888, 2889, 2890, 2891, 2892, 2893, 2894, 2895, 2896, 2897, 2898, 2899, 2900, 2901, 2902, 2903, 2904, 2905, 2906, 2907, 2908, 2909, 2910, 2911, 2912, 2914, 2915, 2916, 2917, 2918, 2919, 2920, 2921, 2923, 2924, 2925, 2926, 2927, 2930, 2931, 2932, 2933, 2934, 2935, 2937, 2938, 2939, 2940, 2941, 2942, 2943, 2944, 2945, 2946, 2947, 2949, 2950, 2951, 2952, 2953, 2955, 2956, 2957, 2959, 2960, 2961, 2962, 2963, 2965, 2966, 2967, 2968, 2969, 2970, 2971, 2972, 2973, 2974, 2975, 2976, 2977, 2978, 2979, 2980, 2981, 2982, 2983, 2984, 2985, 2986, 2987, 2988, 2989, 2990, 2991, 2992, 2993, 2994, 2995, 2996, 2997, 2998, 2999, 3000, 3001, 3002, 3003, 3004, 3005, 3006, 3007, 3008, 3009, 3010, 3011, 3012, 3014, 3015, 3016, 3017, 3018, 3019, 3020, 3022, 3023, 3024, 3025, 3026, 3027, 3028, 3029, 3030, 3031, 3032, 3033, 3034, 3035, 3036, 3037, 3038, 3039, 3040, 3042, 3043, 3044, 3045, 3046, 3047, 3048, 3049, 3050, 3051, 3052, 3053, 3054, 3055, 3057, 3058, 3059, 3060, 3061, 3062, 3063, 3064, 3065, 3066, 3067, 3068, 3070, 3071, 3072, 3073, 3074, 3075, 3076, 3077, 3079, 3080, 3081, 3082, 3083, 3084, 3086, 3087, 3088, 3089, 3090, 3091, 3093, 3094, 3095, 3096, 3097, 3098, 3099, 3100, 3101, 3102, 3103, 3104, 3105, 3106, 3107, 3108, 3109, 3110, 3111, 3112, 3113, 3114, 3115, 3116, 3118, 3119, 3120, 3121, 3122, 3123, 3124, 3125, 3126, 3127, 3128, 3131, 3132, 3133, 3134, 3135, 3136, 3137, 3138, 3139, 3141, 3142, 3143, 3144, 3146, 3147, 3149, 3150, 3151, 3152, 3153, 3155, 3156, 3157, 3158, 3159, 3160, 3162, 3163, 3164, 3165, 3166, 3167, 3169, 3170, 3171, 3172, 3173, 3174, 3175, 3176, 3177, 3178, 3179, 3180, 3181, 3182, 3183, 3184, 3185, 3186, 3187, 3188, 3189, 3190, 3191, 3192, 3193, 3194, 3195, 3196, 3197, 3198, 3199, 3200, 3201, 3202, 3203, 3204, 3205, 3206, 3207, 3208, 3209, 3210, 3211, 3212, 3213, 3214, 3215, 3216, 3217, 3218, 3219, 3222, 3223, 3224, 3225, 3226, 3227, 3228, 3229, 3231, 3232, 3233, 3234, 3236, 3240, 3241, 3242, 3243, 3244, 3245, 3247, 3248, 3249, 3250, 3251, 3252, 3253, 3254, 3255, 3256, 3257, 3258, 3259, 3260, 3261, 3262, 3263, 3265, 3269, 3270, 3271, 3272, 3273, 3276, 3277, 3279, 3280, 3281, 3282, 3283, 3284, 3285, 3286, 3287, 3288, 3289, 3291, 3292, 3293, 3294, 3295, 3296, 3298, 3299, 3300, 3301, 3302, 3303, 3304, 3305, 3306, 3307, 3310, 3311, 3312, 3313, 3314, 3316, 3317, 3318, 3319, 3320, 3321, 3322, 3323, 3325, 3326, 3327, 3328, 3329, 3330, 3331, 3332, 3333, 3334, 3335, 3337, 3338, 3339, 3340, 3341, 3342, 3343, 3344, 3345, 3346, 3347, 3349, 3350, 3351, 3352, 3353, 3354, 3355, 3356, 3357, 3358, 3359, 3360, 3362, 3363, 3364, 3366, 3367, 3368, 3369, 3370, 3371, 3372, 3373, 3374, 3375, 3376, 3377, 3378, 3379, 3380, 3381, 3382, 3383, 3384, 3386, 3387, 3388, 3389, 3390, 3391, 3392, 3393, 3394, 3396, 3397, 3398, 3399, 3400, 3401, 3402, 3403, 3404, 3405, 3406, 3407, 3408, 3410, 3411, 3412, 3413, 3414, 3415, 3416, 3417, 3418, 3419, 3421, 3422, 3423, 3424, 3426, 3427, 3428, 3429, 3430, 3431, 3432, 3433, 3434, 3435, 3436, 3437, 3438, 3439, 3440, 3441, 3442, 3443, 3444, 3445, 3446, 3447, 3448, 3449, 3450, 3451, 3452, 3453, 3454, 3455, 3456, 3457, 3459, 3460, 3461, 3462, 3465, 3466, 3467, 3468, 3469, 3470, 3471, 3472, 3473, 3474, 3476, 3477, 3480, 3481, 3482, 3483, 3484, 3485, 3486, 3487, 3488, 3489, 3490, 3491, 3492, 3493, 3494, 3495, 3497, 3498, 3499, 3500, 3501, 3502, 3503, 3504, 3505, 3506, 3507, 3509, 3510, 3511, 3512, 3513, 3514, 3515, 3516, 3519, 3520, 3521, 3522, 3523, 3525, 3526, 3527, 3528, 3529, 3530, 3531, 3532, 3533, 3534, 3535, 3536, 3538, 3539, 3540, 3541, 3542, 3543, 3544, 3545, 3546, 3547, 3548, 3549, 3550, 3551, 3552, 3553, 3554, 3556, 3557, 3558, 3559, 3562, 3563, 3564, 3565, 3566, 3567, 3568, 3569, 3570, 3571, 3572, 3573, 3574, 3575, 3576, 3577, 3578, 3580, 3581, 3582, 3583, 3584, 3585, 3586, 3588, 3589, 3591, 3592, 3593, 3594, 3595, 3596, 3598, 3599, 3600, 3601, 3602, 3603, 3604, 3605, 3606, 3607, 3608, 3609, 3610, 3611, 3612, 3613, 3614, 3615, 3616, 3617, 3618, 3620, 3621, 3622, 3623, 3624, 3625, 3626, 3627, 3628, 3629, 3630, 3631, 3632, 3633, 3634, 3635, 3636, 3637, 3638, 3639, 3640, 3642, 3644, 3645, 3646, 3647, 3648, 3649, 3650, 3651, 3652, 3653, 3655, 3656, 3657, 3658, 3660, 3661, 3662, 3663, 3664, 3665, 3666, 3667, 3668, 3669, 3670, 3671, 3672, 3673, 3674, 3675, 3676, 3677, 3678, 3679, 3680, 3681, 3682, 3683, 3684, 3685, 3686, 3687, 3688, 3689, 3690, 3691, 3692, 3693, 3694, 3696, 3697, 3698, 3699, 3700, 3701, 3702, 3703, 3704, 3705, 3706, 3707, 3708, 3709, 3710, 3711, 3712, 3713, 3716, 3717, 3718, 3719, 3721, 3722, 3724, 3728, 3729, 3730, 3731, 3732, 3733, 3734, 3735, 3736, 3737, 3738, 3739, 3740, 3743, 3744, 3748, 3749, 3750, 3751, 3752, 3753, 3754, 3756, 3757, 3758, 3759, 3760, 3761, 3762, 3763, 3764, 3765, 3766, 3767, 3768, 3769, 3770, 3772, 3773, 3774, 3775, 3776, 3777, 3778, 3779, 3781, 3782, 3783, 3784, 3785, 3786, 3787, 3788, 3789, 3790, 3791, 3792, 3793, 3794, 3795, 3796, 3797, 3798, 3799, 3800, 3801, 3802, 3803, 3804, 3805, 3806, 3807, 3808, 3809, 3810, 3811, 3812, 3813, 3814, 3815, 3817, 3818, 3819, 3820, 3821, 3822, 3823, 3825, 3826, 3827, 3828, 3829, 3830, 3831, 3832, 3833, 3834, 3835, 3836, 3837, 3838, 3839, 3840, 3841, 3843, 3844, 3845, 3846, 3847, 3848, 3849, 3850, 3851, 3852, 3853, 3854, 3855, 3856, 3857, 3858, 3859, 3860, 3861, 3862, 3863, 3864, 3866, 3867, 3868, 3869, 3870, 3871, 3872, 3873, 3874, 3875, 3877, 3878, 3879, 3880, 3884, 3886, 3887, 3888, 3889, 3890, 3891, 3892, 3893, 3894, 3895, 3896, 3897, 3898, 3899, 3900, 3901, 3902, 3903, 3904, 3905, 3906, 3907, 3908, 3910, 3912, 3913, 3915, 3917, 3918, 3919, 3920, 3921, 3922, 3923, 3924, 3925, 3926, 3927, 3928, 3929, 3930, 3932, 3933, 3934, 3935, 3936, 3937, 3938, 3939, 3940, 3941, 3943, 3944, 3945, 3946, 3947, 3948, 3949, 3950, 3951, 3952, 3953, 3954, 3955, 3956, 3957, 3958, 3959, 3960, 3962, 3963, 3964, 3965, 3966, 3967, 3969, 3972, 3973, 3974, 3975, 3976, 3977, 3978, 3979, 3980, 3981, 3982, 3983, 3984, 3985, 3986, 3987, 3988, 3989, 3990, 3991, 3992, 3993, 3994, 3995, 3996, 3997, 3998, 3999, 4000, 4001, 4002, 4003, 4004, 4005, 4006, 4007, 4008, 4009, 4010, 4011, 4012, 4013, 4014, 4016, 4017, 4018, 4019, 4020, 4021, 4022, 4023, 4024, 4025, 4026, 4027, 4028, 4029, 4030, 4031, 4032, 4033, 4034, 4037, 4038, 4039, 4040, 4041, 4042, 4043, 4044, 4045, 4046, 4047, 4049, 4050, 4053, 4054, 4055, 4056, 4057, 4058, 4059, 4060, 4061, 4062, 4063, 4067, 4068, 4069, 4070, 4071, 4072, 4073, 4074, 4075, 4076, 4077, 4078, 4079, 4080, 4081, 4082, 4083, 4084, 4085, 4086, 4087, 4088, 4089, 4090, 4091, 4092, 4093, 4094, 4095, 4096, 4097, 4098, 4099, 4100, 4101, 4102, 4103, 4104, 4105, 4106, 4107, 4108, 4109, 4111, 4112, 4113, 4114, 4115, 4116, 4117, 4118, 4119, 4120, 4121, 4122, 4123, 4124, 4125, 4126, 4127, 4128, 4129, 4130, 4131, 4132, 4133, 4134, 4135, 4136, 4137, 4138, 4139, 4140, 4141, 4142, 4143, 4144, 4145, 4147, 4148, 4149, 4150, 4151, 4152, 4153, 4154, 4155, 4156, 4157, 4158, 4159, 4160, 4161, 4163, 4164, 4165, 4166, 4167, 4168, 4169, 4170, 4171, 4172, 4173, 4174, 4175, 4176, 4177, 4178, 4179, 4181, 4182, 4183, 4184, 4185, 4186, 4187, 4188, 4189, 4190, 4191, 4192, 4193, 4194, 4195, 4196, 4197, 4198, 4200, 4201, 4202, 4203, 4204, 4205, 4206, 4207, 4208, 4209, 4210, 4211, 4212, 4213, 4214, 4215, 4216, 4217, 4218, 4219, 4221, 4222, 4223, 4224, 4225, 4226, 4227, 4228, 4229, 4230, 4231, 4232, 4233, 4234, 4235, 4237, 4238, 4239, 4240, 4241, 4242, 4243, 4244, 4245, 4246, 4247, 4248, 4249, 4250, 4251, 4252, 4253, 4254, 4255, 4256, 4257, 4258, 4259, 4260, 4261, 4262, 4263, 4264, 4265, 4266, 4267, 4269, 4270, 4271, 4272, 4273, 4275, 4276, 4277, 4278, 4279, 4280, 4281, 4282, 4283, 4284, 4286, 4287, 4288, 4289, 4290, 4292, 4293, 4294, 4295, 4297, 4298, 4299, 4300, 4301, 4302, 4303, 4304, 4305, 4306, 4307, 4308, 4309, 4310, 4311, 4312, 4313, 4314, 4315, 4316, 4317, 4318, 4319, 4320, 4321, 4322, 4323, 4325, 4326, 4327, 4328, 4329, 4330, 4331, 4332, 4333, 4334, 4335, 4336, 4337, 4339, 4340, 4341, 4342, 4343, 4344, 4345, 4346, 4347, 4348, 4349, 4350, 4351, 4352, 4353, 4354, 4356, 4357, 4358, 4359, 4361, 4362, 4363, 4364, 4365, 4366, 4367, 4368, 4369, 4370, 4371, 4372, 4373, 4374, 4375, 4376, 4377, 4378, 4379, 4380, 4381, 4382, 4383, 4384, 4385, 4386, 4387, 4388, 4389, 4390, 4391, 4392, 4393, 4394, 4395, 4396, 4397, 4398, 4399, 4400, 4401, 4402, 4403, 4404, 4405, 4406, 4407, 4408, 4409, 4410, 4411, 4412, 4413, 4414, 4415, 4416, 4417, 4418, 4419, 4420, 4421, 4422, 4423, 4424, 4425, 4426, 4427, 4428, 4429, 4430, 4432, 4433, 4434, 4435, 4436, 4437, 4438, 4439, 4440, 4441, 4442, 4443, 4444, 4445, 4446, 4447, 4448, 4449, 4450, 4451, 4452, 4453, 4455, 4456, 4457, 4458, 4459, 4460, 4461, 4463, 4465, 4466, 4467, 4468, 4469, 4471, 4472, 4473, 4474, 4477, 4478, 4479, 4480, 4481, 4482, 4483, 4484, 4485, 4486, 4487, 4488, 4489, 4490, 4491, 4492, 4493, 4494, 4495, 4496, 4497, 4498, 4499, 4500, 4501, 4502, 4503, 4504, 4505, 4506, 4507, 4508, 4509, 4510, 4511, 4512, 4513, 4514, 4515, 4516, 4517, 4518, 4519, 4520, 4521, 4522, 4523, 4524, 4525, 4526, 4527, 4528, 4529, 4530, 4531, 4532, 4533, 4534, 4535, 4536, 4537, 4538, 4539, 4540, 4541, 4542, 4543, 4544, 4545, 4546, 4547, 4548, 4549, 4551, 4552, 4553, 4554, 4555, 4556, 4557, 4558, 4559, 4560, 4561, 4562, 4563, 4564, 4565, 4566, 4567, 4568, 4569, 4570, 4571, 4572, 4573, 4574, 4575, 4576, 4577, 4578, 4579, 4580, 4581, 4582, 4583, 4584, 4585, 4586, 4587, 4588, 4589, 4590, 4591, 4593, 4594, 4595, 4596, 4597, 4598, 4599, 4600, 4601, 4602, 4603, 4604, 4605, 4606, 4607, 4608, 4610, 4611, 4612, 4613, 4614, 4615, 4616, 4618, 4619, 4620, 4621, 4622, 4623, 4624, 4625, 4626, 4627, 4628, 4629, 4630, 4632, 4633, 4634, 4635, 4636, 4637, 4639, 4640, 4641, 4642, 4643, 4644, 4645, 4646, 4647, 4648, 4650, 4651, 4652, 4653, 4654, 4655, 4656, 4657, 4658, 4659, 4660, 4661, 4662, 4663, 4664, 4665, 4666, 4667, 4668, 4669, 4670, 4671, 4672, 4673, 4674, 4675, 4676, 4677, 4678, 4679, 4680, 4681, 4682, 4683, 4684, 4685, 4686, 4687, 4688, 4689, 4690, 4691, 4692, 4693, 4694, 4695, 4696, 4697, 4698, 4699, 4700, 4701, 4702, 4703, 4704, 4705, 4706, 4707, 4708, 4709, 4710, 4711, 4712, 4713, 4714, 4715, 4716, 4717, 4718, 4719, 4720, 4722, 4723, 4724, 4725, 4726, 4727, 4728, 4729, 4730, 4731, 4732, 4733, 4734, 4735, 4736, 4737, 4738, 4739, 4740, 4741, 4742, 4743, 4744, 4745, 4746, 4747, 4748, 4749, 4750, 4751, 4752, 4753, 4754, 4755, 4756, 4757, 4758, 4759, 4760, 4761, 4762, 4763, 4764, 4765, 4767, 4768, 4770, 4771, 4772, 4773, 4774, 4775, 4776, 4777, 4778, 4779, 4780, 4781, 4783, 4784, 4785, 4788, 4789, 4790, 4791, 4792, 4793, 4794, 4795, 4796, 4797, 4798, 4799, 4800, 4801, 4802, 4803, 4804, 4805, 4806, 4807, 4808, 4809, 4810, 4811, 4813, 4814, 4815, 4816, 4817, 4818, 4819, 4820, 4821, 4822, 4823, 4826, 4827, 4828, 4829, 4831, 4832, 4833, 4834, 4835, 4836, 4837, 4838, 4839, 4840, 4841, 4842, 4843, 4844, 4845, 4846, 4847, 4848, 4849, 4850, 4851, 4852, 4853, 4854, 4855, 4856, 4857, 4858, 4859, 4860, 4861, 4862, 4863, 4864, 4865, 4866, 4867, 4868, 4869, 4871, 4872, 4873, 4874, 4875, 4876, 4877, 4878, 4879, 4880, 4881, 4882, 4883, 4884, 4885, 4887, 4888, 4889, 4890, 4891, 4892, 4893, 4894, 4895, 4897, 4898, 4899, 4900, 4901, 4902, 4903, 4904, 4905, 4906, 4907, 4908, 4909, 4910, 4911, 4912, 4914, 4915, 4916, 4917, 4918, 4919, 4920, 4921, 4922, 4923, 4925, 4926, 4927, 4928, 4929, 4930, 4931, 4932, 4933, 4934, 4935, 4936, 4937, 4938, 4939, 4940, 4942, 4943, 4944, 4945, 4946, 4947, 4948, 4949, 4950, 4951, 4952, 4953, 4954, 4955, 4956, 4957, 4958, 4959, 4960, 4961, 4962, 4963, 4964, 4965, 4967, 4968, 4969, 4970, 4971, 4972, 4973, 4974, 4975, 4977, 4978, 4979, 4980, 4981, 4982, 4983, 4984, 4986, 4987, 4988, 4989, 4990, 4991, 4993, 4994, 4995, 4996, 4997, 4998, 4999, 5000, 5001, 5002, 5003, 5004, 5005, 5006, 5007, 5009, 5010, 5011, 5012, 5013, 5014, 5015, 5016, 5017, 5018, 5019, 5020, 5021, 5022, 5023, 5024, 5025, 5026, 5027, 5028, 5029, 5031, 5032, 5033, 5034, 5035, 5036, 5037, 5038, 5039, 5040, 5041, 5042, 5043, 5044, 5045, 5046, 5047, 5048, 5049, 5050, 5051, 5052, 5053, 5055, 5056, 5057, 5058, 5059, 5060, 5061, 5062, 5063, 5064, 5065, 5066, 5067, 5068, 5069, 5070, 5071, 5072, 5073, 5074, 5075, 5076, 5077, 5078, 5079, 5080, 5081, 5082, 5083, 5084, 5085, 5086, 5087, 5090, 5091, 5092, 5093, 5095, 5096, 5097, 5098, 5099, 5100, 5101, 5102, 5103, 5104, 5105, 5106, 5107, 5108, 5109, 5110, 5111, 5112, 5113, 5114, 5115, 5116, 5117, 5118, 5119, 5120, 5121, 5122, 5123, 5124, 5125, 5126, 5127, 5128, 5129, 5130, 5131, 5132, 5133, 5134, 5135, 5136, 5137, 5138, 5139, 5140, 5141, 5142, 5143, 5144, 5145, 5148, 5149, 5150, 5151, 5152, 5153, 5155, 5156, 5157, 5158, 5159, 5160, 5161, 5162, 5163, 5164, 5165, 5166, 5167, 5168, 5169, 5170, 5171, 5172, 5174, 5175, 5176, 5178, 5179, 5181, 5182, 5183, 5185, 5186, 5187, 5188, 5190, 5191, 5192, 5193, 5194, 5195, 5196, 5197, 5198, 5199, 5200, 5201, 5202, 5203, 5204, 5205, 5206, 5207, 5208, 5209, 5210, 5211, 5212, 5213, 5214, 5215, 5216, 5217, 5218, 5219, 5220, 5221, 5224, 5225, 5226, 5229, 5230, 5231, 5232, 5233, 5236, 5237, 5238, 5239, 5240, 5241, 5242, 5243, 5245, 5246, 5247, 5248, 5249, 5250, 5251, 5252, 5253, 5254, 5256, 5257, 5258, 5259, 5260, 5261, 5262, 5263, 5264, 5265, 5266, 5267, 5268, 5269, 5270, 5271, 5272, 5273, 5274, 5275, 5276, 5277, 5278, 5279, 5280, 5281, 5282, 5283, 5284, 5285, 5286, 5287, 5288, 5289, 5290, 5291, 5292, 5294, 5295, 5296, 5297, 5298, 5299, 5300, 5301, 5302, 5303, 5304, 5305, 5306, 5307, 5308, 5309, 5310, 5311, 5312, 5313, 5314, 5315, 5316, 5317, 5319, 5320, 5321, 5323, 5324, 5325, 5326, 5327, 5328, 5329, 5330, 5331, 5333, 5334, 5335, 5336, 5337, 5338, 5339, 5340, 5341, 5342, 5343, 5344, 5345, 5346, 5347, 5348, 5350, 5351, 5352, 5353, 5354, 5355, 5356, 5357, 5358, 5359, 5361, 5362, 5363, 5364, 5365, 5366, 5367, 5368, 5369, 5370, 5371, 5372, 5373, 5375, 5376, 5377, 5378, 5379, 5380, 5381, 5383, 5384, 5385, 5386, 5387, 5388, 5389, 5390, 5391, 5392, 5393, 5394, 5396, 5397, 5398, 5399, 5400, 5401, 5402, 5403, 5404, 5405, 5406, 5407, 5408, 5409, 5410, 5411, 5412, 5413, 5414, 5416, 5417, 5418, 5419, 5420, 5422, 5423, 5424, 5425, 5426, 5427, 5428, 5429, 5430, 5431, 5432, 5433, 5434, 5435, 5437, 5438, 5439, 5440, 5441, 5442, 5443, 5444, 5445, 5446, 5447, 5448, 5449, 5450, 5451, 5452, 5453, 5454, 5455, 5456, 5457, 5458, 5459, 5460, 5461, 5462, 5463, 5464, 5465, 5466, 5467, 5468, 5469, 5470, 5471, 5472, 5473, 5474, 5475, 5476, 5477, 5478, 5479, 5480, 5481, 5482, 5483, 5484, 5485, 5486, 5487, 5488, 5489, 5490, 5491, 5492, 5493, 5494, 5495, 5496, 5497, 5498, 5499, 5500, 5501, 5502, 5503, 5504, 5505, 5506, 5507, 5508, 5509, 5510, 5511, 5512, 5513, 5514, 5515, 5516, 5517, 5518, 5519, 5520, 5521, 5522, 5523, 5524, 5525, 5526, 5527, 5529, 5530, 5531, 5532, 5533, 5534, 5535, 5536, 5537, 5538, 5539, 5540, 5541, 5542, 5543, 5544, 5545, 5547, 5548, 5549, 5550, 5551, 5552, 5554, 5555, 5556, 5557, 5558, 5559, 5560, 5561, 5562, 5563, 5564, 5565, 5566, 5567, 5568, 5569, 5570, 5571, 5572, 5573, 5574, 5575, 5576, 5577, 5578, 5579, 5580, 5581, 5582, 5583, 5584, 5585, 5586, 5587, 5588, 5589, 5590, 5591, 5592, 5593, 5594, 5595, 5596, 5597, 5598, 5600, 5601, 5602, 5603, 5604, 5605, 5606, 5607, 5608, 5609, 5610, 5612, 5613, 5614, 5615, 5616, 5617, 5618, 5620, 5621, 5622, 5623, 5624, 5625, 5626, 5627, 5628, 5629, 5630, 5631, 5633, 5634, 5635, 5636, 5637, 5639, 5640, 5642, 5643, 5645, 5646, 5647, 5648, 5649, 5650, 5651, 5652, 5653, 5654, 5655, 5656, 5657, 5658, 5659, 5660, 5661, 5662, 5663, 5664, 5665, 5666, 5667, 5668, 5669, 5670, 5671, 5672, 5673, 5674, 5676, 5677, 5678, 5679, 5680, 5681, 5682, 5683, 5684, 5685, 5686, 5688, 5689, 5690, 5691, 5692, 5693, 5694, 5695, 5696, 5697, 5698, 5699, 5700, 5701, 5702, 5703, 5704, 5705, 5706, 5707, 5708, 5709, 5711, 5712, 5713, 5714, 5716, 5717, 5718, 5720, 5721, 5722, 5723, 5724, 5726, 5728, 5729, 5730, 5731, 5732, 5733, 5734, 5735, 5736, 5737, 5739, 5740, 5741, 5742, 5743, 5744, 5745, 5746, 5747, 5748, 5749, 5751, 5752, 5753, 5754, 5755, 5756, 5757, 5758, 5759, 5760, 5761, 5762, 5763, 5764, 5765, 5766, 5767, 5768, 5769, 5771, 5772, 5773, 5774, 5775, 5776, 5777, 5778, 5779, 5780, 5781, 5782, 5783, 5784, 5785, 5786, 5787, 5788, 5789, 5791, 5792, 5793, 5794, 5795, 5796, 5797, 5798, 5799, 5800, 5801, 5802, 5803, 5804, 5805, 5806, 5808, 5809, 5810, 5811, 5813, 5814, 5815, 5816, 5817, 5819, 5820, 5821, 5822, 5823, 5825, 5826, 5827, 5828, 5829, 5830, 5831, 5832, 5833, 5834, 5835, 5836, 5837, 5838, 5839, 5840, 5841, 5842, 5843, 5844, 5846, 5847, 5848, 5849, 5850, 5851, 5852, 5853, 5854, 5855, 5856, 5857, 5858, 5859, 5860, 5861, 5862, 5863, 5864, 5865, 5866, 5868, 5869, 5870, 5871, 5872, 5874, 5875, 5876, 5877, 5878, 5880, 5881, 5882, 5883, 5884, 5886, 5887, 5888, 5889, 5890, 5891, 5892, 5893, 5894, 5895, 5896, 5897, 5898, 5899, 5900, 5901, 5902, 5903, 5904, 5905, 5906, 5907, 5908, 5909, 5910, 5912, 5913, 5914, 5915, 5916, 5917, 5918, 5919, 5920, 5921, 5922, 5924, 5925, 5926, 5927, 5928, 5929, 5932, 5933, 5934, 5935, 5936, 5937, 5938, 5939, 5940, 5942, 5943, 5944, 5945, 5946, 5947, 5948, 5949, 5950, 5952, 5953, 5954, 5955, 5956, 5957, 5960, 5962, 5963, 5965, 5966, 5967, 5968, 5969, 5970, 5971, 5972, 5973, 5974, 5975, 5976, 5977, 5978, 5979, 5980, 5981, 5983, 5984, 5985, 5986, 5987, 5988, 5989, 5990, 5991, 5992, 5993, 5994, 5995, 5996, 5997, 5998, 5999, 6000, 6001, 6002, 6003, 6004, 6005, 6006, 6007, 6008, 6009, 6010, 6011, 6012, 6013, 6015, 6016, 6017, 6018, 6019, 6021, 6022, 6023, 6024, 6025, 6027, 6028, 6029, 6030, 6031, 6032, 6034, 6036, 6037, 6040, 6041, 6042, 6043, 6044, 6045, 6046, 6047, 6048, 6049, 6051, 6052, 6053, 6055, 6056, 6057, 6058, 6059, 6060, 6061, 6063, 6064, 6065, 6066, 6067, 6068, 6069, 6070, 6071, 6072, 6073, 6074, 6075, 6076, 6077, 6078, 6079, 6080, 6081, 6083, 6084, 6085, 6086, 6087, 6088, 6089, 6090, 6091, 6092, 6093, 6094, 6095, 6096, 6097, 6099, 6100, 6101, 6102, 6103, 6104, 6105, 6106, 6107, 6108, 6109, 6111, 6112, 6113, 6114, 6115, 6116, 6117, 6118, 6119, 6120, 6121, 6122, 6123, 6124, 6126, 6127, 6128, 6129, 6130, 6131, 6132, 6133, 6134, 6135, 6136, 6137, 6139, 6140, 6141, 6142, 6143, 6144, 6145, 6146, 6147, 6148, 6149, 6150, 6151, 6152, 6153, 6154, 6155, 6156, 6157, 6158, 6159, 6160, 6161, 6162, 6163, 6164, 6165, 6166, 6167, 6168, 6169, 6170, 6171, 6172, 6173, 6174, 6175, 6176, 6178, 6179, 6180, 6181, 6182, 6183, 6184, 6185, 6186, 6187, 6189, 6190, 6191, 6192, 6193, 6194, 6195, 6196, 6197, 6198, 6200, 6201, 6202, 6203, 6204, 6205, 6206, 6207, 6208, 6209, 6210, 6211, 6212, 6213, 6214, 6215, 6216, 6217, 6218, 6219, 6220, 6221, 6222, 6223, 6224, 6225, 6226, 6227, 6228, 6229, 6230, 6231, 6232, 6233, 6234, 6235, 6236, 6237, 6238, 6239, 6240, 6241, 6242, 6243, 6244, 6245, 6246, 6247, 6248, 6249, 6250, 6251, 6252, 6253, 6254, 6255, 6256, 6257, 6258, 6259, 6260, 6261, 6262, 6263, 6264, 6265, 6266, 6267, 6269, 6270, 6271, 6272, 6273, 6274, 6275, 6276, 6277, 6278, 6279, 6280, 6281, 6282, 6283, 6284, 6285, 6286, 6287, 6288, 6289, 6290, 6291, 6292, 6293, 6294, 6295, 6296, 6297, 6298, 6300, 6301, 6302, 6303, 6304, 6305, 6306, 6307, 6308, 6309, 6310, 6311, 6313, 6314, 6315, 6316, 6317, 6318, 6319, 6320, 6321, 6322, 6323, 6324, 6325, 6326, 6327, 6328, 6329, 6330, 6331, 6332, 6333, 6334, 6335, 6336, 6338, 6339, 6340, 6341, 6342, 6343, 6344, 6345, 6346, 6347, 6348, 6349, 6350, 6351, 6352, 6353, 6354, 6355, 6356, 6357, 6358, 6359, 6360, 6361, 6362, 6363, 6364, 6369, 6370, 6371, 6372, 6373, 6374, 6375, 6376, 6377, 6378, 6379, 6380, 6381, 6382, 6383, 6384, 6385, 6386, 6387, 6388, 6389, 6390, 6391, 6392, 6393, 6394, 6395, 6396, 6398, 6399, 6401, 6402, 6404, 6405, 6407, 6408, 6410, 6411, 6412, 6413, 6414, 6415, 6416, 6417, 6418, 6419, 6420, 6421, 6422, 6423, 6424, 6425, 6426, 6427, 6428, 6429, 6430, 6431, 6433, 6434, 6435, 6436, 6437, 6438, 6439, 6440, 6441, 6442, 6443, 6444, 6445, 6446, 6447, 6448, 6449, 6450, 6452, 6453, 6454, 6455, 6457, 6458, 6460, 6461, 6462, 6463, 6464, 6466, 6467, 6468, 6469, 6470, 6471, 6472, 6473, 6474, 6475, 6476, 6477, 6478, 6479, 6481, 6482, 6483, 6484, 6485, 6486, 6487, 6488, 6489, 6491, 6492, 6493, 6494, 6495, 6496, 6497, 6498, 6499, 6500, 6501, 6502, 6503, 6504, 6505, 6506, 6507, 6508, 6509, 6510, 6511, 6512, 6513, 6514, 6515, 6516, 6517, 6518, 6519, 6520, 6521, 6522, 6523, 6524, 6525, 6526, 6527, 6528, 6529, 6530, 6531, 6532, 6533, 6534, 6535, 6536, 6537, 6538, 6539, 6540, 6541, 6542, 6543, 6544, 6545, 6547, 6548, 6552, 6553, 6554, 6555, 6556, 6557, 6558, 6559, 6560, 6561, 6562, 6563, 6564, 6565, 6566, 6567, 6568, 6569, 6570, 6571, 6572, 6573, 6575, 6576, 6577, 6578, 6579, 6580, 6581, 6582, 6583, 6584, 6585, 6586, 6587, 6589, 6590, 6591, 6592, 6593, 6594, 6595, 6596, 6597, 6598, 6600, 6601, 6602, 6603, 6604, 6605, 6606, 6607, 6608, 6609, 6610, 6611, 6612, 6613, 6614, 6615, 6616, 6617, 6618, 6619, 6620, 6621, 6622, 6623, 6624, 6625, 6626, 6627, 6628, 6629, 6630, 6631, 6632, 6633, 6634, 6635, 6636, 6637, 6639, 6640, 6641, 6642, 6643, 6644, 6645, 6646, 6647, 6648, 6649, 6650, 6651, 6652, 6653, 6654, 6655, 6656, 6657, 6658, 6659, 6660, 6661, 6662, 6663, 6664, 6665, 6666, 6667, 6668, 6669, 6670, 6671, 6672, 6673, 6675, 6676, 6677, 6678, 6679, 6680, 6681, 6682, 6683, 6684, 6685, 6686, 6687, 6688, 6689, 6690, 6691, 6692, 6693, 6694, 6695, 6696, 6697, 6698, 6699, 6700, 6701, 6702, 6703, 6704, 6705, 6706, 6707, 6708, 6709, 6710, 6711, 6712, 6713, 6714, 6715, 6716, 6717, 6718, 6719, 6720, 6721, 6722, 6723, 6724, 6725, 6726, 6727, 6728, 6729, 6730, 6731, 6732, 6733, 6734, 6735, 6736, 6737, 6738, 6739, 6740, 6741, 6742, 6743, 6744, 6745, 6747, 6748, 6750, 6751, 6752, 6753, 6754, 6755, 6756, 6757, 6758, 6759, 6760, 6762, 6764, 6765, 6766, 6767, 6768, 6769, 6770, 6771, 6772, 6773, 6774, 6775, 6776, 6777, 6778, 6779, 6780, 6781, 6782, 6783, 6784, 6785, 6786, 6787, 6788, 6789, 6790, 6791, 6792, 6793}",6300,"{989, 1081, 1113, 1121, 1132, 1133, 1139, 1140, 1141, 1145, 1147, 1149, 1160, 1166, 1168, 1170, 1174, 1175, 1178, 1180, 1184, 1187, 1188, 1189, 1191, 1192, 1197, 1198, 1199, 1200, 1201, 1202, 1206, 1208, 1209, 1214, 1215, 1216, 1222, 1225, 1227, 1230, 1232, 1236, 1239, 1240, 1241, 1245, 1246, 1249, 1253, 1254, 1258, 1259, 1260, 1263, 1264, 1265, 1268, 1283, 1286, 1290, 1293, 1294, 1295, 1299, 1300, 1304, 1306, 1307, 1308, 1309, 1310, 1313, 1314, 1315, 1316, 1320, 1321, 1327, 1329, 1334, 1335, 1338, 1339, 1340, 1343, 1345, 1346, 1350, 1352, 1353, 1355, 1356, 1357, 1363, 1364, 1367, 1368, 1372, 1375, 1379, 1381, 1383, 1385, 1386, 1396, 1400, 1401, 1403, 1407, 1408, 1409, 1410, 1411, 1416, 1419, 1420, 1421, 1423, 1428, 1429, 1433, 1435, 1439, 1440, 1443, 1446, 1447, 1450, 1451, 1452, 1453, 1454, 1455, 1456, 1457, 1459, 1460, 1461, 1462, 1464, 1465, 1466, 1470, 1471, 1472, 1475, 1476, 1477, 1478, 1481, 1482, 1484, 1485, 1488, 1489, 1490, 1492, 1493, 1494, 1495, 1496, 1500, 1501, 1503, 1505, 1507, 1508, 1510, 1513, 1514, 1515, 1516, 1519, 1522, 1523, 1524, 1525, 1528, 1531, 1532, 1533, 1536, 1538, 1540, 1541, 1544, 1545, 1554, 1557, 1558, 1560, 1564, 1565, 1569, 1570, 1572, 1577, 1579, 1587, 1596, 1598, 1599, 1600, 1602, 1603, 1604, 1605, 1607, 1609, 1612, 1616, 1617, 1618, 1620, 1621, 1622, 1623, 1629, 1631, 1632, 1634, 1636, 1637, 1639, 1640, 1642, 1644, 1645, 1646, 1647, 1648, 1649, 1659, 1666, 1669, 1670, 1675, 1676, 1688, 1689, 1690, 1692, 1694, 1697, 1698, 1705, 1707, 1711, 1712, 1714, 1716, 1720, 1723, 1724, 1725, 1732, 1735, 1737, 1738, 1739, 1740, 1742, 1743, 1747, 1748, 1753, 1756, 1759, 1761, 1762, 1767, 1768, 1773, 1774, 1775, 1776, 1779, 1780, 1782, 1783, 1785, 1787, 1788, 1789, 1790, 1795, 1799, 1800, 1801, 1802, 1803, 1804, 1805, 1806, 1807, 1808, 1809, 1810, 1811, 1812, 1814, 1815, 1816, 1817, 1818, 1819, 1820, 1821, 1823, 1824, 1826, 1828, 1830, 1831, 1832, 1833, 1834, 1837, 1838, 1839, 1841, 1842, 1843, 1846, 1848, 1849, 1850, 1852, 1857, 1863, 1865, 1866, 1867, 1871, 1872, 1874, 1875, 1876, 1878, 1879, 1880, 1881, 1883, 1890, 1891, 1894, 1895, 1897, 1898, 1899, 1900, 1903, 1911, 1916, 1918, 1922, 1923, 1924, 1925, 1926, 1930, 1931, 1932, 1934, 1937, 1939, 1941, 1945, 1946, 1951, 1952, 1958, 1962, 1963, 1966, 1967, 1970, 1975, 1981, 1982, 1984, 1990, 1991, 1994, 1997, 1998, 1999, 2001, 2003, 2005, 2006, 2009, 2016, 2018, 2019, 2023, 2024, 2027, 2028, 2034, 2040, 2043, 2045, 2046, 2047, 2051, 2056, 2057, 2058, 2060, 2061, 2062, 2066, 2067, 2070, 2071, 2073, 2075, 2077, 2079, 2082, 2083, 2087, 2094, 2097, 2098, 2100, 2107, 2108, 2111, 2114, 2117, 2123, 2125, 2130, 2131, 2132, 2139, 2142, 2149, 2152, 2154, 2155, 2158, 2159, 2160, 2164, 2166, 2168, 2169, 2170, 2171, 2172, 2173, 2174, 2176, 2177, 2179, 2181, 2184, 2185, 2187, 2188, 2189, 2190, 2191, 2192, 2194, 2197, 2204, 2206, 2207, 2208, 2209, 2210, 2211, 2213, 2214, 2217, 2222, 2223, 2226, 2228, 2232, 2235, 2237, 2243, 2249, 2250, 2251, 2255, 2259, 2261, 2265, 2269, 2270, 2271, 2273, 2277, 2280, 2288, 2290, 2293, 2294, 2295, 2296, 2297, 2298, 2299, 2300, 2301, 2302, 2304, 2305, 2306, 2309, 2311, 2312, 2313, 2315, 2317, 2320, 2321, 2322, 2327, 2328, 2329, 2330, 2331, 2332, 2333, 2334, 2336, 2337, 2338, 2339, 2340, 2341, 2342, 2344, 2347, 2349, 2350, 2351, 2353, 2354, 2356, 2357, 2358, 2359, 2360, 2362, 2367, 2368, 2369, 2370, 2371, 2373, 2375, 2376, 2378, 2380, 2383, 2384, 2385, 2387, 2389, 2390, 2391, 2392, 2393, 2396, 2399, 2401, 2402, 2404, 2405, 2407, 2409, 2410, 2411, 2412, 2414, 2419, 2424, 2428, 2430, 2437, 2438, 2439, 2440, 2441, 2443, 2444, 2445, 2460, 2463, 2467, 2469, 2479, 2480, 2483, 2484, 2485, 2486, 2487, 2488, 2489, 2490, 2491, 2492, 2494, 2501, 2504, 2505, 2506, 2510, 2513, 2514, 2515, 2516, 2517, 2520, 2522, 2524, 2525, 2526, 2527, 2529, 2531, 2533, 2537, 2538, 2544, 2546, 2552, 2553, 2557, 2559, 2562, 2563, 2569, 2570, 2581, 2583, 2591, 2593, 2594, 2595, 2596, 2597, 2598, 2599, 2600, 2601, 2606, 2607, 2610, 2613, 2615, 2621, 2623, 2625, 2629, 2633, 2635, 2636, 2639, 2642, 2668, 2699, 2715, 2724, 2731, 2733, 2735, 2736, 2737, 2745, 2746, 2747, 2751, 2756, 2764, 2770, 2771, 2777, 2785, 2786, 2787, 2789, 2791, 2792, 2793, 2794, 2795, 2798, 2805, 2806, 2807, 2808, 2809, 2812, 2817, 2820, 2822, 2826, 2828, 2830, 2831, 2832, 2834, 2835, 2836, 2837, 2838, 2841, 2845, 2847, 2851, 2852, 2855, 2856, 2857, 2861, 2863, 2866, 2869, 2870, 2871, 2875, 2883, 2886, 2891, 2892, 2894, 2896, 2900, 2904, 2905, 2906, 2910, 2911, 2912, 2914, 2916, 2917, 2918, 2923, 2927, 2930, 2932, 2933, 2934, 2938, 2939, 2940, 2941, 2943, 2944, 2945, 2946, 2949, 2950, 2956, 2957, 2963, 2971, 2974, 2975, 2977, 3101, 3133, 3139, 3222, 3227, 3232, 3233, 3234, 3240, 3251, 3259, 3263, 3277, 3284, 3286, 3292, 3298, 3299, 3301, 3310, 3317, 3322, 3329, 3338, 3339, 3340, 3344, 3350, 3351, 3352, 3356, 3359, 3360, 3364, 3366, 3370, 3371, 3372, 3375, 3376, 3379, 3381, 3382, 3383, 3396, 3399, 3402, 3403, 3406, 3407, 3411, 3427, 3433, 3434, 3436, 3444, 3446, 3448, 3454, 3455, 3456, 3457, 3462, 3466, 3468, 3481, 3488, 3491, 3494, 3499, 3502, 3503, 3504, 3507, 3513, 3520, 3525, 3526, 3531, 3533, 3535, 3536, 3538, 3541, 3544, 3551, 3563, 3564, 3572, 3574, 3577, 3607, 3630, 3651, 3658, 3668, 3677, 3678, 3682, 3689, 3693, 3700, 3704, 3705, 3706, 3709, 3710, 3711, 3717, 3728, 3729, 3732, 3736, 3738, 3744, 3749, 3750, 3761, 3763, 3764, 3765, 3766, 3767, 3772, 3776, 3777, 3778, 3779, 3785, 3787, 3789, 3792, 3794, 3795, 3799, 3801, 3802, 3803, 3806, 3807, 3808, 3809, 3811, 3812, 3813, 3814, 3818, 3819, 3820, 3822, 3825, 3827, 3828, 3829, 3830, 3832, 3834, 3835, 3836, 3839, 3841, 3843, 3844, 3846, 3847, 3848, 3849, 3850, 3851, 3852, 3854, 3855, 3856, 3857, 3858, 3859, 3860, 3861, 3862, 3863, 3864, 3866, 3867, 3868, 3869, 3870, 3872, 3874, 3875, 3878, 3879, 3886, 3887, 3888, 3889, 3890, 3891, 3892, 3893, 3896, 3897, 3900, 3901, 3903, 3904, 3905, 3906, 3907, 3908, 3910, 3912, 3913, 3915, 3917, 3919, 3920, 3922, 3925, 3926, 3928, 3930, 3933, 3935, 3937, 3940, 3941, 3946, 3947, 3949, 3950, 3952, 3953, 3954, 3956, 3959, 3963, 3964, 3966, 3969, 3973, 3974, 3975, 3976, 3977, 3979, 3980, 3981, 3982, 3983, 3984, 3986, 3987, 3988, 3990, 3991, 3993, 3994, 3998, 4000, 4002, 4003, 4004, 4005, 4012, 4020, 4021, 4022, 4023, 4024, 4028, 4031, 4032, 4037, 4038, 4041, 4043, 4045, 4047, 4049, 4056, 4057, 4061, 4068, 4069, 4072, 4073, 4074, 4077, 4081, 4090, 4091, 4097, 4108, 4130, 4131, 4332, 4379, 4392, 4393, 4398, 4407, 4419, 4422, 4442, 4445, 4450, 4451, 4461, 4469, 4482, 4483, 4484, 4485, 4486, 4487, 4488, 4489, 4490, 4491, 4494, 4496, 4497, 4499, 4505, 4517, 4529, 4537, 4544, 4546, 4547, 4555, 4557, 4560, 4561, 4562, 4563, 4575, 4577, 4578, 4579, 4582, 4585, 4587, 4588, 4594, 4598, 4600, 4601, 4606, 4610, 4611, 4614, 4618, 4619, 4620, 4621, 4624, 4627, 4632, 4633, 4634, 4637, 4642, 4643, 4644, 4647, 4653, 4654, 4663, 4664, 4667, 4671, 4673, 4677, 4682, 4683, 4685, 4687, 4690, 4691, 4692, 4695, 4696, 4700, 4701, 4702, 4703, 4705, 4706, 4708, 4709, 4710, 4711, 4712, 4713, 4714, 4715, 4716, 4717, 4719, 4720, 4722, 4724, 4725, 4727, 4729, 4730, 4731, 4732, 4733, 4734, 4736, 4737, 4738, 4739, 4740, 4741, 4742, 4743, 4744, 4745, 4746, 4749, 4751, 4753, 4754, 4755, 4757, 4763, 4764, 4767, 4770, 4772, 4773, 4774, 4776, 4778, 4779, 4780, 4784, 4788, 4789, 4790, 4791, 4793, 4794, 4796, 4802, 4803, 4805, 4807, 4808, 4809, 4810, 4811, 4817, 4818, 4819, 4820, 4821, 4823, 4826, 4829, 4833, 4835, 4836, 4838, 4840, 4841, 4843, 4844, 4847, 4848, 4851, 4854, 4855, 4856, 4857, 4861, 4862, 4864, 4865, 4868, 4869, 4871, 4872, 4873, 4884, 4887, 4893, 4897, 4906, 4914, 4920, 4921, 4923, 4925, 4929, 4930, 4931, 4932, 4933, 4934, 4937, 4938, 4939, 4952, 4953, 4956, 4960, 4961, 4962, 4968, 4972, 4973, 4974, 4975, 4977, 4978, 4979, 4986, 4987, 4988, 4989, 4990, 4993, 4994, 4997, 4999, 5001, 5002, 5003, 5006, 5011, 5012, 5013, 5014, 5016, 5017, 5018, 5019, 5020, 5024, 5025, 5027, 5028, 5031, 5034, 5035, 5038, 5039, 5040, 5043, 5044, 5045, 5046, 5048, 5049, 5056, 5057, 5059, 5062, 5066, 5067, 5068, 5070, 5071, 5072, 5073, 5074, 5075, 5076, 5078, 5079, 5080, 5081, 5082, 5085, 5086, 5087, 5090, 5091, 5092, 5093, 5096, 5097, 5098, 5099, 5102, 5103, 5104, 5107, 5108, 5109, 5110, 5111, 5114, 5117, 5120, 5121, 5122, 5130, 5131, 5132, 5135, 5136, 5137, 5138, 5139, 5140, 5142, 5143, 5145, 5148, 5149, 5150, 5152, 5153, 5156, 5159, 5160, 5162, 5163, 5165, 5166, 5168, 5169, 5171, 5176, 5178, 5179, 5181, 5182, 5183, 5185, 5186, 5187, 5191, 5192, 5194, 5197, 5198, 5200, 5201, 5202, 5203, 5206, 5207, 5208, 5209, 5210, 5213, 5214, 5215, 5219, 5220, 5224, 5225, 5229, 5230, 5233, 5238, 5239, 5240, 5241, 5243, 5245, 5246, 5247, 5248, 5249, 5250, 5251, 5252, 5254, 5256, 5262, 5264, 5265, 5266, 5267, 5268, 5269, 5270, 5272, 5275, 5278, 5279, 5285, 5287, 5288, 5289, 5290, 5291, 5292, 5294, 5295, 5296, 5297, 5298, 5301, 5302, 5305, 5313, 5316, 5320, 5321, 5323, 5328, 5329, 5333, 5336, 5337, 5339, 5340, 5343, 5352, 5353, 5354, 5355, 5356, 5358, 5359, 5361, 5362, 5366, 5371, 5372, 5376, 5377, 5384, 5385, 5386, 5387, 5388, 5389, 5390, 5391, 5393, 5396, 5398, 5402, 5404, 5405, 5406, 5407, 5408, 5409, 5411, 5414, 5417, 5424, 5428, 5429, 5430, 5431, 5432, 5439, 5442, 5443, 5446, 5449, 5452, 5454, 5456, 5462, 5463, 5465, 5466, 5467, 5468, 5472, 5473, 5474, 5475, 5477, 5482, 5484, 5485, 5486, 5487, 5488, 5489, 5494, 5495, 5496, 5498, 5502, 5508, 5509, 5510, 5511, 5512, 5513, 5516, 5518, 5520, 5525, 5526, 5527, 5529, 5540, 5544, 5545, 5550, 5551, 5554, 5555, 5556, 5558, 5559, 5560, 5568, 5569, 5570, 5572, 5575, 5576, 5578, 5579, 5580, 5581, 5586, 5587, 5589, 5591, 5592, 5593, 5594, 5598, 5602, 5603, 5604, 5608, 5609, 5610, 5613, 5614, 5616, 5618, 5620, 5621, 5622, 5623, 5624, 5630, 5631, 5637, 5643, 5646, 5647, 5652, 5653, 5654, 5655, 5657, 5658, 5659, 5662, 5663, 5664, 5665, 5666, 5667, 5668, 5669, 5670, 5671, 5673, 5676, 5677, 5678, 5680, 5681, 5682, 5683, 5684, 5685, 5686, 5690, 5691, 5692, 5693, 5698, 5699, 5701, 5702, 5704, 5705, 5706, 5707, 5708, 5711, 5712, 5716, 5721, 5736, 5742, 5747, 5748, 5751, 5752, 5755, 5756, 5758, 5759, 5761, 5763, 5766, 5772, 5774, 5775, 5776, 5788, 5789, 5798, 5803, 5805, 5808, 5811, 5813, 5814, 5815, 5816, 5819, 5820, 5825, 5828, 5829, 5830, 5833, 5837, 5838, 5842, 5844, 5846, 5847, 5849, 5850, 5851, 5852, 5855, 5857, 5872, 5894, 5896, 5906, 5908, 5913, 5916, 5917, 5924, 5926, 5929, 5932, 5933, 5936, 5937, 5938, 5939, 5944, 5950, 5955, 5957, 5965, 5966, 5967, 5968, 5969, 5972, 5973, 5974, 5975, 5976, 5977, 5978, 5979, 5983, 5984, 5985, 5987, 5989, 5992, 5993, 5994, 5995, 6001, 6002, 6003, 6005, 6006, 6008, 6010, 6011, 6013, 6015, 6016, 6018, 6023, 6024, 6028, 6029, 6037, 6041, 6044, 6045, 6046, 6051, 6052, 6053, 6055, 6058, 6059, 6060, 6064, 6065, 6066, 6067, 6068, 6069, 6072, 6073, 6074, 6075, 6076, 6077, 6079, 6080, 6081, 6083, 6085, 6088, 6089, 6090, 6091, 6093, 6094, 6095, 6096, 6097, 6099, 6100, 6101, 6102, 6103, 6107, 6108, 6109, 6114, 6119, 6120, 6122, 6126, 6127, 6128, 6129, 6130, 6133, 6135, 6136, 6137, 6140, 6142, 6143, 6144, 6148, 6150, 6151, 6152, 6156, 6157, 6158, 6161, 6162, 6163, 6164, 6165, 6171, 6172, 6175, 6176, 6179, 6180, 6186, 6189, 6190, 6191, 6194, 6196, 6198, 6200, 6202, 6203, 6204, 6205, 6206, 6207, 6208, 6209, 6210, 6211, 6212, 6213, 6214, 6215, 6216, 6217, 6218, 6219, 6220, 6222, 6224, 6225, 6226, 6227, 6230, 6232, 6233, 6235, 6237, 6238, 6240, 6241, 6242, 6243, 6244, 6245, 6248, 6249, 6250, 6251, 6255, 6256, 6257, 6259, 6260, 6262, 6266, 6273, 6278, 6280, 6281, 6283, 6284, 6288, 6289, 6293, 6294, 6295, 6297, 6301, 6305, 6306, 6307, 6308, 6309, 6310, 6316, 6317, 6318, 6320, 6322, 6323, 6325, 6327, 6328, 6333, 6335, 6336, 6340, 6342, 6344, 6348, 6352, 6355, 6357, 6359, 6361, 6363, 6364, 6370, 6371, 6373, 6374, 6375, 6377, 6378, 6379, 6380, 6381, 6382, 6383, 6384, 6385, 6386, 6387, 6389, 6390, 6391, 6392, 6394, 6395, 6398, 6399, 6405, 6408, 6410, 6411, 6412, 6414, 6416, 6417, 6418, 6423, 6424, 6425, 6428, 6430, 6431, 6433, 6434, 6435, 6437, 6439, 6441, 6442, 6443, 6444, 6445, 6447, 6448, 6449, 6450, 6457, 6458, 6461, 6462, 6463, 6467, 6469, 6470, 6471, 6472, 6473, 6475, 6476, 6477, 6478, 6481, 6482, 6484, 6486, 6488, 6489, 6491, 6493, 6498, 6499, 6500, 6501, 6502, 6503, 6504, 6505, 6506, 6507, 6508, 6510, 6511, 6514, 6517, 6518, 6519, 6520, 6521, 6522, 6523, 6524, 6525, 6526, 6527, 6530, 6545, 6547, 6548, 6552, 6553, 6554, 6555, 6556, 6557, 6560, 6562, 6563, 6564, 6565, 6566, 6567, 6568, 6569, 6570, 6571, 6573, 6575, 6576, 6577, 6578, 6580, 6581, 6582, 6583, 6584, 6585, 6587, 6589, 6590, 6593, 6594, 6595, 6596, 6597, 6598, 6600, 6601, 6602, 6604, 6605, 6606, 6607, 6608, 6609, 6610, 6612, 6613, 6614, 6618, 6619, 6620, 6621, 6622, 6625, 6626, 6627, 6628, 6629, 6630, 6631, 6632, 6635, 6636, 6637, 6640, 6643, 6644, 6648, 6649, 6650, 6651, 6652, 6653, 6656, 6657, 6658, 6659, 6660, 6661, 6662, 6664, 6666, 6669, 6670, 6671, 6672, 6677, 6681, 6683, 6685, 6686, 6687, 6688, 6689, 6690, 6694, 6695, 6696, 6697, 6701, 6702, 6708, 6710, 6711, 6715, 6716, 6748, 6753, 6783}",2169,"{0, 1, 2, 3, 4, 5, 6, 7, 8, 9, 10, 11, 12, 13, 14, 15, 16, 17, 18, 20, 21, 22, 23, 24, 25, 27, 28, 29, 30, 31, 32, 33, 34, 35, 36, 37, 38, 39, 42, 43, 44, 45, 46, 47, 48, 49, 50, 51, 52, 53, 54, 55, 56, 57, 58, 59, 60, 61, 62, 64, 65, 66, 67, 68, 69, 70, 71, 72, 73, 74, 75, 78, 79, 80, 81, 83, 84, 85, 86, 88, 89, 90, 91, 92, 93, 94, 95, 96, 97, 98, 99, 100, 101, 102, 103, 104, 105, 106, 107, 108, 109, 110, 111, 112, 113, 114, 115, 116, 117, 118, 123, 124, 125, 126, 127, 128, 129, 130, 131, 132, 133, 134, 135, 136, 137, 138, 139, 140, 141, 143, 144, 145, 146, 147, 148, 149, 150, 151, 153, 154, 155, 156, 158, 159, 160, 161, 162, 163, 164, 165, 166, 167, 168, 169, 171, 172, 175, 176, 179, 180, 181, 182, 183, 184, 185, 186, 187, 188, 189, 190, 191, 192, 193, 194, 195, 196, 198, 199, 200, 201, 202, 203, 204, 205, 206, 207, 208, 209, 210, 211, 212, 213, 214, 215, 216, 217, 218, 219, 220, 221, 222, 223, 224, 225, 226, 227, 228, 229, 230, 231, 232, 234, 235, 236, 237, 238, 239, 240, 241, 242, 243, 244, 245, 246, 247, 248, 249, 250, 251, 252, 253, 254, 256, 257, 258, 259, 260, 261, 262, 263, 264, 265, 266, 267, 268, 269, 271, 272, 273, 274, 275, 276, 277, 278, 279, 280, 281, 282, 283, 284, 285, 286, 287, 288, 289, 290, 291, 292, 293, 294, 295, 296, 297, 298, 300, 301, 302, 303, 305, 307, 310, 311, 312, 313, 314, 315, 316, 317, 318, 321, 322, 323, 324, 325, 326, 327, 331, 332, 333, 334, 335, 336, 337, 338, 339, 340, 341, 342, 343, 344, 345, 346, 348, 349, 350, 351, 352, 353, 356, 357, 358, 359, 360, 361, 362, 363, 364, 365, 366, 367, 368, 369, 370, 372, 373, 375, 376, 377, 378, 379, 380, 382, 383, 384, 385, 386, 387, 388, 389, 390, 391, 392, 393, 394, 395, 396, 397, 398, 399, 400, 401, 402, 403, 404, 405, 406, 407, 408, 409, 410, 411, 414, 415, 416, 417, 418, 419, 420, 421, 422, 423, 424, 425, 426, 427, 428, 429, 430, 431, 433, 434, 435, 436, 437, 438, 439, 440, 441, 443, 444, 445, 446, 447, 449, 450, 451, 452, 453, 454, 456, 457, 458, 459, 460, 461, 462, 463, 464, 465, 466, 467, 468, 469, 470, 471, 472, 473, 474, 475, 476, 477, 478, 479, 481, 482, 483, 484, 486, 487, 488, 489, 490, 491, 492, 493, 494, 495, 496, 497, 498, 499, 500, 501, 502, 503, 504, 505, 506, 507, 508, 509, 510, 511, 512, 513, 514, 515, 516, 518, 519, 520, 521, 522, 523, 524, 525, 526, 527, 528, 530, 531, 532, 533, 534, 535, 536, 537, 538, 539, 540, 541, 542, 543, 544, 545, 546, 547, 548, 549, 550, 551, 552, 553, 554, 555, 556, 557, 558, 559, 560, 561, 562, 563, 564, 565, 566, 567, 568, 569, 570, 571, 572, 573, 574, 575, 576, 577, 578, 580, 582, 583, 584, 585, 586, 590, 591, 592, 593, 594, 596, 597, 598, 599, 600, 601, 602, 603, 604, 605, 606, 607, 608, 609, 610, 611, 612, 613, 614, 616, 617, 618, 620, 621, 622, 623, 624, 625, 626, 627, 628, 629, 631, 632, 633, 634, 635, 636, 637, 638, 639, 640, 641, 642, 643, 644, 645, 646, 647, 648, 649, 650, 651, 652, 653, 654, 655, 656, 657, 658, 659, 660, 661, 662, 663, 664, 665, 666, 667, 668, 669, 670, 671, 672, 673, 674, 675, 676, 677, 678, 679, 680, 681, 682, 683, 684, 685, 686, 687, 688, 689, 690, 693, 695, 696, 697, 698, 699, 700, 701, 702, 703, 704, 705, 706, 707, 708, 709, 710, 711, 712, 713, 714, 715, 716, 717, 718, 719, 720, 721, 722, 723, 724, 725, 726, 727, 728, 729, 730, 731, 732, 733, 734, 735, 736, 737, 738, 739, 740, 741, 742, 743, 744, 745, 746, 748, 749, 750, 751, 752, 753, 754, 755, 756, 757, 758, 759, 760, 761, 762, 763, 764, 765, 766, 767, 768, 769, 770, 771, 773, 774, 775, 776, 777, 778, 779, 780, 781, 782, 783, 784, 785, 786, 787, 788, 789, 790, 791, 792, 794, 795, 796, 797, 798, 799, 800, 801, 802, 803, 804, 805, 806, 807, 808, 809, 810, 811, 812, 813, 814, 815, 816, 817, 819, 820, 821, 824, 825, 826, 828, 829, 830, 831, 832, 833, 834, 835, 836, 837, 838, 839, 840, 841, 842, 843, 844, 845, 846, 847, 848, 849, 850, 851, 852, 854, 855, 856, 857, 858, 859, 860, 861, 862, 864, 865, 866, 867, 868, 869, 870, 871, 872, 873, 874, 875, 876, 877, 878, 879, 880, 881, 882, 883, 884, 885, 886, 887, 888, 889, 890, 891, 892, 893, 894, 895, 896, 897, 898, 899, 900, 901, 902, 903, 904, 905, 906, 907, 908, 909, 910, 911, 912, 913, 914, 915, 916, 917, 918, 919, 920, 921, 922, 923, 924, 925, 926, 927, 928, 929, 930, 931, 932, 933, 935, 936, 937, 939, 940, 941, 942, 943, 944, 945, 946, 947, 948, 949, 950, 951, 952, 953, 954, 955, 956, 957, 958, 959, 960, 961, 962, 963, 964, 965, 966, 967, 968, 969, 970, 971, 972, 973, 974, 975, 976, 977, 978, 979, 980, 981, 982, 983, 984, 985, 986, 987, 988, 990, 991, 992, 993, 994, 996, 997, 998, 999, 1000, 1001, 1002, 1003, 1004, 1005, 1006, 1007, 1008, 1009, 1010, 1011, 1012, 1013, 1014, 1015, 1016, 1017, 1018, 1019, 1020, 1021, 1022, 1023, 1024, 1025, 1026, 1028, 1029, 1030, 1031, 1032, 1033, 1034, 1036, 1037, 1038, 1039, 1040, 1041, 1042, 1043, 1044, 1045, 1046, 1047, 1048, 1050, 1051, 1052, 1053, 1054, 1055, 1056, 1057, 1058, 1059, 1060, 1061, 1063, 1064, 1065, 1066, 1067, 1069, 1070, 1071, 1072, 1073, 1074, 1075, 1076, 1077, 1078, 1079, 1080, 1082, 1083, 1085, 1086, 1087, 1088, 1089, 1090, 1092, 1093, 1094, 1095, 1096, 1097, 1098, 1099, 1100, 1101, 1103, 1104, 1105, 1106, 1107, 1108, 1109, 1110, 1111, 1112, 1114, 1115, 1116, 1117, 1118, 1119, 1120, 1122, 1123, 1124, 1125, 1126, 1127, 1128, 1129, 1130, 1131, 1134, 1135, 1136, 1137, 1138, 1142, 1143, 1144, 1146, 1148, 1150, 1151, 1152, 1153, 1154, 1155, 1156, 1157, 1158, 1159, 1161, 1162, 1163, 1164, 1165, 1167, 1169, 1171, 1172, 1173, 1176, 1177, 1179, 1181, 1182, 1183, 1185, 1186, 1190, 1193, 1194, 1195, 1196, 1203, 1204, 1205, 1207, 1210, 1211, 1212, 1213, 1217, 1218, 1219, 1220, 1221, 1223, 1224, 1226, 1228, 1229, 1231, 1233, 1234, 1235, 1237, 1238, 1242, 1243, 1244, 1247, 1248, 1250, 1251, 1252, 1255, 1262, 1267, 1269, 1270, 1271, 1272, 1273, 1274, 1275, 1276, 1277, 1278, 1279, 1280, 1281, 1282, 1284, 1285, 1287, 1288, 1289, 1291, 1292, 1297, 1298, 1301, 1302, 1303, 1305, 1311, 1317, 1318, 1323, 1324, 1325, 1326, 1328, 1330, 1331, 1332, 1333, 1336, 1337, 1342, 1344, 1347, 1348, 1349, 1351, 1354, 1358, 1359, 1360, 1361, 1362, 1365, 1366, 1369, 1370, 1371, 1373, 1374, 1376, 1377, 1378, 1380, 1382, 1384, 1387, 1388, 1389, 1390, 1391, 1392, 1393, 1394, 1395, 1397, 1399, 1402, 1404, 1405, 1406, 1412, 1413, 1414, 1415, 1418, 1422, 1424, 1426, 1427, 1430, 1431, 1432, 1434, 1436, 1437, 1441, 1442, 1445, 1448, 1449, 1458, 1467, 1468, 1469, 1473, 1474, 1479, 1483, 1487, 1491, 1499, 1502, 1504, 1506, 1509, 1511, 1512, 1517, 1518, 1520, 1521, 1526, 1527, 1529, 1530, 1534, 1535, 1539, 1542, 1543, 1546, 1548, 1549, 1550, 1551, 1552, 1553, 1556, 1559, 1561, 1562, 1563, 1566, 1567, 1568, 1571, 1573, 1574, 1575, 1576, 1578, 1580, 1581, 1582, 1583, 1584, 1585, 1586, 1588, 1589, 1590, 1591, 1592, 1593, 1594, 1595, 1597, 1601, 1606, 1608, 1610, 1613, 1614, 1615, 1619, 1624, 1625, 1626, 1627, 1628, 1630, 1633, 1635, 1638, 1641, 1643, 1650, 1651, 1652, 1653, 1654, 1655, 1656, 1657, 1658, 1660, 1661, 1662, 1663, 1664, 1665, 1667, 1668, 1671, 1672, 1673, 1674, 1678, 1679, 1680, 1681, 1682, 1683, 1684, 1685, 1686, 1687, 1691, 1693, 1695, 1696, 1699, 1700, 1701, 1702, 1703, 1704, 1706, 1708, 1709, 1710, 1713, 1715, 1717, 1718, 1719, 1721, 1722, 1726, 1727, 1728, 1729, 1730, 1731, 1734, 1736, 1741, 1744, 1745, 1746, 1749, 1752, 1754, 1755, 1757, 1758, 1760, 1764, 1765, 1766, 1769, 1770, 1771, 1772, 1778, 1781, 1784, 1786, 1791, 1792, 1793, 1796, 1797, 1798, 1813, 1822, 1825, 1827, 1829, 1835, 1836, 1840, 1844, 1845, 1847, 1851, 1853, 1854, 1855, 1858, 1859, 1860, 1861, 1862, 1864, 1868, 1869, 1870, 1873, 1877, 1882, 1884, 1885, 1886, 1887, 1888, 1889, 1892, 1893, 1896, 1901, 1902, 1904, 1905, 1907, 1908, 1909, 1910, 1912, 1914, 1915, 1919, 1920, 1921, 1927, 1928, 1929, 1936, 1938, 1940, 1942, 1943, 1944, 1947, 1948, 1949, 1950, 1954, 1955, 1956, 1957, 1959, 1960, 1961, 1964, 1965, 1968, 1969, 1971, 1972, 1973, 1974, 1976, 1977, 1978, 1979, 1980, 1983, 1985, 1986, 1987, 1988, 1992, 1993, 1995, 1996, 2000, 2002, 2004, 2007, 2008, 2010, 2011, 2012, 2014, 2015, 2017, 2020, 2021, 2022, 2025, 2026, 2029, 2030, 2031, 2032, 2033, 2035, 2036, 2037, 2038, 2039, 2041, 2042, 2044, 2048, 2049, 2050, 2052, 2053, 2055, 2059, 2063, 2064, 2065, 2068, 2069, 2074, 2076, 2080, 2081, 2084, 2085, 2086, 2088, 2089, 2090, 2091, 2092, 2095, 2096, 2099, 2101, 2102, 2103, 2104, 2106, 2109, 2110, 2112, 2113, 2115, 2116, 2118, 2119, 2120, 2121, 2122, 2124, 2126, 2128, 2129, 2133, 2134, 2135, 2137, 2138, 2140, 2141, 2143, 2144, 2146, 2147, 2148, 2150, 2151, 2153, 2156, 2157, 2161, 2162, 2163, 2167, 2175, 2178, 2180, 2182, 2183, 2186, 2193, 2195, 2196, 2198, 2200, 2201, 2202, 2203, 2205, 2212, 2215, 2216, 2218, 2219, 2220, 2221, 2224, 2225, 2229, 2230, 2231, 2233, 2234, 2236, 2239, 2240, 2241, 2242, 2244, 2245, 2246, 2247, 2248, 2252, 2253, 2254, 2260, 2262, 2263, 2264, 2266, 2267, 2268, 2272, 2274, 2275, 2276, 2281, 2282, 2283, 2284, 2285, 2287, 2289, 2291, 2292, 2303, 2307, 2310, 2316, 2318, 2319, 2323, 2324, 2325, 2335, 2345, 2346, 2348, 2352, 2355, 2361, 2363, 2364, 2365, 2366, 2374, 2377, 2379, 2381, 2382, 2386, 2388, 2394, 2395, 2397, 2398, 2403, 2406, 2408, 2413, 2415, 2416, 2420, 2421, 2422, 2423, 2425, 2426, 2427, 2429, 2431, 2432, 2433, 2434, 2435, 2436, 2442, 2446, 2448, 2449, 2450, 2452, 2453, 2454, 2455, 2456, 2457, 2458, 2459, 2461, 2462, 2464, 2465, 2466, 2470, 2471, 2472, 2473, 2474, 2475, 2476, 2477, 2478, 2481, 2482, 2495, 2496, 2497, 2499, 2500, 2503, 2508, 2509, 2511, 2512, 2518, 2519, 2521, 2523, 2528, 2530, 2532, 2534, 2535, 2536, 2540, 2541, 2542, 2543, 2547, 2548, 2549, 2550, 2551, 2554, 2555, 2556, 2558, 2560, 2561, 2564, 2566, 2567, 2568, 2572, 2574, 2575, 2576, 2577, 2578, 2579, 2580, 2582, 2584, 2585, 2586, 2587, 2590, 2592, 2603, 2604, 2605, 2608, 2609, 2611, 2612, 2614, 2616, 2617, 2620, 2622, 2624, 2626, 2627, 2628, 2630, 2631, 2632, 2637, 2638, 2640, 2641, 2643, 2644, 2645, 2646, 2647, 2648, 2649, 2650, 2652, 2653, 2654, 2655, 2656, 2657, 2658, 2659, 2660, 2662, 2664, 2666, 2667, 2669, 2671, 2672, 2673, 2674, 2677, 2679, 2680, 2681, 2682, 2683, 2684, 2685, 2686, 2687, 2688, 2689, 2690, 2691, 2692, 2693, 2694, 2695, 2696, 2697, 2698, 2700, 2701, 2703, 2704, 2705, 2706, 2707, 2708, 2709, 2710, 2711, 2712, 2713, 2716, 2717, 2718, 2720, 2721, 2723, 2725, 2726, 2727, 2728, 2729, 2730, 2732, 2734, 2738, 2739, 2740, 2741, 2744, 2748, 2749, 2750, 2753, 2754, 2755, 2757, 2758, 2759, 2760, 2761, 2762, 2763, 2765, 2766, 2768, 2769, 2772, 2773, 2774, 2775, 2776, 2779, 2780, 2782, 2783, 2784, 2790, 2796, 2797, 2799, 2800, 2801, 2802, 2803, 2804, 2811, 2813, 2814, 2815, 2816, 2818, 2819, 2821, 2823, 2825, 2827, 2833, 2839, 2840, 2842, 2843, 2844, 2846, 2848, 2849, 2850, 2853, 2854, 2858, 2859, 2860, 2862, 2865, 2867, 2868, 2872, 2873, 2874, 2877, 2878, 2880, 2884, 2887, 2888, 2889, 2890, 2893, 2895, 2897, 2898, 2899, 2901, 2902, 2903, 2907, 2908, 2909, 2915, 2919, 2920, 2921, 2924, 2925, 2926, 2931, 2935, 2937, 2942, 2947, 2951, 2952, 2953, 2955, 2959, 2960, 2961, 2962, 2965, 2966, 2967, 2968, 2969, 2970, 2972, 2973, 2976, 2978, 2979, 2980, 2981, 2982, 2983, 2984, 2985, 2986, 2987, 2988, 2989, 2990, 2991, 2992, 2993, 2994, 2995, 2996, 2997, 2998, 2999, 3000, 3001, 3002, 3003, 3004, 3005, 3006, 3007, 3008, 3009, 3010, 3011, 3012, 3014, 3015, 3016, 3017, 3018, 3019, 3020, 3022, 3023, 3024, 3025, 3026, 3027, 3028, 3029, 3030, 3031, 3032, 3033, 3034, 3035, 3036, 3037, 3038, 3039, 3040, 3042, 3043, 3044, 3045, 3046, 3047, 3048, 3049, 3050, 3051, 3052, 3053, 3054, 3055, 3057, 3058, 3059, 3060, 3061, 3062, 3063, 3064, 3065, 3066, 3067, 3068, 3070, 3071, 3072, 3073, 3074, 3075, 3076, 3077, 3079, 3080, 3081, 3082, 3083, 3084, 3086, 3087, 3088, 3089, 3090, 3091, 3093, 3094, 3095, 3096, 3097, 3098, 3099, 3100, 3102, 3103, 3104, 3105, 3106, 3107, 3108, 3109, 3110, 3111, 3112, 3113, 3114, 3115, 3116, 3118, 3119, 3120, 3121, 3122, 3123, 3124, 3125, 3126, 3127, 3128, 3131, 3132, 3134, 3135, 3136, 3137, 3138, 3141, 3142, 3143, 3144, 3146, 3147, 3149, 3150, 3151, 3152, 3153, 3155, 3156, 3157, 3158, 3159, 3160, 3162, 3163, 3164, 3165, 3166, 3167, 3169, 3170, 3171, 3172, 3173, 3174, 3175, 3176, 3177, 3178, 3179, 3180, 3181, 3182, 3183, 3184, 3185, 3186, 3187, 3188, 3189, 3190, 3191, 3192, 3193, 3194, 3195, 3196, 3197, 3198, 3199, 3200, 3201, 3202, 3203, 3204, 3205, 3206, 3207, 3208, 3209, 3210, 3211, 3212, 3213, 3214, 3215, 3216, 3217, 3218, 3219, 3223, 3224, 3225, 3226, 3228, 3229, 3231, 3236, 3241, 3242, 3243, 3244, 3245, 3247, 3248, 3249, 3250, 3252, 3253, 3254, 3255, 3256, 3257, 3258, 3260, 3261, 3262, 3265, 3269, 3270, 3271, 3272, 3273, 3276, 3279, 3280, 3281, 3282, 3283, 3285, 3287, 3288, 3289, 3291, 3293, 3294, 3295, 3296, 3300, 3302, 3303, 3304, 3305, 3306, 3307, 3311, 3312, 3313, 3314, 3316, 3318, 3319, 3320, 3321, 3323, 3325, 3326, 3327, 3328, 3330, 3331, 3332, 3333, 3334, 3335, 3337, 3341, 3342, 3343, 3345, 3346, 3347, 3349, 3353, 3354, 3355, 3357, 3358, 3362, 3363, 3367, 3368, 3369, 3373, 3374, 3377, 3378, 3380, 3384, 3386, 3387, 3388, 3389, 3390, 3391, 3392, 3393, 3394, 3397, 3398, 3400, 3401, 3404, 3405, 3408, 3410, 3412, 3413, 3414, 3415, 3416, 3417, 3418, 3419, 3421, 3422, 3423, 3424, 3426, 3428, 3429, 3430, 3431, 3432, 3435, 3437, 3438, 3439, 3440, 3441, 3442, 3443, 3445, 3447, 3449, 3450, 3451, 3452, 3453, 3459, 3460, 3461, 3465, 3467, 3469, 3470, 3471, 3472, 3473, 3474, 3476, 3477, 3480, 3482, 3483, 3484, 3485, 3486, 3487, 3489, 3490, 3492, 3493, 3495, 3497, 3498, 3500, 3501, 3505, 3506, 3509, 3510, 3511, 3512, 3514, 3515, 3516, 3519, 3521, 3522, 3523, 3527, 3528, 3529, 3530, 3532, 3534, 3539, 3540, 3542, 3543, 3545, 3546, 3547, 3548, 3549, 3550, 3552, 3553, 3554, 3556, 3557, 3558, 3559, 3562, 3565, 3566, 3567, 3568, 3569, 3570, 3571, 3573, 3575, 3576, 3578, 3580, 3581, 3582, 3583, 3584, 3585, 3586, 3588, 3589, 3591, 3592, 3593, 3594, 3595, 3596, 3598, 3599, 3600, 3601, 3602, 3603, 3604, 3605, 3606, 3608, 3609, 3610, 3611, 3612, 3613, 3614, 3615, 3616, 3617, 3618, 3620, 3621, 3622, 3623, 3624, 3625, 3626, 3627, 3628, 3629, 3631, 3632, 3633, 3634, 3635, 3636, 3637, 3638, 3639, 3640, 3642, 3644, 3645, 3646, 3647, 3648, 3649, 3650, 3652, 3653, 3655, 3656, 3657, 3660, 3661, 3662, 3663, 3664, 3665, 3666, 3667, 3669, 3670, 3671, 3672, 3673, 3674, 3675, 3676, 3679, 3680, 3681, 3683, 3684, 3685, 3686, 3687, 3688, 3690, 3691, 3692, 3694, 3696, 3697, 3698, 3699, 3701, 3702, 3703, 3707, 3708, 3712, 3713, 3716, 3718, 3719, 3721, 3722, 3724, 3730, 3731, 3733, 3734, 3735, 3737, 3739, 3740, 3743, 3748, 3751, 3752, 3753, 3754, 3756, 3757, 3758, 3759, 3760, 3762, 3768, 3769, 3770, 3773, 3774, 3775, 3781, 3782, 3783, 3784, 3786, 3788, 3790, 3791, 3793, 3796, 3797, 3798, 3800, 3804, 3805, 3810, 3815, 3817, 3821, 3823, 3826, 3831, 3833, 3837, 3838, 3840, 3845, 3853, 3871, 3873, 3877, 3880, 3884, 3894, 3895, 3898, 3899, 3902, 3918, 3921, 3923, 3924, 3927, 3929, 3932, 3934, 3936, 3938, 3939, 3943, 3944, 3945, 3948, 3951, 3955, 3957, 3958, 3960, 3962, 3965, 3967, 3972, 3978, 3985, 3989, 3992, 3995, 3996, 3997, 3999, 4001, 4006, 4007, 4008, 4009, 4010, 4011, 4013, 4014, 4016, 4017, 4018, 4019, 4025, 4026, 4027, 4029, 4030, 4033, 4034, 4039, 4040, 4042, 4044, 4046, 4050, 4053, 4054, 4055, 4058, 4059, 4060, 4062, 4063, 4067, 4070, 4071, 4075, 4076, 4078, 4079, 4080, 4082, 4083, 4084, 4085, 4086, 4087, 4088, 4089, 4092, 4093, 4094, 4095, 4096, 4098, 4099, 4100, 4101, 4102, 4103, 4104, 4105, 4106, 4107, 4109, 4111, 4112, 4113, 4114, 4115, 4116, 4117, 4118, 4119, 4120, 4121, 4122, 4123, 4124, 4125, 4126, 4127, 4128, 4129, 4132, 4133, 4134, 4135, 4136, 4137, 4138, 4139, 4140, 4141, 4142, 4143, 4144, 4145, 4147, 4148, 4149, 4150, 4151, 4152, 4153, 4154, 4155, 4156, 4157, 4158, 4159, 4160, 4161, 4163, 4164, 4165, 4166, 4167, 4168, 4169, 4170, 4171, 4172, 4173, 4174, 4175, 4176, 4177, 4178, 4179, 4181, 4182, 4183, 4184, 4185, 4186, 4187, 4188, 4189, 4190, 4191, 4192, 4193, 4194, 4195, 4196, 4197, 4198, 4200, 4201, 4202, 4203, 4204, 4205, 4206, 4207, 4208, 4209, 4210, 4211, 4212, 4213, 4214, 4215, 4216, 4217, 4218, 4219, 4221, 4222, 4223, 4224, 4225, 4226, 4227, 4228, 4229, 4230, 4231, 4232, 4233, 4234, 4235, 4237, 4238, 4239, 4240, 4241, 4242, 4243, 4244, 4245, 4246, 4247, 4248, 4249, 4250, 4251, 4252, 4253, 4254, 4255, 4256, 4257, 4258, 4259, 4260, 4261, 4262, 4263, 4264, 4265, 4266, 4267, 4269, 4270, 4271, 4272, 4273, 4275, 4276, 4277, 4278, 4279, 4280, 4281, 4282, 4283, 4284, 4286, 4287, 4288, 4289, 4290, 4292, 4293, 4294, 4295, 4297, 4298, 4299, 4300, 4301, 4302, 4303, 4304, 4305, 4306, 4307, 4308, 4309, 4310, 4311, 4312, 4313, 4314, 4315, 4316, 4317, 4318, 4319, 4320, 4321, 4322, 4323, 4325, 4326, 4327, 4328, 4329, 4330, 4331, 4333, 4334, 4335, 4336, 4337, 4339, 4340, 4341, 4342, 4343, 4344, 4345, 4346, 4347, 4348, 4349, 4350, 4351, 4352, 4353, 4354, 4356, 4357, 4358, 4359, 4361, 4362, 4363, 4364, 4365, 4366, 4367, 4368, 4369, 4370, 4371, 4372, 4373, 4374, 4375, 4376, 4377, 4378, 4380, 4381, 4382, 4383, 4384, 4385, 4386, 4387, 4388, 4389, 4390, 4391, 4394, 4395, 4396, 4397, 4399, 4400, 4401, 4402, 4403, 4404, 4405, 4406, 4408, 4409, 4410, 4411, 4412, 4413, 4414, 4415, 4416, 4417, 4418, 4420, 4421, 4423, 4424, 4425, 4426, 4427, 4428, 4429, 4430, 4432, 4433, 4434, 4435, 4436, 4437, 4438, 4439, 4440, 4441, 4443, 4444, 4446, 4447, 4448, 4449, 4452, 4453, 4455, 4456, 4457, 4458, 4459, 4460, 4463, 4465, 4466, 4467, 4468, 4471, 4472, 4473, 4474, 4477, 4478, 4479, 4480, 4481, 4492, 4493, 4495, 4498, 4500, 4501, 4502, 4503, 4504, 4506, 4507, 4508, 4509, 4510, 4511, 4512, 4513, 4514, 4515, 4516, 4518, 4519, 4520, 4521, 4522, 4523, 4524, 4525, 4526, 4527, 4528, 4530, 4531, 4532, 4533, 4534, 4535, 4536, 4538, 4539, 4540, 4541, 4542, 4543, 4545, 4548, 4549, 4551, 4552, 4553, 4554, 4556, 4558, 4559, 4564, 4565, 4566, 4567, 4568, 4569, 4570, 4571, 4572, 4573, 4574, 4576, 4580, 4581, 4583, 4584, 4586, 4589, 4590, 4591, 4593, 4595, 4596, 4597, 4599, 4602, 4603, 4604, 4605, 4607, 4608, 4612, 4613, 4615, 4616, 4622, 4623, 4625, 4626, 4628, 4629, 4630, 4635, 4636, 4639, 4640, 4641, 4645, 4646, 4648, 4650, 4651, 4652, 4655, 4656, 4657, 4658, 4659, 4660, 4661, 4662, 4665, 4666, 4668, 4669, 4670, 4672, 4674, 4675, 4676, 4678, 4679, 4680, 4681, 4684, 4686, 4688, 4689, 4693, 4694, 4697, 4698, 4699, 4704, 4707, 4718, 4723, 4726, 4728, 4735, 4747, 4748, 4750, 4752, 4756, 4758, 4759, 4760, 4761, 4762, 4765, 4768, 4771, 4775, 4777, 4781, 4783, 4785, 4792, 4795, 4797, 4798, 4799, 4800, 4801, 4804, 4806, 4813, 4814, 4815, 4816, 4822, 4827, 4828, 4831, 4832, 4834, 4837, 4839, 4842, 4845, 4846, 4849, 4850, 4852, 4853, 4858, 4859, 4860, 4863, 4866, 4867, 4874, 4875, 4876, 4877, 4878, 4879, 4880, 4881, 4882, 4883, 4885, 4888, 4889, 4890, 4891, 4892, 4894, 4895, 4898, 4899, 4900, 4901, 4902, 4903, 4904, 4905, 4907, 4908, 4909, 4910, 4911, 4912, 4915, 4916, 4917, 4918, 4919, 4922, 4926, 4927, 4928, 4935, 4936, 4940, 4942, 4943, 4944, 4945, 4946, 4947, 4948, 4949, 4950, 4951, 4954, 4955, 4957, 4958, 4959, 4963, 4964, 4965, 4967, 4969, 4970, 4971, 4980, 4981, 4982, 4983, 4984, 4991, 4995, 4996, 4998, 5000, 5004, 5005, 5007, 5009, 5010, 5015, 5021, 5022, 5023, 5026, 5029, 5032, 5033, 5036, 5037, 5041, 5042, 5047, 5050, 5051, 5052, 5053, 5055, 5058, 5060, 5061, 5063, 5064, 5065, 5069, 5077, 5083, 5084, 5095, 5100, 5101, 5105, 5106, 5112, 5113, 5115, 5116, 5118, 5119, 5123, 5124, 5125, 5126, 5127, 5128, 5129, 5133, 5134, 5141, 5144, 5151, 5155, 5157, 5158, 5161, 5164, 5167, 5170, 5172, 5174, 5175, 5188, 5190, 5193, 5195, 5196, 5199, 5204, 5205, 5211, 5212, 5216, 5217, 5218, 5221, 5226, 5231, 5232, 5236, 5237, 5242, 5253, 5257, 5258, 5259, 5260, 5261, 5263, 5271, 5273, 5274, 5276, 5277, 5280, 5281, 5282, 5283, 5284, 5286, 5299, 5300, 5303, 5304, 5306, 5307, 5308, 5309, 5310, 5311, 5312, 5314, 5315, 5317, 5319, 5324, 5325, 5326, 5327, 5330, 5331, 5334, 5335, 5338, 5341, 5342, 5344, 5345, 5346, 5347, 5348, 5350, 5351, 5357, 5363, 5364, 5365, 5367, 5368, 5369, 5370, 5373, 5375, 5378, 5379, 5380, 5381, 5383, 5392, 5394, 5397, 5399, 5400, 5401, 5403, 5410, 5412, 5413, 5416, 5418, 5419, 5420, 5422, 5423, 5425, 5426, 5427, 5433, 5434, 5435, 5437, 5438, 5440, 5441, 5444, 5445, 5447, 5448, 5450, 5451, 5453, 5455, 5457, 5458, 5459, 5460, 5461, 5464, 5469, 5470, 5471, 5476, 5478, 5479, 5480, 5481, 5483, 5490, 5491, 5492, 5493, 5497, 5499, 5500, 5501, 5503, 5504, 5505, 5506, 5507, 5514, 5515, 5517, 5519, 5521, 5522, 5523, 5524, 5530, 5531, 5532, 5533, 5534, 5535, 5536, 5537, 5538, 5539, 5541, 5542, 5543, 5547, 5548, 5549, 5552, 5557, 5561, 5562, 5563, 5564, 5565, 5566, 5567, 5571, 5573, 5574, 5577, 5582, 5583, 5584, 5585, 5588, 5590, 5595, 5596, 5597, 5600, 5601, 5605, 5606, 5607, 5612, 5615, 5617, 5625, 5626, 5627, 5628, 5629, 5633, 5634, 5635, 5636, 5639, 5640, 5642, 5645, 5648, 5649, 5650, 5651, 5656, 5660, 5661, 5672, 5674, 5679, 5688, 5689, 5694, 5695, 5696, 5697, 5700, 5703, 5709, 5713, 5714, 5717, 5718, 5720, 5722, 5723, 5724, 5726, 5728, 5729, 5730, 5731, 5732, 5733, 5734, 5735, 5737, 5739, 5740, 5741, 5743, 5744, 5745, 5746, 5749, 5753, 5754, 5757, 5760, 5762, 5764, 5765, 5767, 5768, 5769, 5771, 5773, 5777, 5778, 5779, 5780, 5781, 5782, 5783, 5784, 5785, 5786, 5787, 5791, 5792, 5793, 5794, 5795, 5796, 5797, 5799, 5800, 5801, 5802, 5804, 5806, 5809, 5810, 5817, 5821, 5822, 5823, 5826, 5827, 5831, 5832, 5834, 5835, 5836, 5839, 5840, 5841, 5843, 5848, 5853, 5854, 5856, 5858, 5859, 5860, 5861, 5862, 5863, 5864, 5865, 5866, 5868, 5869, 5870, 5871, 5874, 5875, 5876, 5877, 5878, 5880, 5881, 5882, 5883, 5884, 5886, 5887, 5888, 5889, 5890, 5891, 5892, 5893, 5895, 5897, 5898, 5899, 5900, 5901, 5902, 5903, 5904, 5905, 5907, 5909, 5910, 5912, 5914, 5915, 5918, 5919, 5920, 5921, 5922, 5925, 5927, 5928, 5934, 5935, 5940, 5942, 5943, 5945, 5946, 5947, 5948, 5949, 5952, 5953, 5954, 5956, 5960, 5962, 5963, 5970, 5971, 5980, 5981, 5986, 5988, 5990, 5991, 5996, 5997, 5998, 5999, 6000, 6004, 6007, 6009, 6012, 6017, 6019, 6021, 6022, 6025, 6027, 6030, 6031, 6032, 6034, 6036, 6040, 6042, 6043, 6047, 6048, 6049, 6056, 6057, 6061, 6063, 6070, 6071, 6078, 6084, 6086, 6087, 6092, 6104, 6105, 6106, 6111, 6112, 6113, 6115, 6116, 6117, 6118, 6121, 6123, 6124, 6131, 6132, 6134, 6139, 6141, 6145, 6146, 6147, 6149, 6153, 6154, 6155, 6159, 6160, 6166, 6167, 6168, 6169, 6170, 6173, 6174, 6178, 6181, 6182, 6183, 6184, 6185, 6187, 6192, 6193, 6195, 6197, 6201, 6221, 6223, 6228, 6229, 6231, 6234, 6236, 6239, 6246, 6247, 6252, 6253, 6254, 6258, 6261, 6263, 6264, 6265, 6267, 6269, 6270, 6271, 6272, 6274, 6275, 6276, 6277, 6279, 6282, 6285, 6286, 6287, 6290, 6291, 6292, 6296, 6298, 6300, 6302, 6303, 6304, 6311, 6313, 6314, 6315, 6319, 6321, 6324, 6326, 6329, 6330, 6331, 6332, 6334, 6338, 6339, 6341, 6343, 6345, 6346, 6347, 6349, 6350, 6351, 6353, 6354, 6356, 6358, 6360, 6362, 6369, 6372, 6376, 6388, 6393, 6396, 6401, 6402, 6404, 6407, 6413, 6415, 6419, 6420, 6421, 6422, 6426, 6427, 6429, 6436, 6438, 6440, 6446, 6452, 6453, 6454, 6455, 6460, 6464, 6466, 6468, 6474, 6479, 6483, 6485, 6487, 6492, 6494, 6495, 6496, 6497, 6509, 6512, 6513, 6515, 6516, 6528, 6529, 6531, 6532, 6533, 6534, 6535, 6536, 6537, 6538, 6539, 6540, 6541, 6542, 6543, 6544, 6558, 6559, 6561, 6572, 6579, 6586, 6591, 6592, 6603, 6611, 6615, 6616, 6617, 6623, 6624, 6633, 6634, 6639, 6641, 6642, 6645, 6646, 6647, 6654, 6655, 6663, 6665, 6667, 6668, 6673, 6675, 6676, 6678, 6679, 6680, 6682, 6684, 6691, 6692, 6693, 6698, 6699, 6700, 6703, 6704, 6705, 6706, 6707, 6709, 6712, 6713, 6714, 6717, 6718, 6719, 6720, 6721, 6722, 6723, 6724, 6725, 6726, 6727, 6728, 6729, 6730, 6731, 6732, 6733, 6734, 6735, 6736, 6737, 6738, 6739, 6740, 6741, 6742, 6743, 6744, 6745, 6747, 6750, 6751, 6752, 6754, 6755, 6756, 6757, 6758, 6759, 6760, 6762, 6764, 6765, 6766, 6767, 6768, 6769, 6770, 6771, 6772, 6773, 6774, 6775, 6776, 6777, 6778, 6779, 6780, 6781, 6782, 6784, 6785, 6786, 6787, 6788, 6789, 6790, 6791, 6792, 6793}",4131
2,"(('exit', ('Request For Payment FINAL_APPROVED by SUPERVISOR', 'Request Payment')), ('enter', ('Request Payment', 'Payment Handled')))",2,52,"{0, 1, 2, 3, 4, 5, 6, 7, 8, 9, 10, 11, 12, 14, 15, 16, 17, 18, 20, 21, 22, 23, 24, 25, 27, 28, 29, 30, 31, 32, 33, 34, 35, 36, 37, 38, 39, 42, 43, 44, 45, 46, 47, 48, 49, 50, 51, 52, 53, 54, 55, 56, 57, 58, 59, 60, 61, 62, 64, 65, 66, 67, 68, 69, 70, 71, 72, 73, 74, 75, 78, 79, 80, 81, 83, 84, 85, 86, 88, 89, 90, 91, 92, 93, 94, 95, 96, 97, 98, 99, 100, 101, 102, 103, 104, 105, 106, 107, 108, 109, 110, 111, 112, 113, 114, 116, 118, 123, 124, 125, 126, 127, 128, 129, 130, 131, 132, 133, 134, 135, 136, 137, 138, 139, 140, 141, 143, 144, 145, 146, 147, 148, 149, 150, 151, 153, 154, 155, 156, 158, 159, 160, 161, 162, 163, 164, 165, 166, 167, 168, 169, 171, 172, 175, 176, 179, 180, 181, 182, 183, 184, 185, 186, 187, 188, 189, 190, 191, 192, 193, 194, 195, 196, 198, 199, 200, 201, 202, 203, 204, 205, 206, 207, 208, 209, 210, 211, 212, 213, 214, 215, 216, 217, 218, 219, 220, 221, 222, 223, 224, 225, 226, 227, 228, 229, 230, 231, 232, 234, 235, 236, 237, 238, 239, 240, 241, 242, 243, 244, 245, 246, 247, 248, 249, 250, 251, 252, 253, 254, 256, 257, 258, 259, 260, 261, 262, 263, 264, 265, 266, 267, 268, 269, 271, 272, 273, 274, 275, 276, 277, 278, 279, 280, 281, 282, 283, 284, 285, 286, 287, 288, 289, 290, 291, 292, 293, 294, 295, 296, 297, 298, 300, 301, 302, 303, 305, 307, 310, 311, 312, 313, 314, 315, 316, 317, 318, 321, 322, 323, 324, 325, 326, 327, 331, 332, 333, 334, 335, 336, 337, 338, 339, 340, 341, 342, 343, 344, 345, 346, 348, 349, 350, 351, 352, 353, 356, 357, 358, 359, 360, 361, 362, 363, 364, 365, 366, 367, 368, 369, 370, 372, 373, 375, 376, 377, 378, 379, 380, 382, 383, 384, 385, 386, 387, 388, 389, 390, 391, 392, 393, 394, 395, 396, 397, 398, 399, 400, 401, 402, 403, 404, 405, 406, 407, 408, 409, 410, 411, 414, 415, 416, 417, 418, 419, 420, 421, 422, 423, 424, 425, 426, 427, 428, 429, 430, 431, 433, 434, 435, 436, 437, 438, 439, 440, 441, 443, 444, 445, 446, 447, 449, 450, 451, 452, 453, 454, 456, 457, 458, 459, 460, 461, 462, 463, 464, 466, 467, 468, 469, 470, 471, 473, 474, 475, 476, 477, 478, 479, 481, 482, 483, 484, 486, 487, 488, 489, 490, 491, 492, 493, 494, 495, 496, 497, 498, 499, 500, 501, 502, 503, 504, 505, 506, 508, 509, 510, 511, 512, 513, 514, 515, 516, 518, 519, 520, 521, 522, 523, 524, 525, 526, 527, 528, 530, 531, 533, 534, 535, 536, 537, 538, 539, 540, 541, 542, 543, 544, 545, 546, 547, 548, 549, 550, 551, 552, 553, 554, 555, 556, 557, 558, 559, 560, 561, 562, 563, 565, 566, 567, 568, 569, 570, 571, 572, 573, 574, 575, 576, 577, 578, 580, 582, 583, 584, 585, 586, 590, 591, 593, 594, 596, 597, 598, 599, 600, 601, 602, 603, 604, 605, 606, 607, 608, 610, 611, 612, 613, 614, 616, 617, 618, 620, 621, 622, 623, 624, 625, 626, 627, 628, 629, 631, 632, 633, 634, 635, 636, 637, 638, 639, 640, 641, 642, 643, 644, 645, 646, 647, 648, 649, 650, 651, 652, 653, 654, 655, 656, 657, 658, 659, 660, 661, 662, 663, 664, 665, 666, 667, 668, 669, 670, 671, 672, 673, 674, 675, 676, 677, 678, 679, 680, 681, 682, 683, 684, 685, 686, 687, 688, 689, 690, 693, 695, 696, 697, 698, 699, 700, 701, 702, 703, 704, 705, 706, 707, 708, 709, 710, 711, 712, 713, 714, 715, 716, 717, 718, 719, 720, 721, 722, 723, 724, 725, 726, 727, 728, 729, 730, 731, 732, 733, 734, 735, 736, 737, 738, 739, 740, 741, 742, 743, 744, 745, 746, 748, 749, 750, 751, 752, 753, 754, 755, 756, 757, 758, 759, 760, 761, 762, 763, 764, 765, 766, 767, 768, 769, 770, 771, 773, 774, 775, 776, 777, 778, 779, 780, 781, 782, 783, 784, 785, 786, 787, 788, 789, 790, 791, 792, 794, 795, 796, 797, 798, 799, 800, 801, 802, 803, 804, 805, 806, 807, 808, 809, 810, 811, 812, 813, 814, 815, 816, 817, 819, 820, 821, 824, 825, 826, 828, 829, 830, 831, 832, 833, 834, 835, 836, 837, 838, 839, 840, 841, 842, 843, 844, 845, 846, 847, 848, 849, 850, 851, 852, 854, 855, 856, 857, 858, 859, 860, 861, 862, 864, 865, 866, 867, 868, 869, 870, 871, 872, 873, 874, 875, 876, 877, 878, 879, 880, 881, 882, 883, 884, 885, 886, 887, 888, 889, 890, 891, 892, 893, 894, 895, 896, 897, 898, 899, 900, 901, 902, 903, 904, 905, 906, 907, 908, 909, 910, 911, 912, 913, 914, 915, 916, 917, 918, 919, 920, 921, 922, 923, 924, 925, 926, 927, 928, 929, 930, 931, 932, 933, 935, 936, 937, 939, 940, 941, 942, 943, 944, 945, 946, 947, 948, 949, 950, 951, 952, 953, 954, 955, 956, 957, 958, 959, 960, 961, 962, 963, 964, 965, 966, 967, 968, 969, 970, 971, 972, 973, 974, 975, 976, 977, 978, 979, 980, 981, 982, 983, 984, 985, 986, 987, 988, 989, 990, 991, 992, 993, 994, 996, 997, 999, 1000, 1001, 1002, 1003, 1004, 1005, 1006, 1007, 1008, 1009, 1010, 1011, 1012, 1013, 1014, 1015, 1016, 1017, 1018, 1019, 1020, 1021, 1022, 1023, 1024, 1025, 1026, 1028, 1029, 1030, 1031, 1032, 1033, 1034, 1036, 1037, 1038, 1039, 1040, 1041, 1042, 1043, 1044, 1045, 1046, 1047, 1048, 1050, 1051, 1052, 1053, 1054, 1055, 1056, 1057, 1058, 1059, 1060, 1061, 1063, 1064, 1065, 1066, 1067, 1069, 1070, 1071, 1073, 1074, 1075, 1076, 1077, 1078, 1079, 1080, 1081, 1082, 1083, 1085, 1086, 1087, 1088, 1089, 1090, 1092, 1093, 1094, 1095, 1096, 1097, 1098, 1099, 1100, 1101, 1103, 1104, 1105, 1106, 1107, 1108, 1109, 1110, 1111, 1112, 1113, 1114, 1115, 1116, 1117, 1118, 1119, 1120, 1121, 1122, 1123, 1124, 1125, 1126, 1127, 1128, 1129, 1130, 1131, 1132, 1133, 1134, 1135, 1136, 1137, 1138, 1140, 1141, 1142, 1143, 1144, 1145, 1146, 1147, 1148, 1149, 1150, 1151, 1152, 1153, 1154, 1155, 1156, 1157, 1158, 1159, 1160, 1161, 1162, 1163, 1165, 1166, 1167, 1168, 1169, 1170, 1171, 1172, 1173, 1174, 1175, 1176, 1177, 1178, 1179, 1180, 1181, 1182, 1183, 1184, 1185, 1186, 1187, 1188, 1189, 1190, 1191, 1192, 1193, 1194, 1195, 1196, 1197, 1198, 1199, 1200, 1201, 1202, 1203, 1204, 1205, 1206, 1207, 1208, 1209, 1210, 1211, 1212, 1213, 1214, 1215, 1216, 1217, 1218, 1219, 1220, 1221, 1222, 1223, 1224, 1225, 1226, 1227, 1228, 1229, 1230, 1231, 1232, 1233, 1234, 1235, 1236, 1237, 1238, 1239, 1240, 1241, 1242, 1243, 1244, 1245, 1246, 1247, 1248, 1249, 1250, 1251, 1252, 1253, 1254, 1255, 1258, 1259, 1260, 1262, 1263, 1264, 1265, 1267, 1268, 1269, 1270, 1271, 1272, 1273, 1274, 1275, 1276, 1277, 1278, 1279, 1280, 1281, 1282, 1283, 1284, 1285, 1286, 1287, 1288, 1289, 1290, 1291, 1292, 1293, 1294, 1295, 1298, 1299, 1300, 1301, 1302, 1303, 1304, 1305, 1306, 1307, 1308, 1309, 1310, 1311, 1313, 1314, 1315, 1316, 1317, 1318, 1320, 1321, 1323, 1324, 1325, 1326, 1327, 1328, 1329, 1330, 1331, 1332, 1333, 1334, 1335, 1336, 1337, 1338, 1339, 1340, 1342, 1343, 1344, 1345, 1346, 1347, 1348, 1349, 1350, 1351, 1352, 1353, 1354, 1355, 1356, 1357, 1358, 1359, 1360, 1361, 1362, 1364, 1365, 1366, 1367, 1368, 1369, 1370, 1371, 1372, 1373, 1374, 1375, 1376, 1377, 1378, 1379, 1380, 1381, 1382, 1383, 1384, 1385, 1386, 1387, 1388, 1389, 1390, 1391, 1392, 1393, 1394, 1395, 1396, 1397, 1399, 1400, 1401, 1402, 1403, 1404, 1405, 1406, 1407, 1408, 1409, 1410, 1411, 1412, 1413, 1414, 1415, 1416, 1418, 1419, 1420, 1421, 1422, 1423, 1424, 1426, 1427, 1428, 1429, 1430, 1431, 1432, 1433, 1434, 1435, 1436, 1437, 1439, 1440, 1441, 1442, 1443, 1445, 1446, 1447, 1448, 1449, 1450, 1451, 1452, 1453, 1454, 1455, 1456, 1457, 1458, 1459, 1460, 1461, 1462, 1464, 1465, 1466, 1467, 1468, 1469, 1470, 1471, 1472, 1473, 1474, 1475, 1476, 1477, 1478, 1479, 1481, 1482, 1483, 1484, 1485, 1487, 1488, 1489, 1491, 1492, 1493, 1494, 1495, 1496, 1499, 1500, 1501, 1502, 1503, 1504, 1505, 1506, 1507, 1508, 1509, 1510, 1511, 1512, 1513, 1514, 1515, 1516, 1517, 1518, 1519, 1520, 1521, 1522, 1523, 1524, 1525, 1526, 1527, 1528, 1529, 1530, 1531, 1532, 1533, 1534, 1535, 1536, 1538, 1539, 1540, 1541, 1542, 1543, 1544, 1545, 1546, 1548, 1549, 1550, 1551, 1552, 1553, 1554, 1556, 1557, 1558, 1559, 1560, 1561, 1562, 1563, 1564, 1565, 1566, 1567, 1568, 1569, 1570, 1571, 1572, 1573, 1574, 1575, 1576, 1577, 1578, 1579, 1580, 1581, 1582, 1583, 1584, 1585, 1586, 1587, 1588, 1589, 1590, 1591, 1592, 1593, 1594, 1595, 1596, 1597, 1598, 1599, 1600, 1601, 1602, 1603, 1604, 1605, 1606, 1607, 1608, 1609, 1610, 1612, 1613, 1614, 1615, 1616, 1617, 1618, 1619, 1620, 1621, 1622, 1623, 1624, 1625, 1626, 1627, 1628, 1629, 1630, 1631, 1632, 1633, 1634, 1635, 1636, 1637, 1638, 1639, 1640, 1641, 1642, 1643, 1644, 1645, 1646, 1647, 1648, 1649, 1650, 1651, 1652, 1653, 1654, 1655, 1656, 1657, 1658, 1659, 1660, 1661, 1662, 1663, 1664, 1665, 1666, 1667, 1668, 1669, 1670, 1671, 1672, 1673, 1674, 1675, 1676, 1678, 1679, 1680, 1681, 1682, 1683, 1684, 1685, 1686, 1687, 1688, 1689, 1690, 1691, 1692, 1693, 1694, 1695, 1696, 1697, 1698, 1699, 1700, 1701, 1702, 1703, 1704, 1705, 1706, 1707, 1708, 1709, 1710, 1711, 1712, 1713, 1714, 1715, 1716, 1717, 1718, 1719, 1720, 1721, 1722, 1723, 1724, 1725, 1726, 1727, 1728, 1729, 1730, 1731, 1732, 1734, 1735, 1736, 1737, 1738, 1739, 1740, 1741, 1742, 1743, 1744, 1745, 1746, 1747, 1748, 1749, 1752, 1753, 1754, 1755, 1756, 1757, 1758, 1759, 1760, 1761, 1762, 1764, 1765, 1766, 1767, 1768, 1769, 1770, 1771, 1772, 1773, 1774, 1775, 1776, 1778, 1779, 1780, 1781, 1782, 1783, 1784, 1785, 1786, 1787, 1788, 1789, 1790, 1791, 1792, 1793, 1795, 1796, 1797, 1798, 1799, 1800, 1801, 1802, 1803, 1804, 1805, 1806, 1807, 1808, 1809, 1810, 1811, 1812, 1813, 1814, 1815, 1816, 1817, 1818, 1819, 1820, 1821, 1822, 1823, 1824, 1825, 1826, 1827, 1828, 1829, 1830, 1831, 1832, 1833, 1834, 1835, 1836, 1837, 1838, 1839, 1840, 1841, 1842, 1843, 1844, 1845, 1846, 1847, 1848, 1849, 1850, 1851, 1852, 1853, 1854, 1855, 1857, 1858, 1859, 1860, 1861, 1862, 1863, 1864, 1865, 1866, 1867, 1868, 1869, 1870, 1871, 1872, 1873, 1874, 1875, 1876, 1877, 1878, 1879, 1880, 1881, 1882, 1883, 1884, 1885, 1886, 1887, 1888, 1889, 1890, 1891, 1892, 1893, 1894, 1895, 1896, 1897, 1898, 1899, 1900, 1901, 1902, 1903, 1904, 1905, 1907, 1908, 1909, 1910, 1911, 1912, 1914, 1915, 1916, 1918, 1919, 1920, 1921, 1922, 1923, 1924, 1925, 1926, 1927, 1928, 1929, 1930, 1931, 1932, 1934, 1936, 1937, 1938, 1939, 1940, 1941, 1942, 1943, 1944, 1945, 1946, 1947, 1948, 1949, 1950, 1951, 1952, 1954, 1955, 1956, 1957, 1958, 1959, 1960, 1961, 1962, 1963, 1964, 1965, 1966, 1967, 1968, 1969, 1970, 1971, 1972, 1973, 1974, 1975, 1976, 1977, 1978, 1979, 1980, 1981, 1982, 1983, 1984, 1985, 1986, 1987, 1988, 1990, 1991, 1992, 1993, 1994, 1995, 1996, 1997, 1998, 1999, 2000, 2001, 2002, 2003, 2004, 2005, 2006, 2007, 2008, 2009, 2010, 2011, 2012, 2014, 2015, 2016, 2017, 2018, 2019, 2020, 2021, 2022, 2023, 2024, 2025, 2026, 2027, 2028, 2029, 2030, 2031, 2032, 2033, 2034, 2035, 2036, 2037, 2038, 2039, 2040, 2041, 2042, 2043, 2044, 2045, 2046, 2047, 2049, 2050, 2051, 2052, 2053, 2055, 2056, 2057, 2058, 2059, 2060, 2061, 2062, 2063, 2064, 2065, 2066, 2067, 2068, 2069, 2070, 2071, 2073, 2074, 2075, 2076, 2077, 2079, 2080, 2081, 2082, 2083, 2084, 2085, 2086, 2087, 2088, 2089, 2090, 2091, 2092, 2094, 2095, 2096, 2097, 2098, 2099, 2100, 2101, 2102, 2103, 2104, 2106, 2107, 2108, 2109, 2110, 2111, 2112, 2113, 2114, 2115, 2116, 2117, 2118, 2119, 2120, 2121, 2122, 2123, 2124, 2125, 2126, 2128, 2129, 2130, 2131, 2132, 2133, 2134, 2135, 2137, 2138, 2139, 2140, 2141, 2142, 2143, 2144, 2146, 2147, 2148, 2149, 2150, 2151, 2152, 2153, 2154, 2155, 2156, 2157, 2158, 2159, 2160, 2161, 2162, 2163, 2164, 2166, 2167, 2168, 2169, 2170, 2171, 2172, 2173, 2174, 2175, 2176, 2177, 2178, 2179, 2180, 2181, 2182, 2183, 2184, 2185, 2186, 2187, 2188, 2189, 2190, 2191, 2192, 2193, 2194, 2195, 2196, 2197, 2198, 2200, 2201, 2202, 2203, 2204, 2205, 2206, 2207, 2208, 2209, 2210, 2211, 2212, 2213, 2214, 2215, 2216, 2217, 2218, 2219, 2220, 2221, 2222, 2223, 2224, 2225, 2226, 2228, 2229, 2230, 2231, 2232, 2233, 2234, 2235, 2236, 2237, 2239, 2240, 2241, 2242, 2243, 2244, 2245, 2246, 2247, 2248, 2249, 2250, 2251, 2252, 2253, 2254, 2255, 2259, 2260, 2261, 2262, 2263, 2264, 2265, 2266, 2267, 2268, 2269, 2270, 2271, 2272, 2273, 2274, 2275, 2276, 2277, 2280, 2281, 2282, 2283, 2284, 2285, 2287, 2288, 2289, 2290, 2291, 2292, 2293, 2294, 2295, 2296, 2297, 2298, 2299, 2300, 2301, 2302, 2303, 2304, 2305, 2306, 2307, 2309, 2310, 2311, 2312, 2313, 2315, 2316, 2317, 2318, 2319, 2320, 2321, 2322, 2323, 2324, 2325, 2327, 2328, 2329, 2330, 2331, 2332, 2333, 2334, 2335, 2336, 2337, 2338, 2339, 2340, 2341, 2342, 2344, 2345, 2346, 2347, 2348, 2349, 2350, 2351, 2352, 2353, 2354, 2355, 2356, 2357, 2358, 2359, 2360, 2361, 2362, 2363, 2364, 2365, 2366, 2367, 2368, 2369, 2370, 2371, 2373, 2374, 2375, 2376, 2377, 2378, 2379, 2380, 2381, 2382, 2383, 2384, 2385, 2386, 2387, 2388, 2389, 2390, 2391, 2392, 2393, 2394, 2395, 2396, 2397, 2398, 2399, 2401, 2402, 2403, 2404, 2405, 2406, 2407, 2408, 2409, 2410, 2411, 2412, 2413, 2414, 2415, 2416, 2419, 2420, 2421, 2422, 2423, 2424, 2425, 2426, 2427, 2428, 2429, 2430, 2431, 2432, 2433, 2434, 2435, 2436, 2437, 2438, 2439, 2440, 2441, 2442, 2443, 2444, 2445, 2448, 2449, 2450, 2452, 2453, 2454, 2455, 2456, 2457, 2458, 2459, 2460, 2461, 2462, 2463, 2464, 2465, 2466, 2467, 2469, 2470, 2471, 2472, 2473, 2474, 2475, 2476, 2477, 2478, 2479, 2480, 2481, 2482, 2483, 2484, 2485, 2486, 2487, 2488, 2489, 2490, 2491, 2492, 2494, 2495, 2496, 2497, 2499, 2500, 2501, 2503, 2504, 2505, 2506, 2508, 2509, 2510, 2511, 2512, 2513, 2514, 2515, 2516, 2517, 2518, 2519, 2520, 2521, 2522, 2523, 2524, 2525, 2526, 2527, 2528, 2529, 2530, 2531, 2532, 2533, 2534, 2535, 2536, 2537, 2538, 2540, 2541, 2543, 2544, 2546, 2547, 2548, 2549, 2550, 2551, 2552, 2553, 2554, 2555, 2556, 2557, 2558, 2559, 2560, 2561, 2562, 2563, 2564, 2566, 2567, 2568, 2569, 2570, 2572, 2574, 2575, 2576, 2577, 2578, 2579, 2580, 2581, 2582, 2583, 2584, 2585, 2586, 2587, 2590, 2591, 2592, 2593, 2594, 2595, 2596, 2597, 2598, 2599, 2600, 2601, 2603, 2604, 2605, 2606, 2607, 2608, 2609, 2610, 2611, 2612, 2613, 2614, 2615, 2616, 2617, 2620, 2621, 2622, 2623, 2624, 2625, 2626, 2627, 2628, 2629, 2630, 2631, 2632, 2633, 2635, 2636, 2637, 2639, 2640, 2641, 2642, 2643, 2644, 2645, 2646, 2647, 2648, 2649, 2650, 2652, 2653, 2654, 2655, 2656, 2657, 2658, 2659, 2660, 2662, 2664, 2666, 2667, 2668, 2669, 2671, 2672, 2673, 2674, 2677, 2679, 2680, 2681, 2682, 2683, 2684, 2685, 2686, 2687, 2688, 2689, 2690, 2691, 2692, 2693, 2694, 2695, 2696, 2697, 2698, 2699, 2700, 2701, 2703, 2704, 2705, 2706, 2707, 2708, 2709, 2710, 2711, 2712, 2713, 2715, 2716, 2717, 2718, 2720, 2721, 2723, 2724, 2725, 2726, 2727, 2728, 2729, 2730, 2731, 2732, 2733, 2734, 2735, 2736, 2737, 2738, 2739, 2740, 2741, 2744, 2745, 2746, 2747, 2748, 2749, 2750, 2751, 2753, 2754, 2755, 2756, 2757, 2758, 2759, 2760, 2761, 2762, 2763, 2764, 2765, 2766, 2768, 2769, 2770, 2771, 2772, 2773, 2774, 2775, 2776, 2777, 2779, 2780, 2782, 2783, 2784, 2785, 2786, 2787, 2789, 2790, 2791, 2792, 2793, 2794, 2795, 2796, 2797, 2798, 2799, 2800, 2801, 2802, 2803, 2804, 2805, 2806, 2807, 2808, 2809, 2811, 2812, 2813, 2814, 2815, 2816, 2817, 2818, 2819, 2820, 2821, 2822, 2823, 2825, 2826, 2827, 2828, 2830, 2831, 2832, 2833, 2834, 2835, 2836, 2837, 2838, 2839, 2840, 2841, 2842, 2843, 2844, 2845, 2846, 2847, 2848, 2849, 2850, 2851, 2852, 2853, 2854, 2855, 2856, 2857, 2858, 2859, 2860, 2861, 2862, 2863, 2865, 2866, 2867, 2868, 2869, 2870, 2871, 2872, 2873, 2874, 2875, 2877, 2878, 2880, 2883, 2884, 2886, 2887, 2888, 2889, 2890, 2891, 2892, 2893, 2894, 2895, 2896, 2897, 2898, 2899, 2900, 2901, 2902, 2903, 2904, 2905, 2906, 2907, 2908, 2909, 2910, 2911, 2912, 2914, 2915, 2916, 2917, 2918, 2919, 2920, 2921, 2923, 2924, 2925, 2926, 2927, 2930, 2931, 2932, 2933, 2934, 2935, 2937, 2938, 2939, 2940, 2941, 2942, 2943, 2944, 2945, 2946, 2947, 2949, 2950, 2951, 2952, 2953, 2955, 2956, 2957, 2959, 2960, 2961, 2962, 2963, 2965, 2966, 2967, 2968, 2969, 2970, 2971, 2972, 2973, 2974, 2975, 2976, 2977, 2978, 2979, 2980, 2981, 2982, 2983, 2984, 2985, 2986, 2987, 2988, 2989, 2990, 2991, 2992, 2993, 2994, 2995, 2996, 2997, 2998, 2999, 3000, 3001, 3002, 3003, 3004, 3005, 3006, 3007, 3008, 3009, 3010, 3011, 3012, 3014, 3015, 3016, 3017, 3018, 3019, 3020, 3022, 3023, 3024, 3025, 3026, 3027, 3028, 3029, 3030, 3031, 3032, 3033, 3034, 3035, 3036, 3037, 3038, 3039, 3040, 3042, 3043, 3044, 3045, 3046, 3047, 3048, 3049, 3050, 3051, 3052, 3053, 3054, 3055, 3057, 3058, 3059, 3060, 3061, 3062, 3063, 3064, 3065, 3066, 3067, 3068, 3070, 3071, 3072, 3073, 3074, 3075, 3076, 3077, 3079, 3080, 3081, 3082, 3083, 3084, 3086, 3087, 3088, 3089, 3090, 3091, 3093, 3094, 3095, 3096, 3097, 3098, 3099, 3100, 3101, 3102, 3103, 3104, 3105, 3106, 3107, 3108, 3109, 3110, 3111, 3112, 3113, 3114, 3115, 3116, 3118, 3119, 3120, 3121, 3122, 3123, 3124, 3125, 3126, 3127, 3128, 3131, 3132, 3133, 3134, 3135, 3136, 3137, 3138, 3139, 3142, 3143, 3144, 3146, 3147, 3149, 3150, 3151, 3152, 3153, 3155, 3156, 3157, 3158, 3159, 3160, 3162, 3163, 3164, 3165, 3166, 3167, 3169, 3170, 3171, 3172, 3173, 3174, 3175, 3176, 3177, 3178, 3179, 3180, 3181, 3182, 3183, 3184, 3185, 3186, 3187, 3188, 3189, 3190, 3191, 3192, 3193, 3194, 3195, 3196, 3197, 3198, 3199, 3200, 3201, 3202, 3203, 3204, 3205, 3206, 3207, 3208, 3209, 3210, 3211, 3212, 3213, 3214, 3215, 3216, 3217, 3218, 3219, 3222, 3223, 3224, 3225, 3226, 3227, 3228, 3229, 3231, 3232, 3233, 3234, 3236, 3240, 3241, 3242, 3243, 3244, 3245, 3247, 3248, 3249, 3250, 3251, 3252, 3253, 3254, 3255, 3256, 3258, 3259, 3260, 3261, 3262, 3263, 3265, 3269, 3270, 3271, 3272, 3273, 3276, 3277, 3279, 3280, 3281, 3282, 3283, 3284, 3285, 3286, 3287, 3288, 3289, 3291, 3292, 3293, 3294, 3295, 3296, 3298, 3299, 3300, 3301, 3302, 3303, 3304, 3305, 3306, 3307, 3310, 3311, 3312, 3313, 3314, 3316, 3317, 3318, 3319, 3320, 3321, 3322, 3323, 3325, 3326, 3327, 3328, 3329, 3330, 3331, 3332, 3333, 3334, 3335, 3337, 3338, 3339, 3340, 3341, 3342, 3343, 3344, 3345, 3346, 3347, 3349, 3350, 3351, 3352, 3353, 3354, 3355, 3356, 3357, 3358, 3359, 3360, 3362, 3363, 3364, 3366, 3367, 3368, 3369, 3370, 3371, 3372, 3373, 3374, 3375, 3376, 3377, 3378, 3379, 3380, 3381, 3382, 3383, 3384, 3386, 3387, 3388, 3389, 3390, 3391, 3392, 3393, 3394, 3396, 3397, 3398, 3399, 3400, 3401, 3402, 3403, 3404, 3405, 3406, 3407, 3408, 3410, 3411, 3412, 3413, 3414, 3415, 3416, 3417, 3418, 3419, 3421, 3422, 3423, 3424, 3426, 3427, 3428, 3429, 3430, 3431, 3432, 3433, 3434, 3435, 3436, 3437, 3438, 3439, 3440, 3441, 3442, 3443, 3444, 3445, 3446, 3447, 3448, 3449, 3450, 3451, 3452, 3453, 3454, 3455, 3456, 3457, 3459, 3460, 3461, 3462, 3465, 3466, 3467, 3468, 3469, 3470, 3471, 3472, 3473, 3474, 3476, 3477, 3480, 3481, 3482, 3483, 3484, 3485, 3486, 3487, 3488, 3489, 3490, 3491, 3492, 3493, 3494, 3495, 3497, 3498, 3499, 3500, 3501, 3502, 3503, 3504, 3505, 3506, 3507, 3509, 3510, 3511, 3512, 3513, 3514, 3515, 3516, 3519, 3520, 3521, 3522, 3523, 3525, 3526, 3527, 3528, 3529, 3530, 3531, 3532, 3533, 3534, 3535, 3536, 3538, 3539, 3540, 3541, 3542, 3543, 3544, 3545, 3546, 3547, 3548, 3549, 3550, 3551, 3552, 3553, 3556, 3557, 3558, 3562, 3563, 3564, 3565, 3566, 3567, 3568, 3569, 3570, 3571, 3572, 3573, 3574, 3575, 3576, 3577, 3578, 3580, 3581, 3582, 3583, 3584, 3585, 3586, 3588, 3589, 3591, 3592, 3593, 3594, 3595, 3596, 3598, 3599, 3600, 3601, 3602, 3603, 3604, 3605, 3606, 3607, 3608, 3609, 3610, 3611, 3612, 3613, 3614, 3615, 3616, 3617, 3618, 3620, 3621, 3622, 3623, 3624, 3625, 3626, 3627, 3628, 3629, 3630, 3631, 3632, 3633, 3634, 3635, 3636, 3637, 3638, 3639, 3640, 3642, 3644, 3645, 3646, 3647, 3648, 3649, 3650, 3651, 3652, 3653, 3655, 3656, 3657, 3658, 3660, 3661, 3662, 3663, 3664, 3665, 3666, 3667, 3668, 3669, 3670, 3671, 3672, 3673, 3674, 3675, 3676, 3677, 3678, 3679, 3680, 3681, 3682, 3683, 3684, 3685, 3686, 3687, 3688, 3689, 3690, 3691, 3692, 3693, 3694, 3696, 3697, 3698, 3699, 3700, 3701, 3702, 3703, 3704, 3705, 3706, 3707, 3708, 3709, 3710, 3711, 3712, 3713, 3716, 3717, 3718, 3719, 3721, 3722, 3724, 3728, 3729, 3730, 3731, 3732, 3733, 3734, 3735, 3736, 3737, 3738, 3739, 3740, 3743, 3744, 3748, 3749, 3750, 3751, 3752, 3753, 3754, 3756, 3757, 3758, 3759, 3760, 3761, 3762, 3763, 3764, 3765, 3766, 3767, 3768, 3769, 3770, 3772, 3773, 3774, 3775, 3776, 3777, 3778, 3779, 3781, 3782, 3783, 3784, 3785, 3786, 3787, 3788, 3789, 3790, 3791, 3792, 3793, 3794, 3795, 3796, 3797, 3798, 3799, 3800, 3801, 3802, 3803, 3804, 3805, 3806, 3807, 3808, 3809, 3810, 3811, 3812, 3813, 3814, 3815, 3817, 3818, 3819, 3820, 3821, 3822, 3823, 3825, 3826, 3827, 3828, 3829, 3830, 3831, 3832, 3833, 3834, 3835, 3836, 3837, 3838, 3839, 3840, 3841, 3843, 3844, 3845, 3846, 3847, 3848, 3849, 3850, 3851, 3852, 3853, 3854, 3855, 3856, 3857, 3858, 3859, 3860, 3861, 3862, 3863, 3864, 3866, 3867, 3868, 3869, 3870, 3871, 3872, 3873, 3874, 3875, 3877, 3878, 3879, 3880, 3884, 3886, 3887, 3888, 3889, 3890, 3891, 3892, 3893, 3894, 3895, 3896, 3897, 3898, 3899, 3900, 3901, 3902, 3903, 3904, 3905, 3906, 3907, 3908, 3910, 3912, 3913, 3915, 3917, 3918, 3919, 3920, 3921, 3922, 3923, 3924, 3925, 3926, 3927, 3928, 3929, 3930, 3932, 3933, 3934, 3935, 3936, 3937, 3938, 3939, 3940, 3941, 3943, 3944, 3945, 3946, 3947, 3948, 3949, 3950, 3951, 3952, 3953, 3954, 3955, 3956, 3957, 3958, 3959, 3960, 3962, 3963, 3964, 3965, 3966, 3967, 3969, 3972, 3973, 3974, 3975, 3976, 3977, 3978, 3979, 3980, 3981, 3982, 3983, 3984, 3985, 3986, 3987, 3988, 3989, 3990, 3991, 3992, 3993, 3994, 3995, 3996, 3997, 3998, 3999, 4000, 4001, 4002, 4003, 4004, 4005, 4006, 4007, 4008, 4009, 4010, 4011, 4012, 4013, 4014, 4016, 4017, 4018, 4019, 4020, 4021, 4022, 4023, 4024, 4025, 4026, 4027, 4028, 4029, 4030, 4031, 4032, 4033, 4034, 4037, 4038, 4039, 4040, 4041, 4042, 4043, 4044, 4045, 4046, 4047, 4049, 4050, 4053, 4054, 4055, 4056, 4057, 4058, 4059, 4060, 4061, 4062, 4063, 4067, 4068, 4069, 4070, 4071, 4072, 4073, 4074, 4075, 4076, 4077, 4078, 4079, 4080, 4081, 4082, 4083, 4084, 4085, 4086, 4087, 4088, 4089, 4090, 4091, 4092, 4093, 4094, 4095, 4096, 4097, 4098, 4099, 4100, 4101, 4102, 4103, 4104, 4105, 4106, 4107, 4108, 4109, 4111, 4112, 4113, 4114, 4115, 4116, 4117, 4118, 4119, 4120, 4121, 4122, 4123, 4124, 4125, 4126, 4127, 4128, 4129, 4130, 4131, 4132, 4133, 4134, 4135, 4136, 4137, 4138, 4139, 4140, 4141, 4142, 4143, 4144, 4145, 4147, 4148, 4149, 4150, 4151, 4152, 4153, 4154, 4155, 4156, 4157, 4158, 4159, 4160, 4161, 4163, 4164, 4165, 4166, 4167, 4168, 4169, 4170, 4171, 4172, 4173, 4174, 4175, 4176, 4177, 4178, 4179, 4181, 4182, 4183, 4184, 4185, 4186, 4187, 4188, 4189, 4190, 4191, 4192, 4193, 4194, 4195, 4196, 4197, 4198, 4200, 4201, 4202, 4203, 4204, 4205, 4206, 4207, 4208, 4209, 4210, 4211, 4212, 4213, 4214, 4215, 4216, 4217, 4218, 4219, 4221, 4222, 4223, 4224, 4225, 4226, 4227, 4228, 4229, 4230, 4231, 4232, 4233, 4234, 4235, 4237, 4238, 4239, 4240, 4241, 4242, 4243, 4244, 4245, 4246, 4247, 4248, 4249, 4250, 4251, 4252, 4253, 4254, 4255, 4256, 4257, 4258, 4259, 4260, 4261, 4262, 4263, 4264, 4265, 4266, 4267, 4269, 4270, 4271, 4272, 4273, 4275, 4276, 4277, 4278, 4279, 4280, 4281, 4283, 4284, 4286, 4287, 4288, 4289, 4290, 4292, 4293, 4294, 4295, 4297, 4298, 4299, 4300, 4301, 4302, 4303, 4304, 4305, 4306, 4307, 4308, 4309, 4310, 4311, 4312, 4313, 4314, 4315, 4316, 4317, 4318, 4319, 4320, 4321, 4322, 4323, 4325, 4326, 4327, 4328, 4329, 4330, 4331, 4332, 4333, 4334, 4335, 4336, 4337, 4339, 4340, 4341, 4342, 4343, 4344, 4345, 4346, 4347, 4348, 4349, 4350, 4351, 4352, 4353, 4354, 4356, 4357, 4358, 4359, 4361, 4362, 4363, 4364, 4365, 4366, 4367, 4368, 4369, 4370, 4371, 4372, 4373, 4374, 4375, 4376, 4377, 4378, 4379, 4380, 4381, 4382, 4383, 4384, 4385, 4386, 4387, 4388, 4389, 4390, 4391, 4392, 4393, 4394, 4395, 4396, 4397, 4398, 4399, 4400, 4401, 4402, 4403, 4404, 4405, 4406, 4407, 4408, 4409, 4410, 4411, 4412, 4413, 4414, 4415, 4416, 4417, 4418, 4419, 4420, 4421, 4422, 4423, 4424, 4425, 4426, 4427, 4428, 4429, 4430, 4432, 4433, 4434, 4435, 4436, 4437, 4438, 4439, 4440, 4441, 4442, 4443, 4444, 4445, 4446, 4447, 4448, 4449, 4450, 4451, 4452, 4453, 4455, 4456, 4457, 4458, 4459, 4460, 4461, 4463, 4465, 4466, 4467, 4468, 4469, 4471, 4472, 4473, 4474, 4477, 4478, 4479, 4480, 4481, 4482, 4483, 4484, 4485, 4486, 4487, 4488, 4489, 4490, 4491, 4492, 4493, 4494, 4495, 4496, 4497, 4498, 4499, 4500, 4501, 4502, 4503, 4504, 4505, 4506, 4507, 4508, 4509, 4510, 4511, 4512, 4513, 4514, 4515, 4516, 4517, 4518, 4519, 4520, 4521, 4522, 4523, 4524, 4525, 4526, 4527, 4528, 4529, 4530, 4531, 4532, 4533, 4534, 4535, 4536, 4537, 4538, 4539, 4540, 4541, 4542, 4543, 4544, 4545, 4546, 4547, 4548, 4549, 4551, 4552, 4553, 4554, 4555, 4556, 4557, 4558, 4559, 4560, 4561, 4562, 4563, 4564, 4565, 4566, 4567, 4568, 4569, 4570, 4571, 4572, 4573, 4574, 4575, 4576, 4577, 4578, 4579, 4580, 4581, 4582, 4583, 4584, 4585, 4586, 4587, 4588, 4589, 4590, 4591, 4593, 4594, 4595, 4596, 4597, 4598, 4599, 4600, 4601, 4602, 4603, 4604, 4605, 4606, 4607, 4608, 4610, 4611, 4612, 4613, 4614, 4615, 4616, 4618, 4619, 4620, 4621, 4622, 4623, 4624, 4625, 4626, 4627, 4628, 4629, 4630, 4632, 4633, 4634, 4635, 4636, 4637, 4639, 4640, 4641, 4642, 4643, 4644, 4645, 4646, 4647, 4648, 4650, 4651, 4652, 4653, 4654, 4655, 4656, 4657, 4658, 4659, 4660, 4661, 4662, 4663, 4664, 4665, 4666, 4667, 4668, 4669, 4670, 4671, 4672, 4673, 4674, 4675, 4676, 4677, 4678, 4679, 4680, 4681, 4682, 4683, 4684, 4685, 4686, 4687, 4688, 4689, 4690, 4691, 4692, 4693, 4694, 4695, 4696, 4697, 4698, 4699, 4700, 4701, 4702, 4703, 4704, 4705, 4706, 4707, 4708, 4709, 4710, 4711, 4712, 4713, 4715, 4716, 4717, 4718, 4719, 4720, 4722, 4723, 4724, 4725, 4726, 4727, 4728, 4729, 4730, 4731, 4732, 4733, 4734, 4735, 4736, 4737, 4738, 4739, 4740, 4741, 4742, 4743, 4744, 4745, 4746, 4747, 4748, 4749, 4750, 4751, 4752, 4753, 4754, 4755, 4756, 4757, 4758, 4759, 4760, 4761, 4762, 4763, 4764, 4765, 4767, 4768, 4770, 4771, 4772, 4773, 4774, 4775, 4776, 4777, 4778, 4779, 4780, 4781, 4783, 4784, 4785, 4788, 4789, 4790, 4791, 4792, 4793, 4794, 4795, 4796, 4797, 4798, 4799, 4800, 4801, 4802, 4803, 4804, 4805, 4806, 4807, 4808, 4809, 4810, 4811, 4813, 4814, 4815, 4816, 4817, 4818, 4819, 4820, 4821, 4822, 4823, 4826, 4827, 4828, 4829, 4831, 4832, 4833, 4834, 4835, 4836, 4837, 4838, 4839, 4840, 4841, 4842, 4843, 4844, 4845, 4846, 4847, 4848, 4849, 4850, 4851, 4852, 4853, 4854, 4855, 4856, 4857, 4858, 4859, 4860, 4861, 4862, 4863, 4864, 4865, 4866, 4867, 4868, 4869, 4871, 4872, 4873, 4874, 4875, 4876, 4877, 4878, 4879, 4880, 4881, 4882, 4883, 4884, 4885, 4887, 4888, 4889, 4890, 4891, 4892, 4893, 4894, 4895, 4897, 4898, 4899, 4900, 4901, 4902, 4903, 4904, 4905, 4906, 4907, 4908, 4909, 4910, 4911, 4912, 4914, 4915, 4916, 4917, 4918, 4919, 4920, 4921, 4922, 4923, 4925, 4926, 4927, 4928, 4929, 4930, 4931, 4932, 4933, 4934, 4935, 4936, 4937, 4938, 4939, 4940, 4942, 4943, 4944, 4945, 4946, 4947, 4948, 4949, 4950, 4951, 4952, 4953, 4954, 4955, 4956, 4957, 4958, 4959, 4960, 4961, 4962, 4963, 4964, 4965, 4967, 4968, 4969, 4970, 4971, 4972, 4973, 4974, 4975, 4977, 4978, 4979, 4980, 4981, 4982, 4983, 4984, 4986, 4987, 4988, 4989, 4990, 4991, 4993, 4994, 4995, 4996, 4997, 4998, 4999, 5000, 5001, 5002, 5003, 5004, 5005, 5006, 5007, 5009, 5010, 5011, 5012, 5013, 5014, 5015, 5016, 5017, 5018, 5019, 5020, 5021, 5022, 5023, 5024, 5025, 5026, 5027, 5028, 5029, 5031, 5032, 5033, 5034, 5035, 5036, 5037, 5038, 5039, 5040, 5041, 5042, 5043, 5044, 5045, 5046, 5047, 5048, 5049, 5050, 5051, 5052, 5055, 5056, 5057, 5058, 5059, 5060, 5061, 5062, 5063, 5064, 5065, 5066, 5067, 5068, 5069, 5070, 5071, 5072, 5073, 5074, 5075, 5076, 5077, 5078, 5079, 5080, 5081, 5082, 5083, 5084, 5085, 5086, 5087, 5090, 5091, 5092, 5093, 5095, 5096, 5097, 5098, 5099, 5100, 5101, 5102, 5103, 5104, 5105, 5106, 5107, 5108, 5109, 5110, 5111, 5112, 5113, 5114, 5115, 5116, 5117, 5118, 5119, 5120, 5121, 5122, 5123, 5124, 5125, 5126, 5127, 5128, 5129, 5130, 5131, 5132, 5133, 5134, 5135, 5136, 5137, 5138, 5139, 5140, 5141, 5142, 5143, 5144, 5145, 5148, 5149, 5150, 5151, 5152, 5155, 5156, 5157, 5158, 5159, 5160, 5161, 5162, 5163, 5164, 5165, 5166, 5167, 5168, 5169, 5170, 5171, 5172, 5174, 5175, 5176, 5178, 5179, 5181, 5182, 5183, 5185, 5186, 5187, 5188, 5190, 5191, 5192, 5193, 5194, 5195, 5196, 5197, 5198, 5199, 5200, 5201, 5202, 5203, 5204, 5205, 5206, 5207, 5208, 5209, 5210, 5211, 5212, 5213, 5214, 5215, 5216, 5217, 5218, 5219, 5220, 5221, 5224, 5225, 5226, 5229, 5230, 5231, 5232, 5233, 5236, 5237, 5238, 5239, 5240, 5241, 5242, 5243, 5245, 5246, 5247, 5248, 5249, 5250, 5251, 5252, 5253, 5256, 5257, 5258, 5259, 5260, 5261, 5262, 5263, 5264, 5265, 5266, 5267, 5268, 5269, 5270, 5271, 5272, 5273, 5274, 5275, 5276, 5277, 5278, 5279, 5280, 5281, 5282, 5283, 5284, 5285, 5286, 5287, 5288, 5289, 5290, 5291, 5292, 5294, 5295, 5296, 5297, 5298, 5299, 5300, 5301, 5302, 5303, 5304, 5305, 5306, 5307, 5308, 5309, 5310, 5311, 5312, 5313, 5314, 5315, 5316, 5317, 5319, 5320, 5321, 5323, 5324, 5325, 5326, 5327, 5328, 5329, 5330, 5331, 5333, 5334, 5335, 5336, 5337, 5338, 5339, 5340, 5341, 5342, 5343, 5344, 5345, 5346, 5347, 5348, 5350, 5351, 5352, 5353, 5354, 5355, 5356, 5357, 5358, 5359, 5361, 5362, 5363, 5364, 5365, 5366, 5367, 5368, 5369, 5370, 5371, 5372, 5373, 5375, 5376, 5377, 5378, 5379, 5380, 5381, 5383, 5384, 5385, 5386, 5387, 5388, 5389, 5390, 5391, 5392, 5393, 5394, 5396, 5397, 5398, 5399, 5400, 5401, 5402, 5403, 5404, 5405, 5406, 5407, 5408, 5409, 5410, 5411, 5412, 5413, 5414, 5416, 5417, 5418, 5419, 5420, 5422, 5423, 5424, 5425, 5426, 5427, 5428, 5429, 5430, 5431, 5432, 5433, 5434, 5435, 5437, 5438, 5439, 5440, 5441, 5442, 5443, 5444, 5445, 5446, 5447, 5448, 5449, 5450, 5451, 5452, 5453, 5454, 5455, 5456, 5457, 5458, 5459, 5460, 5461, 5462, 5463, 5464, 5465, 5466, 5467, 5468, 5469, 5470, 5471, 5472, 5473, 5474, 5475, 5476, 5477, 5478, 5479, 5480, 5481, 5482, 5483, 5484, 5485, 5486, 5487, 5488, 5489, 5490, 5491, 5492, 5493, 5494, 5495, 5496, 5497, 5498, 5499, 5500, 5501, 5502, 5503, 5504, 5505, 5506, 5507, 5508, 5509, 5510, 5511, 5512, 5513, 5514, 5515, 5516, 5517, 5518, 5519, 5520, 5521, 5522, 5523, 5524, 5525, 5526, 5527, 5529, 5530, 5531, 5532, 5533, 5534, 5535, 5536, 5537, 5538, 5539, 5540, 5541, 5542, 5543, 5544, 5545, 5547, 5548, 5549, 5550, 5551, 5552, 5554, 5555, 5556, 5557, 5558, 5559, 5560, 5561, 5562, 5563, 5564, 5565, 5566, 5567, 5568, 5569, 5570, 5571, 5572, 5573, 5574, 5575, 5576, 5577, 5578, 5579, 5580, 5581, 5582, 5583, 5584, 5585, 5586, 5587, 5588, 5589, 5590, 5591, 5592, 5593, 5594, 5595, 5596, 5597, 5598, 5600, 5601, 5602, 5603, 5604, 5605, 5606, 5607, 5608, 5609, 5610, 5612, 5613, 5614, 5615, 5616, 5617, 5618, 5620, 5622, 5623, 5624, 5625, 5626, 5627, 5628, 5629, 5630, 5631, 5633, 5634, 5635, 5636, 5637, 5639, 5640, 5642, 5643, 5645, 5646, 5647, 5648, 5649, 5650, 5651, 5652, 5653, 5654, 5655, 5656, 5657, 5658, 5659, 5660, 5661, 5662, 5663, 5664, 5665, 5666, 5667, 5668, 5669, 5670, 5671, 5672, 5673, 5674, 5676, 5677, 5678, 5679, 5680, 5681, 5682, 5683, 5684, 5685, 5686, 5688, 5689, 5690, 5691, 5692, 5693, 5694, 5695, 5696, 5697, 5698, 5699, 5700, 5701, 5702, 5703, 5704, 5705, 5706, 5707, 5708, 5709, 5711, 5712, 5713, 5714, 5716, 5717, 5718, 5720, 5721, 5722, 5723, 5724, 5726, 5728, 5729, 5730, 5731, 5732, 5733, 5734, 5735, 5736, 5737, 5739, 5740, 5741, 5742, 5743, 5744, 5745, 5746, 5747, 5748, 5749, 5751, 5752, 5753, 5754, 5755, 5756, 5757, 5758, 5759, 5760, 5761, 5762, 5763, 5764, 5765, 5766, 5767, 5768, 5769, 5771, 5772, 5773, 5774, 5775, 5776, 5777, 5778, 5779, 5780, 5781, 5782, 5783, 5784, 5785, 5786, 5787, 5788, 5789, 5791, 5792, 5793, 5794, 5795, 5796, 5797, 5798, 5799, 5800, 5801, 5802, 5803, 5804, 5805, 5806, 5808, 5809, 5810, 5811, 5813, 5814, 5815, 5816, 5817, 5819, 5820, 5821, 5822, 5823, 5825, 5826, 5827, 5828, 5829, 5830, 5831, 5832, 5833, 5834, 5835, 5836, 5837, 5838, 5839, 5840, 5841, 5842, 5843, 5844, 5846, 5847, 5848, 5849, 5850, 5851, 5852, 5853, 5854, 5855, 5856, 5857, 5858, 5859, 5860, 5861, 5862, 5863, 5864, 5865, 5866, 5868, 5869, 5870, 5871, 5872, 5874, 5875, 5876, 5877, 5878, 5880, 5881, 5882, 5883, 5884, 5886, 5887, 5888, 5889, 5890, 5891, 5892, 5893, 5894, 5895, 5896, 5897, 5898, 5899, 5900, 5901, 5902, 5903, 5904, 5905, 5907, 5908, 5909, 5910, 5912, 5913, 5914, 5915, 5916, 5917, 5918, 5919, 5920, 5921, 5922, 5924, 5925, 5926, 5927, 5928, 5929, 5932, 5933, 5934, 5935, 5936, 5937, 5938, 5939, 5940, 5942, 5943, 5944, 5945, 5946, 5947, 5948, 5949, 5950, 5952, 5953, 5954, 5955, 5956, 5957, 5960, 5962, 5963, 5965, 5966, 5967, 5968, 5969, 5970, 5971, 5972, 5973, 5974, 5975, 5976, 5977, 5978, 5979, 5980, 5981, 5983, 5984, 5985, 5986, 5987, 5988, 5989, 5991, 5992, 5993, 5994, 5995, 5996, 5997, 5998, 5999, 6000, 6001, 6002, 6003, 6004, 6005, 6006, 6007, 6008, 6009, 6010, 6011, 6012, 6013, 6015, 6016, 6017, 6018, 6019, 6021, 6022, 6023, 6024, 6025, 6027, 6028, 6029, 6030, 6031, 6032, 6034, 6036, 6037, 6040, 6041, 6042, 6043, 6044, 6045, 6046, 6047, 6048, 6049, 6051, 6052, 6053, 6055, 6056, 6057, 6058, 6059, 6060, 6061, 6063, 6064, 6065, 6066, 6067, 6068, 6069, 6070, 6071, 6072, 6073, 6074, 6075, 6076, 6077, 6078, 6079, 6080, 6081, 6083, 6084, 6085, 6086, 6087, 6088, 6089, 6090, 6091, 6092, 6093, 6094, 6095, 6096, 6097, 6099, 6100, 6101, 6102, 6103, 6104, 6105, 6106, 6107, 6108, 6109, 6111, 6112, 6113, 6114, 6115, 6116, 6117, 6119, 6120, 6121, 6122, 6123, 6124, 6126, 6127, 6128, 6129, 6130, 6131, 6132, 6133, 6134, 6135, 6136, 6137, 6139, 6140, 6141, 6142, 6143, 6144, 6145, 6146, 6147, 6148, 6149, 6150, 6151, 6152, 6153, 6154, 6155, 6156, 6157, 6158, 6159, 6160, 6161, 6162, 6163, 6164, 6165, 6166, 6167, 6168, 6169, 6170, 6171, 6172, 6173, 6174, 6175, 6176, 6178, 6179, 6180, 6181, 6182, 6183, 6184, 6185, 6186, 6187, 6189, 6190, 6191, 6192, 6193, 6194, 6195, 6196, 6197, 6198, 6200, 6201, 6202, 6203, 6204, 6205, 6206, 6207, 6208, 6209, 6210, 6211, 6212, 6213, 6214, 6215, 6216, 6217, 6218, 6220, 6221, 6222, 6223, 6224, 6225, 6226, 6227, 6228, 6229, 6230, 6231, 6232, 6233, 6234, 6235, 6236, 6237, 6238, 6239, 6240, 6241, 6242, 6243, 6244, 6245, 6246, 6247, 6248, 6249, 6250, 6251, 6252, 6253, 6254, 6255, 6256, 6257, 6258, 6259, 6260, 6261, 6262, 6263, 6264, 6265, 6266, 6267, 6269, 6270, 6271, 6272, 6273, 6274, 6275, 6276, 6277, 6278, 6279, 6280, 6281, 6282, 6283, 6284, 6285, 6286, 6287, 6288, 6289, 6290, 6291, 6292, 6293, 6294, 6295, 6296, 6297, 6298, 6300, 6301, 6302, 6303, 6304, 6305, 6306, 6307, 6308, 6309, 6310, 6311, 6313, 6314, 6315, 6316, 6317, 6318, 6319, 6320, 6321, 6322, 6323, 6324, 6325, 6326, 6327, 6328, 6329, 6330, 6331, 6332, 6333, 6334, 6335, 6336, 6338, 6339, 6340, 6341, 6342, 6343, 6344, 6345, 6346, 6347, 6348, 6349, 6350, 6351, 6352, 6353, 6354, 6355, 6356, 6357, 6358, 6359, 6360, 6361, 6362, 6363, 6364, 6369, 6370, 6371, 6372, 6373, 6374, 6375, 6376, 6377, 6378, 6379, 6380, 6381, 6382, 6383, 6384, 6385, 6386, 6387, 6388, 6389, 6390, 6391, 6392, 6393, 6394, 6395, 6396, 6399, 6401, 6402, 6404, 6405, 6407, 6408, 6410, 6411, 6412, 6413, 6414, 6415, 6416, 6417, 6418, 6419, 6420, 6421, 6422, 6423, 6424, 6425, 6426, 6427, 6428, 6429, 6430, 6431, 6433, 6434, 6435, 6436, 6437, 6438, 6439, 6440, 6441, 6442, 6443, 6444, 6445, 6446, 6447, 6448, 6449, 6450, 6452, 6453, 6454, 6455, 6457, 6458, 6460, 6461, 6462, 6463, 6464, 6467, 6468, 6469, 6470, 6471, 6472, 6473, 6474, 6475, 6476, 6477, 6478, 6479, 6481, 6482, 6483, 6484, 6485, 6486, 6487, 6488, 6489, 6491, 6492, 6493, 6494, 6495, 6496, 6497, 6498, 6499, 6500, 6501, 6502, 6503, 6504, 6505, 6506, 6507, 6508, 6509, 6510, 6511, 6512, 6513, 6514, 6515, 6516, 6517, 6518, 6519, 6520, 6521, 6522, 6523, 6524, 6525, 6526, 6527, 6528, 6529, 6530, 6531, 6532, 6533, 6534, 6535, 6536, 6537, 6538, 6539, 6540, 6541, 6542, 6543, 6544, 6545, 6547, 6548, 6552, 6553, 6554, 6555, 6556, 6557, 6558, 6559, 6560, 6561, 6562, 6563, 6564, 6565, 6566, 6568, 6569, 6570, 6571, 6572, 6573, 6575, 6576, 6577, 6578, 6579, 6580, 6581, 6582, 6583, 6584, 6585, 6586, 6587, 6589, 6590, 6591, 6592, 6593, 6594, 6595, 6596, 6597, 6598, 6600, 6601, 6602, 6603, 6604, 6605, 6606, 6607, 6608, 6609, 6610, 6611, 6612, 6613, 6614, 6615, 6616, 6617, 6618, 6619, 6620, 6621, 6622, 6623, 6624, 6625, 6626, 6627, 6628, 6629, 6630, 6631, 6632, 6633, 6634, 6635, 6636, 6637, 6639, 6640, 6641, 6642, 6643, 6644, 6645, 6646, 6647, 6648, 6649, 6650, 6651, 6652, 6653, 6654, 6655, 6656, 6657, 6658, 6659, 6660, 6661, 6662, 6663, 6664, 6665, 6666, 6667, 6668, 6669, 6670, 6671, 6672, 6673, 6675, 6676, 6677, 6678, 6679, 6680, 6681, 6682, 6683, 6684, 6685, 6686, 6687, 6688, 6689, 6690, 6691, 6692, 6693, 6694, 6695, 6696, 6697, 6698, 6699, 6700, 6701, 6702, 6703, 6704, 6705, 6706, 6707, 6708, 6709, 6710, 6711, 6712, 6713, 6714, 6715, 6716, 6717, 6718, 6719, 6720, 6721, 6722, 6723, 6724, 6725, 6726, 6727, 6728, 6729, 6730, 6731, 6732, 6733, 6734, 6735, 6736, 6737, 6738, 6739, 6740, 6741, 6742, 6743, 6744, 6745, 6747, 6748, 6750, 6751, 6752, 6753, 6754, 6755, 6756, 6757, 6759, 6760, 6762, 6764, 6765, 6766, 6767, 6768, 6769, 6770, 6771, 6773, 6774, 6775, 6776, 6777, 6778, 6779, 6780, 6781, 6782, 6783, 6784, 6785, 6786, 6787, 6788, 6789, 6790, 6791, 6792, 6793}",6260,"{989, 1081, 1113, 1121, 1132, 1133, 1140, 1141, 1145, 1147, 1149, 1160, 1166, 1168, 1170, 1174, 1175, 1178, 1180, 1184, 1187, 1188, 1189, 1191, 1192, 1197, 1198, 1199, 1200, 1201, 1202, 1206, 1208, 1209, 1214, 1215, 1216, 1222, 1225, 1227, 1230, 1232, 1236, 1239, 1240, 1241, 1245, 1246, 1249, 1253, 1254, 1258, 1259, 1260, 1263, 1264, 1265, 1268, 1283, 1286, 1290, 1293, 1294, 1295, 1299, 1300, 1304, 1306, 1307, 1308, 1309, 1310, 1313, 1314, 1315, 1316, 1320, 1321, 1327, 1329, 1334, 1335, 1338, 1339, 1340, 1343, 1345, 1346, 1350, 1352, 1353, 1355, 1356, 1357, 1364, 1367, 1368, 1372, 1375, 1379, 1381, 1383, 1385, 1386, 1396, 1400, 1401, 1403, 1407, 1408, 1409, 1410, 1411, 1416, 1419, 1420, 1421, 1423, 1428, 1429, 1433, 1435, 1439, 1440, 1443, 1446, 1447, 1450, 1451, 1452, 1453, 1454, 1455, 1456, 1457, 1459, 1460, 1461, 1462, 1464, 1465, 1466, 1470, 1471, 1472, 1475, 1476, 1477, 1478, 1481, 1482, 1484, 1485, 1488, 1489, 1492, 1493, 1494, 1495, 1496, 1500, 1501, 1503, 1505, 1507, 1508, 1510, 1513, 1514, 1515, 1516, 1519, 1522, 1523, 1524, 1525, 1528, 1531, 1532, 1533, 1536, 1538, 1540, 1541, 1544, 1545, 1554, 1557, 1558, 1560, 1564, 1565, 1569, 1570, 1572, 1577, 1579, 1587, 1596, 1598, 1599, 1600, 1602, 1603, 1604, 1605, 1607, 1609, 1612, 1616, 1617, 1618, 1620, 1621, 1622, 1623, 1629, 1631, 1632, 1634, 1636, 1637, 1639, 1640, 1642, 1644, 1645, 1646, 1647, 1648, 1649, 1659, 1666, 1669, 1670, 1675, 1676, 1688, 1689, 1690, 1692, 1694, 1697, 1698, 1705, 1707, 1711, 1712, 1714, 1716, 1720, 1723, 1724, 1725, 1732, 1735, 1737, 1738, 1739, 1740, 1742, 1743, 1747, 1748, 1753, 1756, 1759, 1761, 1762, 1767, 1768, 1773, 1774, 1775, 1776, 1779, 1780, 1782, 1783, 1785, 1787, 1788, 1789, 1790, 1795, 1799, 1800, 1801, 1802, 1803, 1804, 1805, 1806, 1807, 1808, 1809, 1810, 1811, 1812, 1814, 1815, 1816, 1817, 1818, 1819, 1820, 1821, 1823, 1824, 1826, 1828, 1830, 1831, 1832, 1833, 1834, 1837, 1838, 1839, 1841, 1842, 1843, 1846, 1848, 1849, 1850, 1852, 1857, 1863, 1865, 1866, 1867, 1871, 1872, 1874, 1875, 1876, 1878, 1879, 1880, 1881, 1883, 1890, 1891, 1894, 1895, 1897, 1898, 1899, 1900, 1903, 1911, 1916, 1918, 1922, 1923, 1924, 1925, 1926, 1930, 1931, 1932, 1934, 1937, 1939, 1941, 1945, 1946, 1951, 1952, 1958, 1962, 1963, 1966, 1967, 1970, 1975, 1981, 1982, 1984, 1990, 1991, 1994, 1997, 1998, 1999, 2001, 2003, 2005, 2006, 2009, 2016, 2018, 2019, 2023, 2024, 2027, 2028, 2034, 2040, 2043, 2045, 2046, 2047, 2051, 2056, 2057, 2058, 2060, 2061, 2062, 2066, 2067, 2070, 2071, 2073, 2075, 2077, 2079, 2082, 2083, 2087, 2094, 2097, 2098, 2100, 2107, 2108, 2111, 2114, 2117, 2123, 2125, 2130, 2131, 2132, 2139, 2142, 2149, 2152, 2154, 2155, 2158, 2159, 2160, 2164, 2166, 2168, 2169, 2170, 2171, 2172, 2173, 2174, 2176, 2177, 2179, 2181, 2184, 2185, 2187, 2188, 2189, 2190, 2191, 2192, 2194, 2197, 2204, 2206, 2207, 2208, 2209, 2210, 2211, 2213, 2214, 2217, 2222, 2223, 2226, 2228, 2232, 2235, 2237, 2243, 2249, 2250, 2251, 2255, 2259, 2261, 2265, 2269, 2270, 2271, 2273, 2277, 2280, 2288, 2290, 2293, 2294, 2295, 2296, 2297, 2298, 2299, 2300, 2301, 2302, 2304, 2305, 2306, 2309, 2311, 2312, 2313, 2315, 2317, 2320, 2321, 2322, 2327, 2328, 2329, 2330, 2331, 2332, 2333, 2334, 2336, 2337, 2338, 2339, 2340, 2341, 2342, 2344, 2347, 2349, 2350, 2351, 2353, 2354, 2356, 2357, 2358, 2359, 2360, 2362, 2367, 2368, 2369, 2370, 2371, 2373, 2375, 2376, 2378, 2380, 2383, 2384, 2385, 2387, 2389, 2390, 2391, 2392, 2393, 2396, 2399, 2401, 2402, 2404, 2405, 2407, 2409, 2410, 2411, 2412, 2414, 2419, 2424, 2428, 2430, 2437, 2438, 2439, 2440, 2441, 2443, 2444, 2445, 2460, 2463, 2467, 2469, 2479, 2480, 2483, 2484, 2485, 2486, 2487, 2488, 2489, 2490, 2491, 2492, 2494, 2501, 2504, 2505, 2506, 2510, 2513, 2514, 2515, 2516, 2517, 2520, 2522, 2524, 2525, 2526, 2527, 2529, 2531, 2533, 2537, 2538, 2544, 2546, 2552, 2553, 2557, 2559, 2562, 2563, 2569, 2570, 2581, 2583, 2591, 2593, 2594, 2595, 2596, 2597, 2598, 2599, 2600, 2601, 2606, 2607, 2610, 2613, 2615, 2621, 2623, 2625, 2629, 2633, 2635, 2636, 2639, 2642, 2668, 2699, 2715, 2724, 2731, 2733, 2735, 2736, 2737, 2745, 2746, 2747, 2751, 2756, 2764, 2770, 2771, 2777, 2785, 2786, 2787, 2789, 2791, 2792, 2793, 2794, 2795, 2798, 2805, 2806, 2807, 2808, 2809, 2812, 2817, 2820, 2822, 2826, 2828, 2830, 2831, 2832, 2834, 2835, 2836, 2837, 2838, 2841, 2845, 2847, 2851, 2852, 2855, 2856, 2857, 2861, 2863, 2866, 2869, 2870, 2871, 2875, 2883, 2886, 2891, 2892, 2894, 2896, 2900, 2904, 2905, 2906, 2910, 2911, 2912, 2914, 2916, 2917, 2918, 2923, 2927, 2930, 2932, 2933, 2934, 2938, 2939, 2940, 2941, 2943, 2944, 2945, 2946, 2949, 2950, 2956, 2957, 2963, 2971, 2974, 2975, 2977, 3101, 3133, 3139, 3222, 3227, 3232, 3233, 3234, 3240, 3251, 3259, 3263, 3277, 3284, 3286, 3292, 3298, 3299, 3301, 3310, 3317, 3322, 3329, 3338, 3339, 3340, 3344, 3350, 3351, 3352, 3356, 3359, 3360, 3364, 3366, 3370, 3371, 3372, 3375, 3376, 3381, 3382, 3383, 3396, 3399, 3402, 3403, 3406, 3407, 3411, 3427, 3433, 3434, 3436, 3444, 3446, 3448, 3454, 3455, 3456, 3457, 3462, 3466, 3468, 3481, 3488, 3491, 3494, 3499, 3502, 3503, 3504, 3507, 3513, 3520, 3525, 3526, 3531, 3533, 3535, 3536, 3538, 3541, 3544, 3551, 3563, 3564, 3572, 3574, 3577, 3607, 3630, 3651, 3658, 3668, 3677, 3678, 3682, 3689, 3693, 3700, 3704, 3705, 3706, 3709, 3710, 3711, 3717, 3728, 3729, 3732, 3736, 3738, 3744, 3749, 3750, 3761, 3763, 3764, 3765, 3766, 3767, 3772, 3776, 3777, 3778, 3779, 3785, 3787, 3789, 3792, 3794, 3795, 3799, 3801, 3802, 3803, 3806, 3807, 3808, 3809, 3811, 3812, 3813, 3814, 3818, 3819, 3820, 3822, 3825, 3827, 3828, 3829, 3830, 3832, 3834, 3835, 3836, 3839, 3841, 3843, 3844, 3846, 3847, 3848, 3849, 3850, 3851, 3852, 3854, 3855, 3856, 3857, 3858, 3859, 3860, 3861, 3862, 3863, 3864, 3866, 3867, 3868, 3869, 3870, 3872, 3874, 3875, 3878, 3879, 3886, 3887, 3888, 3889, 3890, 3891, 3892, 3893, 3896, 3897, 3900, 3901, 3903, 3904, 3905, 3906, 3907, 3908, 3910, 3912, 3913, 3915, 3917, 3919, 3920, 3922, 3925, 3926, 3928, 3930, 3933, 3935, 3937, 3940, 3941, 3946, 3947, 3949, 3950, 3952, 3953, 3954, 3956, 3959, 3963, 3964, 3966, 3969, 3973, 3974, 3975, 3976, 3977, 3979, 3980, 3981, 3982, 3983, 3984, 3986, 3987, 3988, 3990, 3991, 3993, 3994, 3998, 4000, 4002, 4003, 4004, 4005, 4012, 4020, 4021, 4022, 4023, 4024, 4028, 4031, 4032, 4037, 4038, 4041, 4043, 4045, 4047, 4049, 4056, 4057, 4061, 4068, 4069, 4072, 4073, 4074, 4077, 4081, 4090, 4091, 4097, 4108, 4130, 4131, 4332, 4379, 4392, 4393, 4398, 4407, 4419, 4422, 4442, 4445, 4450, 4451, 4461, 4469, 4482, 4483, 4484, 4485, 4486, 4487, 4488, 4489, 4490, 4491, 4494, 4496, 4497, 4499, 4505, 4517, 4529, 4537, 4544, 4546, 4547, 4555, 4557, 4560, 4561, 4562, 4563, 4575, 4577, 4578, 4579, 4582, 4585, 4587, 4588, 4594, 4598, 4600, 4601, 4606, 4610, 4611, 4614, 4618, 4619, 4620, 4621, 4624, 4627, 4632, 4633, 4634, 4637, 4642, 4643, 4644, 4647, 4653, 4654, 4663, 4664, 4667, 4671, 4673, 4677, 4682, 4683, 4685, 4687, 4690, 4691, 4692, 4695, 4696, 4700, 4701, 4702, 4703, 4705, 4706, 4708, 4709, 4710, 4711, 4712, 4713, 4715, 4716, 4717, 4719, 4720, 4722, 4724, 4725, 4727, 4729, 4730, 4731, 4732, 4733, 4734, 4736, 4737, 4738, 4739, 4740, 4741, 4742, 4743, 4744, 4745, 4746, 4749, 4751, 4753, 4754, 4755, 4757, 4763, 4764, 4767, 4770, 4772, 4773, 4774, 4776, 4778, 4779, 4780, 4784, 4788, 4789, 4790, 4791, 4793, 4794, 4796, 4802, 4803, 4807, 4808, 4809, 4810, 4811, 4817, 4818, 4819, 4820, 4821, 4823, 4826, 4829, 4833, 4835, 4836, 4838, 4840, 4841, 4843, 4844, 4847, 4848, 4851, 4854, 4855, 4856, 4857, 4861, 4862, 4864, 4865, 4868, 4869, 4871, 4872, 4873, 4884, 4887, 4893, 4897, 4906, 4914, 4920, 4921, 4923, 4925, 4929, 4930, 4931, 4932, 4933, 4934, 4937, 4938, 4939, 4952, 4953, 4956, 4961, 4962, 4968, 4972, 4973, 4974, 4975, 4977, 4978, 4979, 4986, 4987, 4988, 4989, 4990, 4994, 4997, 4999, 5001, 5002, 5003, 5006, 5011, 5012, 5013, 5014, 5016, 5017, 5018, 5019, 5020, 5024, 5025, 5027, 5028, 5031, 5034, 5035, 5038, 5039, 5040, 5043, 5044, 5045, 5046, 5048, 5049, 5057, 5059, 5062, 5066, 5067, 5068, 5070, 5071, 5072, 5073, 5074, 5075, 5076, 5078, 5080, 5081, 5082, 5085, 5086, 5087, 5090, 5091, 5092, 5093, 5096, 5097, 5098, 5099, 5102, 5103, 5104, 5107, 5108, 5109, 5110, 5111, 5114, 5117, 5120, 5121, 5122, 5130, 5131, 5132, 5136, 5137, 5138, 5139, 5140, 5142, 5143, 5145, 5148, 5149, 5150, 5152, 5156, 5160, 5162, 5163, 5165, 5166, 5171, 5176, 5178, 5181, 5182, 5183, 5185, 5186, 5187, 5191, 5194, 5198, 5200, 5201, 5202, 5203, 5206, 5207, 5214, 5215, 5219, 5224, 5225, 5229, 5230, 5238, 5239, 5241, 5243, 5245, 5246, 5247, 5248, 5250, 5251, 5252, 5256, 5265, 5267, 5268, 5269, 5270, 5275, 5285, 5289, 5290, 5291, 5294, 5295, 5296, 5298, 5301, 5302, 5305, 5313, 5316, 5320, 5321, 5323, 5328, 5329, 5333, 5336, 5337, 5339, 5340, 5343, 5352, 5353, 5354, 5355, 5356, 5358, 5359, 5361, 5362, 5366, 5371, 5372, 5376, 5377, 5384, 5385, 5386, 5387, 5388, 5389, 5390, 5391, 5396, 5398, 5402, 5404, 5405, 5406, 5407, 5408, 5409, 5411, 5414, 5417, 5424, 5428, 5429, 5430, 5431, 5432, 5439, 5442, 5443, 5446, 5449, 5452, 5454, 5462, 5463, 5465, 5466, 5467, 5468, 5472, 5473, 5474, 5475, 5477, 5482, 5484, 5485, 5486, 5487, 5488, 5489, 5494, 5495, 5496, 5498, 5502, 5508, 5509, 5510, 5511, 5512, 5513, 5516, 5518, 5520, 5525, 5526, 5527, 5529, 5540, 5544, 5545, 5550, 5551, 5554, 5555, 5556, 5558, 5559, 5560, 5568, 5569, 5570, 5572, 5575, 5576, 5578, 5579, 5580, 5581, 5586, 5587, 5589, 5591, 5592, 5593, 5594, 5598, 5602, 5603, 5604, 5608, 5609, 5610, 5613, 5614, 5616, 5618, 5620, 5622, 5623, 5624, 5630, 5631, 5637, 5643, 5646, 5647, 5652, 5653, 5654, 5655, 5657, 5658, 5659, 5662, 5663, 5664, 5665, 5666, 5667, 5668, 5669, 5670, 5671, 5673, 5676, 5677, 5678, 5680, 5681, 5682, 5683, 5684, 5685, 5686, 5690, 5691, 5692, 5693, 5698, 5699, 5701, 5702, 5704, 5705, 5706, 5707, 5708, 5711, 5712, 5716, 5721, 5736, 5742, 5747, 5748, 5751, 5752, 5755, 5756, 5758, 5759, 5761, 5763, 5766, 5772, 5774, 5775, 5776, 5788, 5789, 5798, 5803, 5805, 5808, 5811, 5813, 5814, 5815, 5816, 5819, 5820, 5825, 5828, 5829, 5830, 5833, 5837, 5838, 5842, 5844, 5846, 5847, 5849, 5850, 5851, 5852, 5855, 5857, 5872, 5894, 5896, 5908, 5913, 5916, 5917, 5926, 5929, 5932, 5933, 5936, 5937, 5938, 5939, 5944, 5950, 5955, 5957, 5965, 5966, 5967, 5968, 5969, 5972, 5973, 5974, 5975, 5976, 5977, 5978, 5979, 5983, 5984, 5985, 5987, 5989, 5992, 5993, 5994, 5995, 6001, 6002, 6003, 6005, 6006, 6008, 6010, 6011, 6013, 6015, 6016, 6018, 6023, 6024, 6028, 6029, 6037, 6041, 6044, 6045, 6046, 6051, 6052, 6053, 6055, 6058, 6059, 6060, 6064, 6065, 6066, 6067, 6068, 6069, 6072, 6073, 6074, 6075, 6076, 6077, 6079, 6080, 6081, 6083, 6085, 6088, 6089, 6090, 6091, 6093, 6094, 6096, 6097, 6099, 6100, 6101, 6102, 6103, 6107, 6108, 6109, 6114, 6119, 6120, 6122, 6126, 6127, 6128, 6129, 6130, 6133, 6135, 6136, 6137, 6140, 6142, 6143, 6144, 6148, 6150, 6151, 6152, 6156, 6157, 6158, 6161, 6162, 6163, 6164, 6165, 6171, 6172, 6175, 6176, 6179, 6180, 6186, 6189, 6190, 6191, 6194, 6196, 6198, 6200, 6202, 6203, 6204, 6205, 6206, 6207, 6208, 6209, 6210, 6211, 6212, 6213, 6214, 6215, 6216, 6217, 6218, 6220, 6222, 6224, 6225, 6226, 6227, 6230, 6232, 6233, 6235, 6237, 6238, 6240, 6241, 6242, 6243, 6244, 6245, 6248, 6249, 6250, 6251, 6255, 6256, 6257, 6259, 6260, 6262, 6266, 6273, 6278, 6280, 6281, 6283, 6284, 6288, 6289, 6293, 6294, 6295, 6297, 6301, 6305, 6306, 6307, 6308, 6309, 6310, 6316, 6317, 6318, 6320, 6322, 6323, 6325, 6327, 6328, 6333, 6335, 6336, 6340, 6342, 6344, 6348, 6352, 6355, 6357, 6359, 6361, 6363, 6364, 6370, 6371, 6373, 6374, 6375, 6377, 6378, 6379, 6380, 6381, 6382, 6383, 6384, 6385, 6386, 6387, 6390, 6391, 6392, 6394, 6395, 6399, 6405, 6408, 6410, 6411, 6412, 6414, 6416, 6417, 6418, 6423, 6424, 6425, 6428, 6430, 6431, 6433, 6434, 6435, 6437, 6439, 6441, 6442, 6443, 6444, 6445, 6447, 6448, 6449, 6457, 6458, 6461, 6462, 6463, 6467, 6469, 6470, 6471, 6472, 6473, 6475, 6476, 6477, 6478, 6481, 6482, 6484, 6486, 6488, 6489, 6491, 6493, 6498, 6499, 6500, 6501, 6502, 6503, 6504, 6505, 6506, 6507, 6508, 6510, 6511, 6514, 6517, 6518, 6519, 6520, 6521, 6522, 6523, 6524, 6525, 6526, 6527, 6530, 6545, 6547, 6548, 6552, 6553, 6554, 6555, 6556, 6557, 6560, 6562, 6563, 6564, 6565, 6566, 6568, 6569, 6570, 6571, 6573, 6575, 6576, 6577, 6578, 6580, 6581, 6582, 6583, 6584, 6585, 6587, 6589, 6590, 6593, 6594, 6595, 6596, 6597, 6598, 6600, 6601, 6602, 6604, 6605, 6606, 6607, 6608, 6609, 6610, 6612, 6613, 6614, 6618, 6619, 6620, 6621, 6622, 6625, 6626, 6627, 6628, 6629, 6630, 6631, 6632, 6635, 6636, 6637, 6640, 6643, 6644, 6648, 6649, 6650, 6651, 6652, 6653, 6656, 6657, 6658, 6659, 6660, 6661, 6662, 6664, 6666, 6669, 6670, 6671, 6672, 6677, 6681, 6683, 6685, 6686, 6687, 6688, 6689, 6690, 6694, 6695, 6696, 6697, 6701, 6702, 6708, 6710, 6711, 6715, 6716, 6748, 6753, 6783}",2121,"{0, 1, 2, 3, 4, 5, 6, 7, 8, 9, 10, 11, 12, 14, 15, 16, 17, 18, 20, 21, 22, 23, 24, 25, 27, 28, 29, 30, 31, 32, 33, 34, 35, 36, 37, 38, 39, 42, 43, 44, 45, 46, 47, 48, 49, 50, 51, 52, 53, 54, 55, 56, 57, 58, 59, 60, 61, 62, 64, 65, 66, 67, 68, 69, 70, 71, 72, 73, 74, 75, 78, 79, 80, 81, 83, 84, 85, 86, 88, 89, 90, 91, 92, 93, 94, 95, 96, 97, 98, 99, 100, 101, 102, 103, 104, 105, 106, 107, 108, 109, 110, 111, 112, 113, 114, 116, 118, 123, 124, 125, 126, 127, 128, 129, 130, 131, 132, 133, 134, 135, 136, 137, 138, 139, 140, 141, 143, 144, 145, 146, 147, 148, 149, 150, 151, 153, 154, 155, 156, 158, 159, 160, 161, 162, 163, 164, 165, 166, 167, 168, 169, 171, 172, 175, 176, 179, 180, 181, 182, 183, 184, 185, 186, 187, 188, 189, 190, 191, 192, 193, 194, 195, 196, 198, 199, 200, 201, 202, 203, 204, 205, 206, 207, 208, 209, 210, 211, 212, 213, 214, 215, 216, 217, 218, 219, 220, 221, 222, 223, 224, 225, 226, 227, 228, 229, 230, 231, 232, 234, 235, 236, 237, 238, 239, 240, 241, 242, 243, 244, 245, 246, 247, 248, 249, 250, 251, 252, 253, 254, 256, 257, 258, 259, 260, 261, 262, 263, 264, 265, 266, 267, 268, 269, 271, 272, 273, 274, 275, 276, 277, 278, 279, 280, 281, 282, 283, 284, 285, 286, 287, 288, 289, 290, 291, 292, 293, 294, 295, 296, 297, 298, 300, 301, 302, 303, 305, 307, 310, 311, 312, 313, 314, 315, 316, 317, 318, 321, 322, 323, 324, 325, 326, 327, 331, 332, 333, 334, 335, 336, 337, 338, 339, 340, 341, 342, 343, 344, 345, 346, 348, 349, 350, 351, 352, 353, 356, 357, 358, 359, 360, 361, 362, 363, 364, 365, 366, 367, 368, 369, 370, 372, 373, 375, 376, 377, 378, 379, 380, 382, 383, 384, 385, 386, 387, 388, 389, 390, 391, 392, 393, 394, 395, 396, 397, 398, 399, 400, 401, 402, 403, 404, 405, 406, 407, 408, 409, 410, 411, 414, 415, 416, 417, 418, 419, 420, 421, 422, 423, 424, 425, 426, 427, 428, 429, 430, 431, 433, 434, 435, 436, 437, 438, 439, 440, 441, 443, 444, 445, 446, 447, 449, 450, 451, 452, 453, 454, 456, 457, 458, 459, 460, 461, 462, 463, 464, 466, 467, 468, 469, 470, 471, 473, 474, 475, 476, 477, 478, 479, 481, 482, 483, 484, 486, 487, 488, 489, 490, 491, 492, 493, 494, 495, 496, 497, 498, 499, 500, 501, 502, 503, 504, 505, 506, 508, 509, 510, 511, 512, 513, 514, 515, 516, 518, 519, 520, 521, 522, 523, 524, 525, 526, 527, 528, 530, 531, 533, 534, 535, 536, 537, 538, 539, 540, 541, 542, 543, 544, 545, 546, 547, 548, 549, 550, 551, 552, 553, 554, 555, 556, 557, 558, 559, 560, 561, 562, 563, 565, 566, 567, 568, 569, 570, 571, 572, 573, 574, 575, 576, 577, 578, 580, 582, 583, 584, 585, 586, 590, 591, 593, 594, 596, 597, 598, 599, 600, 601, 602, 603, 604, 605, 606, 607, 608, 610, 611, 612, 613, 614, 616, 617, 618, 620, 621, 622, 623, 624, 625, 626, 627, 628, 629, 631, 632, 633, 634, 635, 636, 637, 638, 639, 640, 641, 642, 643, 644, 645, 646, 647, 648, 649, 650, 651, 652, 653, 654, 655, 656, 657, 658, 659, 660, 661, 662, 663, 664, 665, 666, 667, 668, 669, 670, 671, 672, 673, 674, 675, 676, 677, 678, 679, 680, 681, 682, 683, 684, 685, 686, 687, 688, 689, 690, 693, 695, 696, 697, 698, 699, 700, 701, 702, 703, 704, 705, 706, 707, 708, 709, 710, 711, 712, 713, 714, 715, 716, 717, 718, 719, 720, 721, 722, 723, 724, 725, 726, 727, 728, 729, 730, 731, 732, 733, 734, 735, 736, 737, 738, 739, 740, 741, 742, 743, 744, 745, 746, 748, 749, 750, 751, 752, 753, 754, 755, 756, 757, 758, 759, 760, 761, 762, 763, 764, 765, 766, 767, 768, 769, 770, 771, 773, 774, 775, 776, 777, 778, 779, 780, 781, 782, 783, 784, 785, 786, 787, 788, 789, 790, 791, 792, 794, 795, 796, 797, 798, 799, 800, 801, 802, 803, 804, 805, 806, 807, 808, 809, 810, 811, 812, 813, 814, 815, 816, 817, 819, 820, 821, 824, 825, 826, 828, 829, 830, 831, 832, 833, 834, 835, 836, 837, 838, 839, 840, 841, 842, 843, 844, 845, 846, 847, 848, 849, 850, 851, 852, 854, 855, 856, 857, 858, 859, 860, 861, 862, 864, 865, 866, 867, 868, 869, 870, 871, 872, 873, 874, 875, 876, 877, 878, 879, 880, 881, 882, 883, 884, 885, 886, 887, 888, 889, 890, 891, 892, 893, 894, 895, 896, 897, 898, 899, 900, 901, 902, 903, 904, 905, 906, 907, 908, 909, 910, 911, 912, 913, 914, 915, 916, 917, 918, 919, 920, 921, 922, 923, 924, 925, 926, 927, 928, 929, 930, 931, 932, 933, 935, 936, 937, 939, 940, 941, 942, 943, 944, 945, 946, 947, 948, 949, 950, 951, 952, 953, 954, 955, 956, 957, 958, 959, 960, 961, 962, 963, 964, 965, 966, 967, 968, 969, 970, 971, 972, 973, 974, 975, 976, 977, 978, 979, 980, 981, 982, 983, 984, 985, 986, 987, 988, 990, 991, 992, 993, 994, 996, 997, 999, 1000, 1001, 1002, 1003, 1004, 1005, 1006, 1007, 1008, 1009, 1010, 1011, 1012, 1013, 1014, 1015, 1016, 1017, 1018, 1019, 1020, 1021, 1022, 1023, 1024, 1025, 1026, 1028, 1029, 1030, 1031, 1032, 1033, 1034, 1036, 1037, 1038, 1039, 1040, 1041, 1042, 1043, 1044, 1045, 1046, 1047, 1048, 1050, 1051, 1052, 1053, 1054, 1055, 1056, 1057, 1058, 1059, 1060, 1061, 1063, 1064, 1065, 1066, 1067, 1069, 1070, 1071, 1073, 1074, 1075, 1076, 1077, 1078, 1079, 1080, 1082, 1083, 1085, 1086, 1087, 1088, 1089, 1090, 1092, 1093, 1094, 1095, 1096, 1097, 1098, 1099, 1100, 1101, 1103, 1104, 1105, 1106, 1107, 1108, 1109, 1110, 1111, 1112, 1114, 1115, 1116, 1117, 1118, 1119, 1120, 1122, 1123, 1124, 1125, 1126, 1127, 1128, 1129, 1130, 1131, 1134, 1135, 1136, 1137, 1138, 1142, 1143, 1144, 1146, 1148, 1150, 1151, 1152, 1153, 1154, 1155, 1156, 1157, 1158, 1159, 1161, 1162, 1163, 1165, 1167, 1169, 1171, 1172, 1173, 1176, 1177, 1179, 1181, 1182, 1183, 1185, 1186, 1190, 1193, 1194, 1195, 1196, 1203, 1204, 1205, 1207, 1210, 1211, 1212, 1213, 1217, 1218, 1219, 1220, 1221, 1223, 1224, 1226, 1228, 1229, 1231, 1233, 1234, 1235, 1237, 1238, 1242, 1243, 1244, 1247, 1248, 1250, 1251, 1252, 1255, 1262, 1267, 1269, 1270, 1271, 1272, 1273, 1274, 1275, 1276, 1277, 1278, 1279, 1280, 1281, 1282, 1284, 1285, 1287, 1288, 1289, 1291, 1292, 1298, 1301, 1302, 1303, 1305, 1311, 1317, 1318, 1323, 1324, 1325, 1326, 1328, 1330, 1331, 1332, 1333, 1336, 1337, 1342, 1344, 1347, 1348, 1349, 1351, 1354, 1358, 1359, 1360, 1361, 1362, 1365, 1366, 1369, 1370, 1371, 1373, 1374, 1376, 1377, 1378, 1380, 1382, 1384, 1387, 1388, 1389, 1390, 1391, 1392, 1393, 1394, 1395, 1397, 1399, 1402, 1404, 1405, 1406, 1412, 1413, 1414, 1415, 1418, 1422, 1424, 1426, 1427, 1430, 1431, 1432, 1434, 1436, 1437, 1441, 1442, 1445, 1448, 1449, 1458, 1467, 1468, 1469, 1473, 1474, 1479, 1483, 1487, 1491, 1499, 1502, 1504, 1506, 1509, 1511, 1512, 1517, 1518, 1520, 1521, 1526, 1527, 1529, 1530, 1534, 1535, 1539, 1542, 1543, 1546, 1548, 1549, 1550, 1551, 1552, 1553, 1556, 1559, 1561, 1562, 1563, 1566, 1567, 1568, 1571, 1573, 1574, 1575, 1576, 1578, 1580, 1581, 1582, 1583, 1584, 1585, 1586, 1588, 1589, 1590, 1591, 1592, 1593, 1594, 1595, 1597, 1601, 1606, 1608, 1610, 1613, 1614, 1615, 1619, 1624, 1625, 1626, 1627, 1628, 1630, 1633, 1635, 1638, 1641, 1643, 1650, 1651, 1652, 1653, 1654, 1655, 1656, 1657, 1658, 1660, 1661, 1662, 1663, 1664, 1665, 1667, 1668, 1671, 1672, 1673, 1674, 1678, 1679, 1680, 1681, 1682, 1683, 1684, 1685, 1686, 1687, 1691, 1693, 1695, 1696, 1699, 1700, 1701, 1702, 1703, 1704, 1706, 1708, 1709, 1710, 1713, 1715, 1717, 1718, 1719, 1721, 1722, 1726, 1727, 1728, 1729, 1730, 1731, 1734, 1736, 1741, 1744, 1745, 1746, 1749, 1752, 1754, 1755, 1757, 1758, 1760, 1764, 1765, 1766, 1769, 1770, 1771, 1772, 1778, 1781, 1784, 1786, 1791, 1792, 1793, 1796, 1797, 1798, 1813, 1822, 1825, 1827, 1829, 1835, 1836, 1840, 1844, 1845, 1847, 1851, 1853, 1854, 1855, 1858, 1859, 1860, 1861, 1862, 1864, 1868, 1869, 1870, 1873, 1877, 1882, 1884, 1885, 1886, 1887, 1888, 1889, 1892, 1893, 1896, 1901, 1902, 1904, 1905, 1907, 1908, 1909, 1910, 1912, 1914, 1915, 1919, 1920, 1921, 1927, 1928, 1929, 1936, 1938, 1940, 1942, 1943, 1944, 1947, 1948, 1949, 1950, 1954, 1955, 1956, 1957, 1959, 1960, 1961, 1964, 1965, 1968, 1969, 1971, 1972, 1973, 1974, 1976, 1977, 1978, 1979, 1980, 1983, 1985, 1986, 1987, 1988, 1992, 1993, 1995, 1996, 2000, 2002, 2004, 2007, 2008, 2010, 2011, 2012, 2014, 2015, 2017, 2020, 2021, 2022, 2025, 2026, 2029, 2030, 2031, 2032, 2033, 2035, 2036, 2037, 2038, 2039, 2041, 2042, 2044, 2049, 2050, 2052, 2053, 2055, 2059, 2063, 2064, 2065, 2068, 2069, 2074, 2076, 2080, 2081, 2084, 2085, 2086, 2088, 2089, 2090, 2091, 2092, 2095, 2096, 2099, 2101, 2102, 2103, 2104, 2106, 2109, 2110, 2112, 2113, 2115, 2116, 2118, 2119, 2120, 2121, 2122, 2124, 2126, 2128, 2129, 2133, 2134, 2135, 2137, 2138, 2140, 2141, 2143, 2144, 2146, 2147, 2148, 2150, 2151, 2153, 2156, 2157, 2161, 2162, 2163, 2167, 2175, 2178, 2180, 2182, 2183, 2186, 2193, 2195, 2196, 2198, 2200, 2201, 2202, 2203, 2205, 2212, 2215, 2216, 2218, 2219, 2220, 2221, 2224, 2225, 2229, 2230, 2231, 2233, 2234, 2236, 2239, 2240, 2241, 2242, 2244, 2245, 2246, 2247, 2248, 2252, 2253, 2254, 2260, 2262, 2263, 2264, 2266, 2267, 2268, 2272, 2274, 2275, 2276, 2281, 2282, 2283, 2284, 2285, 2287, 2289, 2291, 2292, 2303, 2307, 2310, 2316, 2318, 2319, 2323, 2324, 2325, 2335, 2345, 2346, 2348, 2352, 2355, 2361, 2363, 2364, 2365, 2366, 2374, 2377, 2379, 2381, 2382, 2386, 2388, 2394, 2395, 2397, 2398, 2403, 2406, 2408, 2413, 2415, 2416, 2420, 2421, 2422, 2423, 2425, 2426, 2427, 2429, 2431, 2432, 2433, 2434, 2435, 2436, 2442, 2448, 2449, 2450, 2452, 2453, 2454, 2455, 2456, 2457, 2458, 2459, 2461, 2462, 2464, 2465, 2466, 2470, 2471, 2472, 2473, 2474, 2475, 2476, 2477, 2478, 2481, 2482, 2495, 2496, 2497, 2499, 2500, 2503, 2508, 2509, 2511, 2512, 2518, 2519, 2521, 2523, 2528, 2530, 2532, 2534, 2535, 2536, 2540, 2541, 2543, 2547, 2548, 2549, 2550, 2551, 2554, 2555, 2556, 2558, 2560, 2561, 2564, 2566, 2567, 2568, 2572, 2574, 2575, 2576, 2577, 2578, 2579, 2580, 2582, 2584, 2585, 2586, 2587, 2590, 2592, 2603, 2604, 2605, 2608, 2609, 2611, 2612, 2614, 2616, 2617, 2620, 2622, 2624, 2626, 2627, 2628, 2630, 2631, 2632, 2637, 2640, 2641, 2643, 2644, 2645, 2646, 2647, 2648, 2649, 2650, 2652, 2653, 2654, 2655, 2656, 2657, 2658, 2659, 2660, 2662, 2664, 2666, 2667, 2669, 2671, 2672, 2673, 2674, 2677, 2679, 2680, 2681, 2682, 2683, 2684, 2685, 2686, 2687, 2688, 2689, 2690, 2691, 2692, 2693, 2694, 2695, 2696, 2697, 2698, 2700, 2701, 2703, 2704, 2705, 2706, 2707, 2708, 2709, 2710, 2711, 2712, 2713, 2716, 2717, 2718, 2720, 2721, 2723, 2725, 2726, 2727, 2728, 2729, 2730, 2732, 2734, 2738, 2739, 2740, 2741, 2744, 2748, 2749, 2750, 2753, 2754, 2755, 2757, 2758, 2759, 2760, 2761, 2762, 2763, 2765, 2766, 2768, 2769, 2772, 2773, 2774, 2775, 2776, 2779, 2780, 2782, 2783, 2784, 2790, 2796, 2797, 2799, 2800, 2801, 2802, 2803, 2804, 2811, 2813, 2814, 2815, 2816, 2818, 2819, 2821, 2823, 2825, 2827, 2833, 2839, 2840, 2842, 2843, 2844, 2846, 2848, 2849, 2850, 2853, 2854, 2858, 2859, 2860, 2862, 2865, 2867, 2868, 2872, 2873, 2874, 2877, 2878, 2880, 2884, 2887, 2888, 2889, 2890, 2893, 2895, 2897, 2898, 2899, 2901, 2902, 2903, 2907, 2908, 2909, 2915, 2919, 2920, 2921, 2924, 2925, 2926, 2931, 2935, 2937, 2942, 2947, 2951, 2952, 2953, 2955, 2959, 2960, 2961, 2962, 2965, 2966, 2967, 2968, 2969, 2970, 2972, 2973, 2976, 2978, 2979, 2980, 2981, 2982, 2983, 2984, 2985, 2986, 2987, 2988, 2989, 2990, 2991, 2992, 2993, 2994, 2995, 2996, 2997, 2998, 2999, 3000, 3001, 3002, 3003, 3004, 3005, 3006, 3007, 3008, 3009, 3010, 3011, 3012, 3014, 3015, 3016, 3017, 3018, 3019, 3020, 3022, 3023, 3024, 3025, 3026, 3027, 3028, 3029, 3030, 3031, 3032, 3033, 3034, 3035, 3036, 3037, 3038, 3039, 3040, 3042, 3043, 3044, 3045, 3046, 3047, 3048, 3049, 3050, 3051, 3052, 3053, 3054, 3055, 3057, 3058, 3059, 3060, 3061, 3062, 3063, 3064, 3065, 3066, 3067, 3068, 3070, 3071, 3072, 3073, 3074, 3075, 3076, 3077, 3079, 3080, 3081, 3082, 3083, 3084, 3086, 3087, 3088, 3089, 3090, 3091, 3093, 3094, 3095, 3096, 3097, 3098, 3099, 3100, 3102, 3103, 3104, 3105, 3106, 3107, 3108, 3109, 3110, 3111, 3112, 3113, 3114, 3115, 3116, 3118, 3119, 3120, 3121, 3122, 3123, 3124, 3125, 3126, 3127, 3128, 3131, 3132, 3134, 3135, 3136, 3137, 3138, 3142, 3143, 3144, 3146, 3147, 3149, 3150, 3151, 3152, 3153, 3155, 3156, 3157, 3158, 3159, 3160, 3162, 3163, 3164, 3165, 3166, 3167, 3169, 3170, 3171, 3172, 3173, 3174, 3175, 3176, 3177, 3178, 3179, 3180, 3181, 3182, 3183, 3184, 3185, 3186, 3187, 3188, 3189, 3190, 3191, 3192, 3193, 3194, 3195, 3196, 3197, 3198, 3199, 3200, 3201, 3202, 3203, 3204, 3205, 3206, 3207, 3208, 3209, 3210, 3211, 3212, 3213, 3214, 3215, 3216, 3217, 3218, 3219, 3223, 3224, 3225, 3226, 3228, 3229, 3231, 3236, 3241, 3242, 3243, 3244, 3245, 3247, 3248, 3249, 3250, 3252, 3253, 3254, 3255, 3256, 3258, 3260, 3261, 3262, 3265, 3269, 3270, 3271, 3272, 3273, 3276, 3279, 3280, 3281, 3282, 3283, 3285, 3287, 3288, 3289, 3291, 3293, 3294, 3295, 3296, 3300, 3302, 3303, 3304, 3305, 3306, 3307, 3311, 3312, 3313, 3314, 3316, 3318, 3319, 3320, 3321, 3323, 3325, 3326, 3327, 3328, 3330, 3331, 3332, 3333, 3334, 3335, 3337, 3341, 3342, 3343, 3345, 3346, 3347, 3349, 3353, 3354, 3355, 3357, 3358, 3362, 3363, 3367, 3368, 3369, 3373, 3374, 3377, 3378, 3379, 3380, 3384, 3386, 3387, 3388, 3389, 3390, 3391, 3392, 3393, 3394, 3397, 3398, 3400, 3401, 3404, 3405, 3408, 3410, 3412, 3413, 3414, 3415, 3416, 3417, 3418, 3419, 3421, 3422, 3423, 3424, 3426, 3428, 3429, 3430, 3431, 3432, 3435, 3437, 3438, 3439, 3440, 3441, 3442, 3443, 3445, 3447, 3449, 3450, 3451, 3452, 3453, 3459, 3460, 3461, 3465, 3467, 3469, 3470, 3471, 3472, 3473, 3474, 3476, 3477, 3480, 3482, 3483, 3484, 3485, 3486, 3487, 3489, 3490, 3492, 3493, 3495, 3497, 3498, 3500, 3501, 3505, 3506, 3509, 3510, 3511, 3512, 3514, 3515, 3516, 3519, 3521, 3522, 3523, 3527, 3528, 3529, 3530, 3532, 3534, 3539, 3540, 3542, 3543, 3545, 3546, 3547, 3548, 3549, 3550, 3552, 3553, 3556, 3557, 3558, 3562, 3565, 3566, 3567, 3568, 3569, 3570, 3571, 3573, 3575, 3576, 3578, 3580, 3581, 3582, 3583, 3584, 3585, 3586, 3588, 3589, 3591, 3592, 3593, 3594, 3595, 3596, 3598, 3599, 3600, 3601, 3602, 3603, 3604, 3605, 3606, 3608, 3609, 3610, 3611, 3612, 3613, 3614, 3615, 3616, 3617, 3618, 3620, 3621, 3622, 3623, 3624, 3625, 3626, 3627, 3628, 3629, 3631, 3632, 3633, 3634, 3635, 3636, 3637, 3638, 3639, 3640, 3642, 3644, 3645, 3646, 3647, 3648, 3649, 3650, 3652, 3653, 3655, 3656, 3657, 3660, 3661, 3662, 3663, 3664, 3665, 3666, 3667, 3669, 3670, 3671, 3672, 3673, 3674, 3675, 3676, 3679, 3680, 3681, 3683, 3684, 3685, 3686, 3687, 3688, 3690, 3691, 3692, 3694, 3696, 3697, 3698, 3699, 3701, 3702, 3703, 3707, 3708, 3712, 3713, 3716, 3718, 3719, 3721, 3722, 3724, 3730, 3731, 3733, 3734, 3735, 3737, 3739, 3740, 3743, 3748, 3751, 3752, 3753, 3754, 3756, 3757, 3758, 3759, 3760, 3762, 3768, 3769, 3770, 3773, 3774, 3775, 3781, 3782, 3783, 3784, 3786, 3788, 3790, 3791, 3793, 3796, 3797, 3798, 3800, 3804, 3805, 3810, 3815, 3817, 3821, 3823, 3826, 3831, 3833, 3837, 3838, 3840, 3845, 3853, 3871, 3873, 3877, 3880, 3884, 3894, 3895, 3898, 3899, 3902, 3918, 3921, 3923, 3924, 3927, 3929, 3932, 3934, 3936, 3938, 3939, 3943, 3944, 3945, 3948, 3951, 3955, 3957, 3958, 3960, 3962, 3965, 3967, 3972, 3978, 3985, 3989, 3992, 3995, 3996, 3997, 3999, 4001, 4006, 4007, 4008, 4009, 4010, 4011, 4013, 4014, 4016, 4017, 4018, 4019, 4025, 4026, 4027, 4029, 4030, 4033, 4034, 4039, 4040, 4042, 4044, 4046, 4050, 4053, 4054, 4055, 4058, 4059, 4060, 4062, 4063, 4067, 4070, 4071, 4075, 4076, 4078, 4079, 4080, 4082, 4083, 4084, 4085, 4086, 4087, 4088, 4089, 4092, 4093, 4094, 4095, 4096, 4098, 4099, 4100, 4101, 4102, 4103, 4104, 4105, 4106, 4107, 4109, 4111, 4112, 4113, 4114, 4115, 4116, 4117, 4118, 4119, 4120, 4121, 4122, 4123, 4124, 4125, 4126, 4127, 4128, 4129, 4132, 4133, 4134, 4135, 4136, 4137, 4138, 4139, 4140, 4141, 4142, 4143, 4144, 4145, 4147, 4148, 4149, 4150, 4151, 4152, 4153, 4154, 4155, 4156, 4157, 4158, 4159, 4160, 4161, 4163, 4164, 4165, 4166, 4167, 4168, 4169, 4170, 4171, 4172, 4173, 4174, 4175, 4176, 4177, 4178, 4179, 4181, 4182, 4183, 4184, 4185, 4186, 4187, 4188, 4189, 4190, 4191, 4192, 4193, 4194, 4195, 4196, 4197, 4198, 4200, 4201, 4202, 4203, 4204, 4205, 4206, 4207, 4208, 4209, 4210, 4211, 4212, 4213, 4214, 4215, 4216, 4217, 4218, 4219, 4221, 4222, 4223, 4224, 4225, 4226, 4227, 4228, 4229, 4230, 4231, 4232, 4233, 4234, 4235, 4237, 4238, 4239, 4240, 4241, 4242, 4243, 4244, 4245, 4246, 4247, 4248, 4249, 4250, 4251, 4252, 4253, 4254, 4255, 4256, 4257, 4258, 4259, 4260, 4261, 4262, 4263, 4264, 4265, 4266, 4267, 4269, 4270, 4271, 4272, 4273, 4275, 4276, 4277, 4278, 4279, 4280, 4281, 4283, 4284, 4286, 4287, 4288, 4289, 4290, 4292, 4293, 4294, 4295, 4297, 4298, 4299, 4300, 4301, 4302, 4303, 4304, 4305, 4306, 4307, 4308, 4309, 4310, 4311, 4312, 4313, 4314, 4315, 4316, 4317, 4318, 4319, 4320, 4321, 4322, 4323, 4325, 4326, 4327, 4328, 4329, 4330, 4331, 4333, 4334, 4335, 4336, 4337, 4339, 4340, 4341, 4342, 4343, 4344, 4345, 4346, 4347, 4348, 4349, 4350, 4351, 4352, 4353, 4354, 4356, 4357, 4358, 4359, 4361, 4362, 4363, 4364, 4365, 4366, 4367, 4368, 4369, 4370, 4371, 4372, 4373, 4374, 4375, 4376, 4377, 4378, 4380, 4381, 4382, 4383, 4384, 4385, 4386, 4387, 4388, 4389, 4390, 4391, 4394, 4395, 4396, 4397, 4399, 4400, 4401, 4402, 4403, 4404, 4405, 4406, 4408, 4409, 4410, 4411, 4412, 4413, 4414, 4415, 4416, 4417, 4418, 4420, 4421, 4423, 4424, 4425, 4426, 4427, 4428, 4429, 4430, 4432, 4433, 4434, 4435, 4436, 4437, 4438, 4439, 4440, 4441, 4443, 4444, 4446, 4447, 4448, 4449, 4452, 4453, 4455, 4456, 4457, 4458, 4459, 4460, 4463, 4465, 4466, 4467, 4468, 4471, 4472, 4473, 4474, 4477, 4478, 4479, 4480, 4481, 4492, 4493, 4495, 4498, 4500, 4501, 4502, 4503, 4504, 4506, 4507, 4508, 4509, 4510, 4511, 4512, 4513, 4514, 4515, 4516, 4518, 4519, 4520, 4521, 4522, 4523, 4524, 4525, 4526, 4527, 4528, 4530, 4531, 4532, 4533, 4534, 4535, 4536, 4538, 4539, 4540, 4541, 4542, 4543, 4545, 4548, 4549, 4551, 4552, 4553, 4554, 4556, 4558, 4559, 4564, 4565, 4566, 4567, 4568, 4569, 4570, 4571, 4572, 4573, 4574, 4576, 4580, 4581, 4583, 4584, 4586, 4589, 4590, 4591, 4593, 4595, 4596, 4597, 4599, 4602, 4603, 4604, 4605, 4607, 4608, 4612, 4613, 4615, 4616, 4622, 4623, 4625, 4626, 4628, 4629, 4630, 4635, 4636, 4639, 4640, 4641, 4645, 4646, 4648, 4650, 4651, 4652, 4655, 4656, 4657, 4658, 4659, 4660, 4661, 4662, 4665, 4666, 4668, 4669, 4670, 4672, 4674, 4675, 4676, 4678, 4679, 4680, 4681, 4684, 4686, 4688, 4689, 4693, 4694, 4697, 4698, 4699, 4704, 4707, 4718, 4723, 4726, 4728, 4735, 4747, 4748, 4750, 4752, 4756, 4758, 4759, 4760, 4761, 4762, 4765, 4768, 4771, 4775, 4777, 4781, 4783, 4785, 4792, 4795, 4797, 4798, 4799, 4800, 4801, 4804, 4805, 4806, 4813, 4814, 4815, 4816, 4822, 4827, 4828, 4831, 4832, 4834, 4837, 4839, 4842, 4845, 4846, 4849, 4850, 4852, 4853, 4858, 4859, 4860, 4863, 4866, 4867, 4874, 4875, 4876, 4877, 4878, 4879, 4880, 4881, 4882, 4883, 4885, 4888, 4889, 4890, 4891, 4892, 4894, 4895, 4898, 4899, 4900, 4901, 4902, 4903, 4904, 4905, 4907, 4908, 4909, 4910, 4911, 4912, 4915, 4916, 4917, 4918, 4919, 4922, 4926, 4927, 4928, 4935, 4936, 4940, 4942, 4943, 4944, 4945, 4946, 4947, 4948, 4949, 4950, 4951, 4954, 4955, 4957, 4958, 4959, 4960, 4963, 4964, 4965, 4967, 4969, 4970, 4971, 4980, 4981, 4982, 4983, 4984, 4991, 4993, 4995, 4996, 4998, 5000, 5004, 5005, 5007, 5009, 5010, 5015, 5021, 5022, 5023, 5026, 5029, 5032, 5033, 5036, 5037, 5041, 5042, 5047, 5050, 5051, 5052, 5055, 5056, 5058, 5060, 5061, 5063, 5064, 5065, 5069, 5077, 5079, 5083, 5084, 5095, 5100, 5101, 5105, 5106, 5112, 5113, 5115, 5116, 5118, 5119, 5123, 5124, 5125, 5126, 5127, 5128, 5129, 5133, 5134, 5135, 5141, 5144, 5151, 5155, 5157, 5158, 5159, 5161, 5164, 5167, 5168, 5169, 5170, 5172, 5174, 5175, 5179, 5188, 5190, 5192, 5193, 5195, 5196, 5197, 5199, 5204, 5205, 5208, 5209, 5210, 5211, 5212, 5213, 5216, 5217, 5218, 5220, 5221, 5226, 5231, 5232, 5233, 5236, 5237, 5240, 5242, 5249, 5253, 5257, 5258, 5259, 5260, 5261, 5262, 5263, 5264, 5266, 5271, 5272, 5273, 5274, 5276, 5277, 5278, 5279, 5280, 5281, 5282, 5283, 5284, 5286, 5287, 5288, 5292, 5297, 5299, 5300, 5303, 5304, 5306, 5307, 5308, 5309, 5310, 5311, 5312, 5314, 5315, 5317, 5319, 5324, 5325, 5326, 5327, 5330, 5331, 5334, 5335, 5338, 5341, 5342, 5344, 5345, 5346, 5347, 5348, 5350, 5351, 5357, 5363, 5364, 5365, 5367, 5368, 5369, 5370, 5373, 5375, 5378, 5379, 5380, 5381, 5383, 5392, 5393, 5394, 5397, 5399, 5400, 5401, 5403, 5410, 5412, 5413, 5416, 5418, 5419, 5420, 5422, 5423, 5425, 5426, 5427, 5433, 5434, 5435, 5437, 5438, 5440, 5441, 5444, 5445, 5447, 5448, 5450, 5451, 5453, 5455, 5456, 5457, 5458, 5459, 5460, 5461, 5464, 5469, 5470, 5471, 5476, 5478, 5479, 5480, 5481, 5483, 5490, 5491, 5492, 5493, 5497, 5499, 5500, 5501, 5503, 5504, 5505, 5506, 5507, 5514, 5515, 5517, 5519, 5521, 5522, 5523, 5524, 5530, 5531, 5532, 5533, 5534, 5535, 5536, 5537, 5538, 5539, 5541, 5542, 5543, 5547, 5548, 5549, 5552, 5557, 5561, 5562, 5563, 5564, 5565, 5566, 5567, 5571, 5573, 5574, 5577, 5582, 5583, 5584, 5585, 5588, 5590, 5595, 5596, 5597, 5600, 5601, 5605, 5606, 5607, 5612, 5615, 5617, 5625, 5626, 5627, 5628, 5629, 5633, 5634, 5635, 5636, 5639, 5640, 5642, 5645, 5648, 5649, 5650, 5651, 5656, 5660, 5661, 5672, 5674, 5679, 5688, 5689, 5694, 5695, 5696, 5697, 5700, 5703, 5709, 5713, 5714, 5717, 5718, 5720, 5722, 5723, 5724, 5726, 5728, 5729, 5730, 5731, 5732, 5733, 5734, 5735, 5737, 5739, 5740, 5741, 5743, 5744, 5745, 5746, 5749, 5753, 5754, 5757, 5760, 5762, 5764, 5765, 5767, 5768, 5769, 5771, 5773, 5777, 5778, 5779, 5780, 5781, 5782, 5783, 5784, 5785, 5786, 5787, 5791, 5792, 5793, 5794, 5795, 5796, 5797, 5799, 5800, 5801, 5802, 5804, 5806, 5809, 5810, 5817, 5821, 5822, 5823, 5826, 5827, 5831, 5832, 5834, 5835, 5836, 5839, 5840, 5841, 5843, 5848, 5853, 5854, 5856, 5858, 5859, 5860, 5861, 5862, 5863, 5864, 5865, 5866, 5868, 5869, 5870, 5871, 5874, 5875, 5876, 5877, 5878, 5880, 5881, 5882, 5883, 5884, 5886, 5887, 5888, 5889, 5890, 5891, 5892, 5893, 5895, 5897, 5898, 5899, 5900, 5901, 5902, 5903, 5904, 5905, 5907, 5909, 5910, 5912, 5914, 5915, 5918, 5919, 5920, 5921, 5922, 5924, 5925, 5927, 5928, 5934, 5935, 5940, 5942, 5943, 5945, 5946, 5947, 5948, 5949, 5952, 5953, 5954, 5956, 5960, 5962, 5963, 5970, 5971, 5980, 5981, 5986, 5988, 5991, 5996, 5997, 5998, 5999, 6000, 6004, 6007, 6009, 6012, 6017, 6019, 6021, 6022, 6025, 6027, 6030, 6031, 6032, 6034, 6036, 6040, 6042, 6043, 6047, 6048, 6049, 6056, 6057, 6061, 6063, 6070, 6071, 6078, 6084, 6086, 6087, 6092, 6095, 6104, 6105, 6106, 6111, 6112, 6113, 6115, 6116, 6117, 6121, 6123, 6124, 6131, 6132, 6134, 6139, 6141, 6145, 6146, 6147, 6149, 6153, 6154, 6155, 6159, 6160, 6166, 6167, 6168, 6169, 6170, 6173, 6174, 6178, 6181, 6182, 6183, 6184, 6185, 6187, 6192, 6193, 6195, 6197, 6201, 6221, 6223, 6228, 6229, 6231, 6234, 6236, 6239, 6246, 6247, 6252, 6253, 6254, 6258, 6261, 6263, 6264, 6265, 6267, 6269, 6270, 6271, 6272, 6274, 6275, 6276, 6277, 6279, 6282, 6285, 6286, 6287, 6290, 6291, 6292, 6296, 6298, 6300, 6302, 6303, 6304, 6311, 6313, 6314, 6315, 6319, 6321, 6324, 6326, 6329, 6330, 6331, 6332, 6334, 6338, 6339, 6341, 6343, 6345, 6346, 6347, 6349, 6350, 6351, 6353, 6354, 6356, 6358, 6360, 6362, 6369, 6372, 6376, 6388, 6389, 6393, 6396, 6401, 6402, 6404, 6407, 6413, 6415, 6419, 6420, 6421, 6422, 6426, 6427, 6429, 6436, 6438, 6440, 6446, 6450, 6452, 6453, 6454, 6455, 6460, 6464, 6468, 6474, 6479, 6483, 6485, 6487, 6492, 6494, 6495, 6496, 6497, 6509, 6512, 6513, 6515, 6516, 6528, 6529, 6531, 6532, 6533, 6534, 6535, 6536, 6537, 6538, 6539, 6540, 6541, 6542, 6543, 6544, 6558, 6559, 6561, 6572, 6579, 6586, 6591, 6592, 6603, 6611, 6615, 6616, 6617, 6623, 6624, 6633, 6634, 6639, 6641, 6642, 6645, 6646, 6647, 6654, 6655, 6663, 6665, 6667, 6668, 6673, 6675, 6676, 6678, 6679, 6680, 6682, 6684, 6691, 6692, 6693, 6698, 6699, 6700, 6703, 6704, 6705, 6706, 6707, 6709, 6712, 6713, 6714, 6717, 6718, 6719, 6720, 6721, 6722, 6723, 6724, 6725, 6726, 6727, 6728, 6729, 6730, 6731, 6732, 6733, 6734, 6735, 6736, 6737, 6738, 6739, 6740, 6741, 6742, 6743, 6744, 6745, 6747, 6750, 6751, 6752, 6754, 6755, 6756, 6757, 6759, 6760, 6762, 6764, 6765, 6766, 6767, 6768, 6769, 6770, 6771, 6773, 6774, 6775, 6776, 6777, 6778, 6779, 6780, 6781, 6782, 6784, 6785, 6786, 6787, 6788, 6789, 6790, 6791, 6792, 6793}",4139
3,"(('exit', ('Request For Payment FINAL_APPROVED by SUPERVISOR', 'Request Payment')), ('batch', ('Request Payment', 'Payment Handled')))",2,51,"{0, 1, 2, 3, 4, 5, 6, 7, 8, 9, 10, 11, 12, 14, 15, 16, 17, 18, 20, 21, 22, 23, 24, 25, 27, 28, 29, 30, 31, 32, 33, 34, 35, 36, 37, 38, 39, 42, 43, 44, 45, 46, 47, 48, 49, 50, 51, 52, 53, 54, 55, 56, 57, 58, 59, 60, 61, 62, 64, 65, 66, 67, 68, 69, 70, 71, 72, 73, 74, 75, 78, 79, 80, 81, 83, 84, 85, 86, 88, 89, 90, 91, 92, 93, 94, 95, 96, 97, 98, 99, 100, 101, 102, 103, 104, 105, 106, 107, 108, 109, 110, 111, 112, 113, 114, 116, 118, 123, 124, 125, 126, 127, 128, 129, 130, 131, 132, 133, 134, 135, 136, 137, 138, 139, 140, 141, 143, 144, 145, 146, 147, 148, 149, 150, 151, 153, 154, 155, 156, 158, 159, 160, 161, 162, 163, 164, 165, 166, 167, 168, 169, 171, 172, 175, 176, 179, 180, 181, 182, 183, 184, 185, 186, 187, 188, 189, 190, 191, 192, 193, 194, 195, 196, 198, 199, 200, 201, 202, 203, 204, 205, 206, 207, 208, 209, 210, 211, 212, 213, 214, 215, 216, 217, 218, 219, 220, 221, 222, 223, 224, 225, 226, 227, 228, 229, 230, 231, 232, 234, 235, 236, 237, 238, 239, 240, 241, 242, 243, 244, 245, 246, 247, 248, 249, 250, 251, 252, 253, 254, 256, 257, 258, 259, 260, 261, 262, 263, 264, 265, 266, 267, 268, 269, 271, 272, 273, 274, 275, 276, 277, 278, 279, 280, 281, 282, 283, 284, 285, 286, 287, 288, 289, 290, 291, 292, 293, 294, 295, 296, 297, 298, 300, 301, 302, 303, 305, 307, 310, 311, 312, 313, 314, 315, 316, 317, 318, 321, 322, 323, 324, 325, 326, 327, 331, 332, 333, 334, 335, 336, 337, 338, 339, 340, 341, 342, 343, 344, 345, 346, 348, 349, 350, 351, 352, 353, 356, 357, 358, 359, 360, 361, 362, 363, 364, 365, 366, 367, 368, 369, 370, 372, 373, 375, 376, 377, 378, 379, 380, 382, 383, 384, 385, 386, 387, 388, 389, 390, 391, 392, 393, 394, 395, 396, 397, 398, 399, 400, 401, 402, 403, 404, 405, 406, 407, 408, 409, 410, 411, 414, 415, 416, 417, 418, 419, 420, 421, 422, 423, 424, 425, 426, 427, 428, 429, 430, 431, 433, 434, 435, 436, 437, 438, 439, 440, 441, 443, 444, 445, 446, 447, 449, 450, 451, 452, 453, 454, 456, 457, 458, 459, 460, 461, 462, 463, 464, 466, 467, 468, 469, 470, 471, 473, 474, 475, 476, 477, 478, 479, 481, 482, 483, 484, 486, 487, 488, 489, 490, 491, 492, 493, 494, 495, 496, 497, 498, 499, 500, 501, 502, 503, 504, 505, 506, 508, 509, 510, 511, 512, 513, 514, 515, 516, 518, 519, 520, 521, 522, 523, 524, 525, 526, 527, 528, 530, 531, 533, 534, 535, 536, 537, 538, 539, 540, 541, 542, 543, 544, 545, 546, 547, 548, 549, 550, 551, 552, 553, 554, 555, 556, 557, 558, 559, 560, 561, 562, 563, 565, 566, 567, 568, 569, 570, 571, 572, 573, 574, 575, 576, 577, 578, 580, 582, 583, 584, 585, 586, 590, 591, 593, 594, 596, 597, 598, 599, 600, 601, 602, 603, 604, 605, 606, 607, 608, 610, 611, 612, 613, 614, 616, 617, 618, 620, 621, 622, 623, 624, 625, 626, 627, 628, 629, 631, 632, 633, 634, 635, 636, 637, 638, 639, 640, 641, 642, 643, 644, 645, 646, 647, 648, 649, 650, 651, 652, 653, 654, 655, 656, 657, 658, 659, 660, 661, 662, 663, 664, 665, 666, 667, 668, 669, 670, 671, 672, 673, 674, 675, 676, 677, 678, 679, 680, 681, 682, 683, 684, 685, 686, 687, 688, 689, 690, 693, 695, 696, 697, 698, 699, 700, 701, 702, 703, 704, 705, 706, 707, 708, 709, 710, 711, 712, 713, 714, 715, 716, 717, 718, 719, 720, 721, 722, 723, 724, 725, 726, 727, 728, 729, 730, 731, 732, 733, 734, 735, 736, 737, 738, 739, 740, 741, 742, 743, 744, 745, 746, 748, 749, 750, 751, 752, 753, 754, 755, 756, 757, 758, 759, 760, 761, 762, 763, 764, 765, 766, 767, 768, 769, 770, 771, 773, 774, 775, 776, 777, 778, 779, 780, 781, 782, 783, 784, 785, 786, 787, 788, 789, 790, 791, 792, 794, 795, 796, 797, 798, 799, 800, 801, 802, 803, 804, 805, 806, 807, 808, 809, 810, 811, 812, 813, 814, 815, 816, 817, 819, 820, 821, 824, 825, 826, 828, 829, 830, 831, 832, 833, 834, 835, 836, 837, 838, 839, 840, 841, 842, 843, 844, 845, 846, 847, 848, 849, 850, 851, 852, 854, 855, 856, 857, 858, 859, 860, 861, 862, 864, 865, 866, 867, 868, 869, 870, 871, 872, 873, 874, 875, 876, 877, 878, 879, 880, 881, 882, 883, 884, 885, 886, 887, 888, 889, 890, 891, 892, 893, 894, 895, 896, 897, 898, 899, 900, 901, 902, 903, 904, 905, 906, 907, 908, 909, 910, 911, 912, 913, 914, 915, 916, 917, 918, 919, 920, 921, 922, 923, 924, 925, 926, 927, 928, 929, 930, 931, 932, 933, 935, 936, 937, 939, 940, 941, 942, 943, 944, 945, 946, 947, 948, 949, 950, 951, 952, 953, 954, 955, 956, 957, 958, 959, 960, 961, 962, 963, 964, 965, 966, 967, 968, 969, 970, 971, 972, 973, 974, 975, 976, 977, 978, 979, 980, 981, 982, 983, 984, 985, 986, 987, 988, 989, 990, 991, 992, 993, 994, 996, 997, 999, 1000, 1001, 1002, 1003, 1004, 1005, 1006, 1007, 1008, 1009, 1010, 1011, 1012, 1013, 1014, 1015, 1016, 1017, 1018, 1019, 1020, 1021, 1022, 1023, 1024, 1025, 1026, 1028, 1029, 1030, 1031, 1032, 1033, 1034, 1036, 1037, 1038, 1039, 1040, 1041, 1042, 1043, 1044, 1045, 1046, 1047, 1048, 1050, 1051, 1052, 1053, 1054, 1055, 1056, 1057, 1058, 1059, 1060, 1061, 1063, 1064, 1065, 1066, 1067, 1069, 1070, 1071, 1073, 1074, 1075, 1076, 1077, 1078, 1079, 1080, 1081, 1082, 1083, 1085, 1086, 1087, 1088, 1089, 1090, 1092, 1093, 1094, 1095, 1096, 1097, 1098, 1099, 1100, 1101, 1103, 1104, 1105, 1106, 1107, 1108, 1109, 1110, 1111, 1112, 1113, 1114, 1115, 1116, 1117, 1118, 1119, 1120, 1121, 1122, 1123, 1124, 1125, 1126, 1127, 1128, 1129, 1130, 1131, 1132, 1133, 1134, 1135, 1136, 1137, 1138, 1140, 1141, 1142, 1143, 1144, 1145, 1146, 1147, 1148, 1149, 1150, 1151, 1152, 1153, 1154, 1155, 1156, 1157, 1158, 1159, 1160, 1161, 1162, 1163, 1165, 1166, 1167, 1168, 1169, 1170, 1171, 1172, 1173, 1174, 1175, 1176, 1177, 1178, 1179, 1180, 1181, 1182, 1183, 1184, 1185, 1186, 1187, 1188, 1189, 1190, 1191, 1192, 1193, 1194, 1195, 1196, 1197, 1198, 1199, 1200, 1201, 1202, 1203, 1204, 1205, 1206, 1207, 1208, 1209, 1210, 1211, 1212, 1213, 1214, 1215, 1216, 1217, 1218, 1219, 1220, 1221, 1222, 1223, 1224, 1225, 1226, 1227, 1228, 1229, 1230, 1231, 1232, 1233, 1234, 1235, 1236, 1237, 1238, 1239, 1240, 1241, 1242, 1243, 1244, 1245, 1246, 1247, 1248, 1249, 1250, 1251, 1252, 1253, 1254, 1255, 1258, 1259, 1260, 1262, 1263, 1264, 1265, 1267, 1268, 1269, 1270, 1271, 1272, 1273, 1274, 1275, 1276, 1277, 1278, 1279, 1280, 1281, 1282, 1283, 1284, 1285, 1286, 1287, 1288, 1289, 1290, 1291, 1292, 1293, 1294, 1295, 1298, 1299, 1300, 1301, 1302, 1303, 1304, 1305, 1306, 1307, 1308, 1309, 1310, 1311, 1313, 1314, 1315, 1316, 1317, 1318, 1320, 1321, 1323, 1324, 1325, 1326, 1327, 1328, 1329, 1330, 1331, 1332, 1333, 1334, 1335, 1336, 1337, 1338, 1339, 1340, 1342, 1343, 1344, 1345, 1346, 1347, 1348, 1349, 1350, 1351, 1352, 1353, 1354, 1355, 1356, 1357, 1358, 1359, 1360, 1361, 1362, 1364, 1365, 1366, 1367, 1368, 1369, 1370, 1371, 1372, 1373, 1374, 1375, 1376, 1377, 1378, 1379, 1380, 1381, 1382, 1383, 1384, 1385, 1386, 1387, 1388, 1389, 1390, 1391, 1392, 1393, 1394, 1395, 1396, 1397, 1399, 1400, 1401, 1402, 1403, 1404, 1405, 1406, 1407, 1408, 1409, 1410, 1411, 1412, 1413, 1414, 1415, 1416, 1418, 1419, 1420, 1421, 1422, 1423, 1424, 1426, 1427, 1428, 1429, 1430, 1431, 1432, 1433, 1434, 1435, 1436, 1437, 1439, 1440, 1441, 1442, 1443, 1445, 1446, 1447, 1448, 1449, 1450, 1451, 1452, 1453, 1454, 1455, 1456, 1457, 1458, 1459, 1460, 1461, 1462, 1464, 1465, 1466, 1467, 1468, 1469, 1470, 1471, 1472, 1473, 1474, 1475, 1476, 1477, 1478, 1479, 1481, 1482, 1483, 1484, 1485, 1487, 1488, 1489, 1491, 1492, 1493, 1494, 1495, 1496, 1499, 1500, 1501, 1502, 1503, 1504, 1505, 1506, 1507, 1508, 1509, 1510, 1511, 1512, 1513, 1514, 1515, 1516, 1517, 1518, 1519, 1520, 1521, 1522, 1523, 1524, 1525, 1526, 1527, 1528, 1529, 1530, 1531, 1532, 1533, 1534, 1535, 1536, 1538, 1539, 1540, 1541, 1542, 1543, 1544, 1545, 1546, 1548, 1549, 1550, 1551, 1552, 1553, 1554, 1556, 1557, 1558, 1559, 1560, 1561, 1562, 1563, 1564, 1565, 1566, 1567, 1568, 1569, 1570, 1571, 1572, 1573, 1574, 1575, 1576, 1577, 1578, 1579, 1580, 1581, 1582, 1583, 1584, 1585, 1586, 1587, 1588, 1589, 1590, 1591, 1592, 1593, 1594, 1595, 1596, 1597, 1598, 1599, 1600, 1601, 1602, 1603, 1604, 1605, 1606, 1607, 1608, 1609, 1610, 1612, 1613, 1614, 1615, 1616, 1617, 1618, 1619, 1620, 1621, 1622, 1623, 1624, 1625, 1626, 1627, 1628, 1629, 1630, 1631, 1632, 1633, 1634, 1635, 1636, 1637, 1638, 1639, 1640, 1641, 1642, 1643, 1644, 1645, 1646, 1647, 1648, 1649, 1650, 1651, 1652, 1653, 1654, 1655, 1656, 1657, 1658, 1659, 1660, 1661, 1662, 1663, 1664, 1665, 1666, 1667, 1668, 1669, 1670, 1671, 1672, 1673, 1674, 1675, 1676, 1678, 1679, 1680, 1681, 1682, 1683, 1684, 1685, 1686, 1687, 1688, 1689, 1690, 1691, 1692, 1693, 1694, 1695, 1696, 1697, 1698, 1699, 1700, 1701, 1702, 1703, 1704, 1705, 1706, 1707, 1708, 1709, 1710, 1711, 1712, 1713, 1714, 1715, 1716, 1717, 1718, 1719, 1720, 1721, 1722, 1723, 1724, 1725, 1726, 1727, 1728, 1729, 1730, 1731, 1732, 1734, 1735, 1736, 1737, 1738, 1739, 1740, 1741, 1742, 1743, 1744, 1745, 1746, 1747, 1748, 1749, 1752, 1753, 1754, 1755, 1756, 1757, 1758, 1759, 1760, 1761, 1762, 1764, 1765, 1766, 1767, 1768, 1769, 1770, 1771, 1772, 1773, 1774, 1775, 1776, 1778, 1779, 1780, 1781, 1782, 1783, 1784, 1785, 1786, 1787, 1788, 1789, 1790, 1791, 1792, 1793, 1795, 1796, 1797, 1798, 1799, 1800, 1801, 1802, 1803, 1804, 1805, 1806, 1807, 1808, 1809, 1810, 1811, 1812, 1813, 1814, 1815, 1816, 1817, 1818, 1819, 1820, 1821, 1822, 1823, 1824, 1825, 1826, 1827, 1828, 1829, 1830, 1831, 1832, 1833, 1834, 1835, 1836, 1837, 1838, 1839, 1840, 1841, 1842, 1843, 1844, 1845, 1846, 1847, 1848, 1849, 1850, 1851, 1852, 1853, 1854, 1855, 1857, 1858, 1859, 1860, 1861, 1862, 1863, 1864, 1865, 1866, 1867, 1868, 1869, 1870, 1871, 1872, 1873, 1874, 1875, 1876, 1877, 1878, 1879, 1880, 1881, 1882, 1883, 1884, 1885, 1886, 1887, 1888, 1889, 1890, 1891, 1892, 1893, 1894, 1895, 1896, 1897, 1898, 1899, 1900, 1901, 1902, 1903, 1904, 1905, 1907, 1908, 1909, 1910, 1911, 1912, 1914, 1915, 1916, 1918, 1919, 1920, 1921, 1922, 1923, 1924, 1925, 1926, 1927, 1928, 1929, 1930, 1931, 1932, 1934, 1936, 1937, 1938, 1939, 1940, 1941, 1942, 1943, 1944, 1945, 1946, 1947, 1948, 1949, 1950, 1951, 1952, 1954, 1955, 1956, 1957, 1958, 1959, 1960, 1961, 1962, 1963, 1964, 1965, 1966, 1967, 1968, 1969, 1970, 1971, 1972, 1973, 1974, 1975, 1976, 1977, 1978, 1979, 1980, 1981, 1982, 1983, 1984, 1985, 1986, 1987, 1988, 1990, 1991, 1992, 1993, 1994, 1995, 1996, 1997, 1998, 1999, 2000, 2001, 2002, 2003, 2004, 2005, 2006, 2007, 2008, 2009, 2010, 2011, 2012, 2014, 2015, 2016, 2017, 2018, 2019, 2020, 2021, 2022, 2023, 2024, 2025, 2026, 2027, 2028, 2029, 2030, 2031, 2032, 2033, 2034, 2035, 2036, 2037, 2038, 2039, 2040, 2041, 2042, 2043, 2044, 2045, 2046, 2047, 2049, 2050, 2051, 2052, 2053, 2055, 2056, 2057, 2058, 2059, 2060, 2061, 2062, 2063, 2064, 2065, 2066, 2067, 2068, 2069, 2070, 2071, 2073, 2074, 2075, 2076, 2077, 2079, 2080, 2081, 2082, 2083, 2084, 2085, 2086, 2087, 2088, 2089, 2090, 2091, 2092, 2094, 2095, 2096, 2097, 2098, 2099, 2100, 2101, 2102, 2103, 2104, 2106, 2107, 2108, 2109, 2110, 2111, 2112, 2113, 2114, 2115, 2116, 2117, 2118, 2119, 2120, 2121, 2122, 2123, 2124, 2125, 2126, 2128, 2129, 2130, 2131, 2132, 2133, 2134, 2135, 2137, 2138, 2139, 2140, 2141, 2142, 2143, 2144, 2146, 2147, 2148, 2149, 2150, 2151, 2152, 2153, 2154, 2155, 2156, 2157, 2158, 2159, 2160, 2161, 2162, 2163, 2164, 2166, 2167, 2168, 2169, 2170, 2171, 2172, 2173, 2174, 2175, 2176, 2177, 2178, 2179, 2180, 2181, 2182, 2183, 2184, 2185, 2186, 2187, 2188, 2189, 2190, 2191, 2192, 2193, 2194, 2195, 2196, 2197, 2198, 2200, 2201, 2202, 2203, 2204, 2205, 2206, 2207, 2208, 2209, 2210, 2211, 2212, 2213, 2214, 2215, 2216, 2217, 2218, 2219, 2220, 2221, 2222, 2223, 2224, 2225, 2226, 2228, 2229, 2230, 2231, 2232, 2233, 2234, 2235, 2236, 2237, 2239, 2240, 2241, 2242, 2243, 2244, 2245, 2246, 2247, 2248, 2249, 2250, 2251, 2252, 2253, 2254, 2255, 2259, 2260, 2261, 2262, 2263, 2264, 2265, 2266, 2267, 2268, 2269, 2270, 2271, 2272, 2273, 2274, 2275, 2276, 2277, 2280, 2281, 2282, 2283, 2284, 2285, 2287, 2288, 2289, 2290, 2291, 2292, 2293, 2294, 2295, 2296, 2297, 2298, 2299, 2300, 2301, 2302, 2303, 2304, 2305, 2306, 2307, 2309, 2310, 2311, 2312, 2313, 2315, 2316, 2317, 2318, 2319, 2320, 2321, 2322, 2323, 2324, 2325, 2327, 2328, 2329, 2330, 2331, 2332, 2333, 2334, 2335, 2336, 2337, 2338, 2339, 2340, 2341, 2342, 2344, 2345, 2346, 2347, 2348, 2349, 2350, 2351, 2352, 2353, 2354, 2355, 2356, 2357, 2358, 2359, 2360, 2361, 2362, 2363, 2364, 2365, 2366, 2367, 2368, 2369, 2370, 2371, 2373, 2374, 2375, 2376, 2377, 2378, 2379, 2380, 2381, 2382, 2383, 2384, 2385, 2386, 2387, 2388, 2389, 2390, 2391, 2392, 2393, 2394, 2395, 2396, 2397, 2398, 2399, 2401, 2402, 2403, 2404, 2405, 2406, 2407, 2408, 2409, 2410, 2411, 2412, 2413, 2414, 2415, 2416, 2419, 2420, 2421, 2422, 2423, 2424, 2425, 2426, 2427, 2428, 2429, 2430, 2431, 2432, 2433, 2434, 2435, 2436, 2437, 2438, 2439, 2440, 2441, 2442, 2443, 2444, 2445, 2448, 2449, 2450, 2452, 2453, 2454, 2455, 2456, 2457, 2458, 2459, 2460, 2461, 2462, 2463, 2464, 2465, 2466, 2467, 2469, 2470, 2471, 2472, 2473, 2474, 2475, 2476, 2477, 2478, 2479, 2480, 2481, 2482, 2483, 2484, 2485, 2486, 2487, 2488, 2489, 2490, 2491, 2492, 2494, 2495, 2496, 2497, 2499, 2500, 2501, 2503, 2504, 2505, 2506, 2508, 2509, 2510, 2511, 2512, 2513, 2514, 2515, 2516, 2517, 2518, 2519, 2520, 2521, 2522, 2523, 2524, 2525, 2526, 2527, 2528, 2529, 2530, 2531, 2532, 2533, 2534, 2535, 2536, 2537, 2538, 2540, 2541, 2543, 2544, 2546, 2547, 2548, 2549, 2550, 2551, 2552, 2553, 2554, 2555, 2556, 2557, 2558, 2559, 2560, 2561, 2562, 2563, 2564, 2566, 2567, 2568, 2569, 2570, 2572, 2574, 2575, 2576, 2577, 2578, 2579, 2580, 2581, 2582, 2583, 2584, 2585, 2586, 2587, 2590, 2591, 2592, 2593, 2594, 2595, 2596, 2597, 2598, 2599, 2600, 2601, 2603, 2604, 2605, 2606, 2607, 2608, 2609, 2610, 2611, 2612, 2613, 2614, 2615, 2616, 2617, 2620, 2621, 2622, 2623, 2624, 2625, 2626, 2627, 2628, 2629, 2630, 2631, 2632, 2633, 2635, 2636, 2637, 2639, 2640, 2641, 2642, 2643, 2644, 2645, 2646, 2647, 2648, 2649, 2650, 2652, 2653, 2654, 2655, 2656, 2657, 2658, 2659, 2660, 2662, 2664, 2666, 2667, 2668, 2669, 2671, 2672, 2673, 2674, 2677, 2679, 2680, 2681, 2682, 2683, 2684, 2685, 2686, 2687, 2688, 2689, 2690, 2691, 2692, 2693, 2694, 2695, 2696, 2697, 2698, 2699, 2700, 2701, 2703, 2704, 2705, 2706, 2707, 2708, 2709, 2710, 2711, 2712, 2713, 2715, 2716, 2717, 2718, 2720, 2721, 2723, 2724, 2725, 2726, 2727, 2728, 2729, 2730, 2731, 2732, 2733, 2734, 2735, 2736, 2737, 2738, 2739, 2740, 2741, 2744, 2745, 2746, 2747, 2748, 2749, 2750, 2751, 2753, 2754, 2755, 2756, 2757, 2758, 2759, 2760, 2761, 2762, 2763, 2764, 2765, 2766, 2768, 2769, 2770, 2771, 2772, 2773, 2774, 2775, 2776, 2777, 2779, 2780, 2782, 2783, 2784, 2785, 2786, 2787, 2789, 2790, 2791, 2792, 2793, 2794, 2795, 2796, 2797, 2798, 2799, 2800, 2801, 2802, 2803, 2804, 2805, 2806, 2807, 2808, 2809, 2811, 2812, 2813, 2814, 2815, 2816, 2817, 2818, 2819, 2820, 2821, 2822, 2823, 2825, 2826, 2827, 2828, 2830, 2831, 2832, 2833, 2834, 2835, 2836, 2837, 2838, 2839, 2840, 2841, 2842, 2843, 2844, 2845, 2846, 2847, 2848, 2849, 2850, 2851, 2852, 2853, 2854, 2855, 2856, 2857, 2858, 2859, 2860, 2861, 2862, 2863, 2865, 2866, 2867, 2868, 2869, 2870, 2871, 2872, 2873, 2874, 2875, 2877, 2878, 2880, 2883, 2884, 2886, 2887, 2888, 2889, 2890, 2891, 2892, 2893, 2894, 2895, 2896, 2897, 2898, 2899, 2900, 2901, 2902, 2903, 2904, 2905, 2906, 2907, 2908, 2909, 2910, 2911, 2912, 2914, 2915, 2916, 2917, 2918, 2919, 2920, 2921, 2923, 2924, 2925, 2926, 2927, 2930, 2931, 2932, 2933, 2934, 2935, 2937, 2938, 2939, 2940, 2941, 2942, 2943, 2944, 2945, 2946, 2947, 2949, 2950, 2951, 2952, 2953, 2955, 2956, 2957, 2959, 2960, 2961, 2962, 2963, 2965, 2966, 2967, 2968, 2969, 2970, 2971, 2972, 2973, 2974, 2975, 2976, 2977, 2978, 2979, 2980, 2981, 2982, 2983, 2984, 2985, 2986, 2987, 2988, 2989, 2990, 2991, 2992, 2993, 2994, 2995, 2996, 2997, 2998, 2999, 3000, 3001, 3002, 3003, 3004, 3005, 3006, 3007, 3008, 3009, 3010, 3011, 3012, 3014, 3015, 3016, 3017, 3018, 3019, 3020, 3022, 3023, 3024, 3025, 3026, 3027, 3028, 3029, 3030, 3031, 3032, 3033, 3034, 3035, 3036, 3037, 3038, 3039, 3040, 3042, 3043, 3044, 3045, 3046, 3047, 3048, 3049, 3050, 3051, 3052, 3053, 3054, 3055, 3057, 3058, 3059, 3060, 3061, 3062, 3063, 3064, 3065, 3066, 3067, 3068, 3070, 3071, 3072, 3073, 3074, 3075, 3076, 3077, 3079, 3080, 3081, 3082, 3083, 3084, 3086, 3087, 3088, 3089, 3090, 3091, 3093, 3094, 3095, 3096, 3097, 3098, 3099, 3100, 3101, 3102, 3103, 3104, 3105, 3106, 3107, 3108, 3109, 3110, 3111, 3112, 3113, 3114, 3115, 3116, 3118, 3119, 3120, 3121, 3122, 3123, 3124, 3125, 3126, 3127, 3128, 3131, 3132, 3133, 3134, 3135, 3136, 3137, 3138, 3139, 3142, 3143, 3144, 3146, 3147, 3149, 3150, 3151, 3152, 3153, 3155, 3156, 3157, 3158, 3159, 3160, 3162, 3163, 3164, 3165, 3166, 3167, 3169, 3170, 3171, 3172, 3173, 3174, 3175, 3176, 3177, 3178, 3179, 3180, 3181, 3182, 3183, 3184, 3185, 3186, 3187, 3188, 3189, 3190, 3191, 3192, 3193, 3194, 3195, 3196, 3197, 3198, 3199, 3200, 3201, 3202, 3203, 3204, 3205, 3206, 3207, 3208, 3209, 3210, 3211, 3212, 3213, 3214, 3215, 3216, 3217, 3218, 3219, 3222, 3223, 3224, 3225, 3226, 3227, 3228, 3229, 3231, 3232, 3233, 3234, 3236, 3240, 3241, 3242, 3243, 3244, 3245, 3247, 3248, 3249, 3250, 3251, 3252, 3253, 3254, 3255, 3256, 3258, 3259, 3260, 3261, 3262, 3263, 3265, 3269, 3270, 3271, 3272, 3273, 3276, 3277, 3279, 3280, 3281, 3282, 3283, 3284, 3285, 3286, 3287, 3288, 3289, 3291, 3292, 3293, 3294, 3295, 3296, 3298, 3299, 3300, 3301, 3302, 3303, 3304, 3305, 3306, 3307, 3310, 3311, 3312, 3313, 3314, 3316, 3317, 3318, 3319, 3320, 3321, 3322, 3323, 3325, 3326, 3327, 3328, 3329, 3330, 3331, 3332, 3333, 3334, 3335, 3337, 3338, 3339, 3340, 3341, 3342, 3343, 3344, 3345, 3346, 3347, 3349, 3350, 3351, 3352, 3353, 3354, 3355, 3356, 3357, 3358, 3359, 3360, 3362, 3363, 3364, 3366, 3367, 3368, 3369, 3370, 3371, 3372, 3373, 3374, 3375, 3376, 3377, 3378, 3379, 3380, 3381, 3382, 3383, 3384, 3386, 3387, 3388, 3389, 3390, 3391, 3392, 3393, 3394, 3396, 3397, 3398, 3399, 3400, 3401, 3402, 3403, 3404, 3405, 3406, 3407, 3408, 3410, 3411, 3412, 3413, 3414, 3415, 3416, 3417, 3418, 3419, 3421, 3422, 3423, 3424, 3426, 3427, 3428, 3429, 3430, 3431, 3432, 3433, 3434, 3435, 3436, 3437, 3438, 3439, 3440, 3441, 3442, 3443, 3444, 3445, 3446, 3447, 3448, 3449, 3450, 3451, 3452, 3453, 3454, 3455, 3456, 3457, 3459, 3460, 3461, 3462, 3465, 3466, 3467, 3468, 3469, 3470, 3471, 3472, 3473, 3474, 3476, 3477, 3480, 3481, 3482, 3483, 3484, 3485, 3486, 3487, 3488, 3489, 3490, 3491, 3492, 3493, 3494, 3495, 3497, 3498, 3499, 3500, 3501, 3502, 3503, 3504, 3505, 3506, 3507, 3509, 3510, 3511, 3512, 3513, 3514, 3515, 3516, 3519, 3520, 3521, 3522, 3523, 3525, 3526, 3527, 3528, 3529, 3530, 3531, 3532, 3533, 3534, 3535, 3536, 3538, 3539, 3540, 3541, 3542, 3543, 3544, 3545, 3546, 3547, 3548, 3549, 3550, 3551, 3552, 3553, 3556, 3557, 3558, 3562, 3563, 3564, 3565, 3566, 3567, 3568, 3569, 3570, 3571, 3572, 3573, 3574, 3575, 3576, 3577, 3578, 3580, 3581, 3582, 3583, 3584, 3585, 3586, 3588, 3589, 3591, 3592, 3593, 3594, 3595, 3596, 3598, 3599, 3600, 3601, 3602, 3603, 3604, 3605, 3606, 3607, 3608, 3609, 3610, 3611, 3612, 3613, 3614, 3615, 3616, 3617, 3618, 3620, 3621, 3622, 3623, 3624, 3625, 3626, 3627, 3628, 3629, 3630, 3631, 3632, 3633, 3634, 3635, 3636, 3637, 3638, 3639, 3640, 3642, 3644, 3645, 3646, 3647, 3648, 3649, 3650, 3651, 3652, 3653, 3655, 3656, 3657, 3658, 3660, 3661, 3662, 3663, 3664, 3665, 3666, 3667, 3668, 3669, 3670, 3671, 3672, 3673, 3674, 3675, 3676, 3677, 3678, 3679, 3680, 3681, 3682, 3683, 3684, 3685, 3686, 3687, 3688, 3689, 3690, 3691, 3692, 3693, 3694, 3696, 3697, 3698, 3699, 3700, 3701, 3702, 3703, 3704, 3705, 3706, 3707, 3708, 3709, 3710, 3711, 3712, 3713, 3716, 3717, 3718, 3719, 3721, 3722, 3724, 3728, 3729, 3730, 3731, 3732, 3733, 3734, 3735, 3736, 3737, 3738, 3739, 3740, 3743, 3744, 3748, 3749, 3750, 3751, 3752, 3753, 3754, 3756, 3757, 3758, 3759, 3760, 3761, 3762, 3763, 3764, 3765, 3766, 3767, 3768, 3769, 3770, 3772, 3773, 3774, 3775, 3776, 3777, 3778, 3779, 3781, 3782, 3783, 3784, 3785, 3786, 3787, 3788, 3789, 3790, 3791, 3792, 3793, 3794, 3795, 3796, 3797, 3798, 3799, 3800, 3801, 3802, 3803, 3804, 3805, 3806, 3807, 3808, 3809, 3810, 3811, 3812, 3813, 3814, 3815, 3817, 3818, 3819, 3820, 3821, 3822, 3823, 3825, 3826, 3827, 3828, 3829, 3830, 3831, 3832, 3833, 3834, 3835, 3836, 3837, 3838, 3839, 3840, 3841, 3843, 3844, 3845, 3846, 3847, 3848, 3849, 3850, 3851, 3852, 3853, 3854, 3855, 3856, 3857, 3858, 3859, 3860, 3861, 3862, 3863, 3864, 3866, 3867, 3868, 3869, 3870, 3871, 3872, 3873, 3874, 3875, 3877, 3878, 3879, 3880, 3884, 3886, 3887, 3888, 3889, 3890, 3891, 3892, 3893, 3894, 3895, 3896, 3897, 3898, 3899, 3900, 3901, 3902, 3903, 3904, 3905, 3906, 3907, 3908, 3910, 3912, 3913, 3915, 3917, 3918, 3919, 3920, 3921, 3922, 3923, 3924, 3925, 3926, 3927, 3928, 3929, 3930, 3932, 3933, 3934, 3935, 3936, 3937, 3938, 3939, 3940, 3941, 3943, 3944, 3945, 3946, 3947, 3948, 3949, 3950, 3951, 3952, 3953, 3954, 3955, 3956, 3957, 3958, 3959, 3960, 3962, 3963, 3964, 3965, 3966, 3967, 3969, 3972, 3973, 3974, 3975, 3976, 3977, 3978, 3979, 3980, 3981, 3982, 3983, 3984, 3985, 3986, 3987, 3988, 3989, 3990, 3991, 3992, 3993, 3994, 3995, 3996, 3997, 3998, 3999, 4000, 4001, 4002, 4003, 4004, 4005, 4006, 4007, 4008, 4009, 4010, 4011, 4012, 4013, 4014, 4016, 4017, 4018, 4019, 4020, 4021, 4022, 4023, 4024, 4025, 4026, 4027, 4028, 4029, 4030, 4031, 4032, 4033, 4034, 4037, 4038, 4039, 4040, 4041, 4042, 4043, 4044, 4045, 4046, 4047, 4049, 4050, 4053, 4054, 4055, 4056, 4057, 4058, 4059, 4060, 4061, 4062, 4063, 4067, 4068, 4069, 4070, 4071, 4072, 4073, 4074, 4075, 4076, 4077, 4078, 4079, 4080, 4081, 4082, 4083, 4084, 4085, 4086, 4087, 4088, 4089, 4090, 4091, 4092, 4093, 4094, 4095, 4096, 4097, 4098, 4099, 4100, 4101, 4102, 4103, 4104, 4105, 4106, 4107, 4108, 4109, 4111, 4112, 4113, 4114, 4115, 4116, 4117, 4118, 4119, 4120, 4121, 4122, 4123, 4124, 4125, 4126, 4127, 4128, 4129, 4130, 4131, 4132, 4133, 4134, 4135, 4136, 4137, 4138, 4139, 4140, 4141, 4142, 4143, 4144, 4145, 4147, 4148, 4149, 4150, 4151, 4152, 4153, 4154, 4155, 4156, 4157, 4158, 4159, 4160, 4161, 4163, 4164, 4165, 4166, 4167, 4168, 4169, 4170, 4171, 4172, 4173, 4174, 4175, 4176, 4177, 4178, 4179, 4181, 4182, 4183, 4184, 4185, 4186, 4187, 4188, 4189, 4190, 4191, 4192, 4193, 4194, 4195, 4196, 4197, 4198, 4200, 4201, 4202, 4203, 4204, 4205, 4206, 4207, 4208, 4209, 4210, 4211, 4212, 4213, 4214, 4215, 4216, 4217, 4218, 4219, 4221, 4222, 4223, 4224, 4225, 4226, 4227, 4228, 4229, 4230, 4231, 4232, 4233, 4234, 4235, 4237, 4238, 4239, 4240, 4241, 4242, 4243, 4244, 4245, 4246, 4247, 4248, 4249, 4250, 4251, 4252, 4253, 4254, 4255, 4256, 4257, 4258, 4259, 4260, 4261, 4262, 4263, 4264, 4265, 4266, 4267, 4269, 4270, 4271, 4272, 4273, 4275, 4276, 4277, 4278, 4279, 4280, 4281, 4283, 4284, 4286, 4287, 4288, 4289, 4290, 4292, 4293, 4294, 4295, 4297, 4298, 4299, 4300, 4301, 4302, 4303, 4304, 4305, 4306, 4307, 4308, 4309, 4310, 4311, 4312, 4313, 4314, 4315, 4316, 4317, 4318, 4319, 4320, 4321, 4322, 4323, 4325, 4326, 4327, 4328, 4329, 4330, 4331, 4332, 4333, 4334, 4335, 4336, 4337, 4339, 4340, 4341, 4342, 4343, 4344, 4345, 4346, 4347, 4348, 4349, 4350, 4351, 4352, 4353, 4354, 4356, 4357, 4358, 4359, 4361, 4362, 4363, 4364, 4365, 4366, 4367, 4368, 4369, 4370, 4371, 4372, 4373, 4374, 4375, 4376, 4377, 4378, 4379, 4380, 4381, 4382, 4383, 4384, 4385, 4386, 4387, 4388, 4389, 4390, 4391, 4392, 4393, 4394, 4395, 4396, 4397, 4398, 4399, 4400, 4401, 4402, 4403, 4404, 4405, 4406, 4407, 4408, 4409, 4410, 4411, 4412, 4413, 4414, 4415, 4416, 4417, 4418, 4419, 4420, 4421, 4422, 4423, 4424, 4425, 4426, 4427, 4428, 4429, 4430, 4432, 4433, 4434, 4435, 4436, 4437, 4438, 4439, 4440, 4441, 4442, 4443, 4444, 4445, 4446, 4447, 4448, 4449, 4450, 4451, 4452, 4453, 4455, 4456, 4457, 4458, 4459, 4460, 4461, 4463, 4465, 4466, 4467, 4468, 4469, 4471, 4472, 4473, 4474, 4477, 4478, 4479, 4480, 4481, 4482, 4483, 4484, 4485, 4486, 4487, 4488, 4489, 4490, 4491, 4492, 4493, 4494, 4495, 4496, 4497, 4498, 4499, 4500, 4501, 4502, 4503, 4504, 4505, 4506, 4507, 4508, 4509, 4510, 4511, 4512, 4513, 4514, 4515, 4516, 4517, 4518, 4519, 4520, 4521, 4522, 4523, 4524, 4525, 4526, 4527, 4528, 4529, 4530, 4531, 4532, 4533, 4534, 4535, 4536, 4537, 4538, 4539, 4540, 4541, 4542, 4543, 4544, 4545, 4546, 4547, 4548, 4549, 4551, 4552, 4553, 4554, 4555, 4556, 4557, 4558, 4559, 4560, 4561, 4562, 4563, 4564, 4565, 4566, 4567, 4568, 4569, 4570, 4571, 4572, 4573, 4574, 4575, 4576, 4577, 4578, 4579, 4580, 4581, 4582, 4583, 4584, 4585, 4586, 4587, 4588, 4589, 4590, 4591, 4593, 4594, 4595, 4596, 4597, 4598, 4599, 4600, 4601, 4602, 4603, 4604, 4605, 4606, 4607, 4608, 4610, 4611, 4612, 4613, 4614, 4615, 4616, 4618, 4619, 4620, 4621, 4622, 4623, 4624, 4625, 4626, 4627, 4628, 4629, 4630, 4632, 4633, 4634, 4635, 4636, 4637, 4639, 4640, 4641, 4642, 4643, 4644, 4645, 4646, 4647, 4648, 4650, 4651, 4652, 4653, 4654, 4655, 4656, 4657, 4658, 4659, 4660, 4661, 4662, 4663, 4664, 4665, 4666, 4667, 4668, 4669, 4670, 4671, 4672, 4673, 4674, 4675, 4676, 4677, 4678, 4679, 4680, 4681, 4682, 4683, 4684, 4685, 4686, 4687, 4688, 4689, 4690, 4691, 4692, 4693, 4694, 4695, 4696, 4697, 4698, 4699, 4700, 4701, 4702, 4703, 4704, 4705, 4706, 4707, 4708, 4709, 4710, 4711, 4712, 4713, 4715, 4716, 4717, 4718, 4719, 4720, 4722, 4723, 4724, 4725, 4726, 4727, 4728, 4729, 4730, 4731, 4732, 4733, 4734, 4735, 4736, 4737, 4738, 4739, 4740, 4741, 4742, 4743, 4744, 4745, 4746, 4747, 4748, 4749, 4750, 4751, 4752, 4753, 4754, 4755, 4756, 4757, 4758, 4759, 4760, 4761, 4762, 4763, 4764, 4765, 4767, 4768, 4770, 4771, 4772, 4773, 4774, 4775, 4776, 4777, 4778, 4779, 4780, 4781, 4783, 4784, 4785, 4788, 4789, 4790, 4791, 4792, 4793, 4794, 4795, 4796, 4797, 4798, 4799, 4800, 4801, 4802, 4803, 4804, 4805, 4806, 4807, 4808, 4809, 4810, 4811, 4813, 4814, 4815, 4816, 4817, 4818, 4819, 4820, 4821, 4822, 4823, 4826, 4827, 4828, 4829, 4831, 4832, 4833, 4834, 4835, 4836, 4837, 4838, 4839, 4840, 4841, 4842, 4843, 4844, 4845, 4846, 4847, 4848, 4849, 4850, 4851, 4852, 4853, 4854, 4855, 4856, 4857, 4858, 4859, 4860, 4861, 4862, 4863, 4864, 4865, 4866, 4867, 4868, 4869, 4871, 4872, 4873, 4874, 4875, 4876, 4877, 4878, 4879, 4880, 4881, 4882, 4883, 4884, 4885, 4887, 4888, 4889, 4890, 4891, 4892, 4893, 4894, 4895, 4897, 4898, 4899, 4900, 4901, 4902, 4903, 4904, 4905, 4906, 4907, 4908, 4909, 4910, 4911, 4912, 4914, 4915, 4916, 4917, 4918, 4919, 4920, 4921, 4922, 4923, 4925, 4926, 4927, 4928, 4929, 4930, 4931, 4932, 4933, 4934, 4935, 4936, 4937, 4938, 4939, 4940, 4942, 4943, 4944, 4945, 4946, 4947, 4948, 4949, 4950, 4951, 4952, 4953, 4954, 4955, 4956, 4957, 4958, 4959, 4960, 4961, 4962, 4963, 4964, 4965, 4967, 4968, 4969, 4970, 4971, 4972, 4973, 4974, 4975, 4977, 4978, 4979, 4980, 4981, 4982, 4983, 4984, 4986, 4987, 4988, 4989, 4990, 4991, 4993, 4994, 4995, 4996, 4997, 4998, 4999, 5000, 5001, 5002, 5003, 5004, 5005, 5006, 5007, 5009, 5010, 5011, 5012, 5013, 5014, 5015, 5016, 5017, 5018, 5019, 5020, 5021, 5022, 5023, 5024, 5025, 5026, 5027, 5028, 5029, 5031, 5032, 5033, 5034, 5035, 5036, 5037, 5038, 5039, 5040, 5041, 5042, 5043, 5044, 5045, 5046, 5047, 5048, 5049, 5050, 5051, 5052, 5055, 5056, 5057, 5058, 5059, 5060, 5061, 5062, 5063, 5064, 5065, 5066, 5067, 5068, 5069, 5070, 5071, 5072, 5073, 5074, 5075, 5076, 5077, 5078, 5079, 5080, 5081, 5082, 5083, 5084, 5085, 5086, 5087, 5090, 5091, 5092, 5093, 5095, 5096, 5097, 5098, 5099, 5100, 5101, 5102, 5103, 5104, 5105, 5106, 5107, 5108, 5109, 5110, 5111, 5112, 5113, 5114, 5115, 5116, 5117, 5118, 5119, 5120, 5121, 5122, 5123, 5124, 5125, 5126, 5127, 5128, 5129, 5130, 5131, 5132, 5133, 5134, 5135, 5136, 5137, 5138, 5139, 5140, 5141, 5142, 5143, 5144, 5145, 5148, 5149, 5150, 5151, 5152, 5155, 5156, 5157, 5158, 5159, 5160, 5161, 5162, 5163, 5164, 5165, 5166, 5167, 5168, 5169, 5170, 5171, 5172, 5174, 5175, 5176, 5178, 5179, 5181, 5182, 5183, 5185, 5186, 5187, 5188, 5190, 5191, 5192, 5193, 5194, 5195, 5196, 5197, 5198, 5199, 5200, 5201, 5202, 5203, 5204, 5205, 5206, 5207, 5208, 5209, 5210, 5211, 5212, 5213, 5214, 5215, 5216, 5217, 5218, 5219, 5220, 5221, 5224, 5225, 5226, 5229, 5230, 5231, 5232, 5233, 5236, 5237, 5238, 5239, 5240, 5241, 5242, 5243, 5245, 5246, 5247, 5248, 5249, 5250, 5251, 5252, 5253, 5256, 5257, 5258, 5259, 5260, 5261, 5262, 5263, 5264, 5265, 5266, 5267, 5268, 5269, 5270, 5271, 5272, 5273, 5274, 5275, 5276, 5277, 5278, 5279, 5280, 5281, 5282, 5283, 5284, 5285, 5286, 5287, 5288, 5289, 5290, 5291, 5292, 5294, 5295, 5296, 5297, 5298, 5299, 5300, 5301, 5302, 5303, 5304, 5305, 5306, 5307, 5308, 5309, 5310, 5311, 5312, 5313, 5314, 5315, 5316, 5317, 5319, 5320, 5321, 5323, 5324, 5325, 5326, 5327, 5328, 5329, 5330, 5331, 5333, 5334, 5335, 5336, 5337, 5338, 5339, 5340, 5341, 5342, 5343, 5344, 5345, 5346, 5347, 5348, 5350, 5351, 5352, 5353, 5354, 5355, 5356, 5357, 5358, 5359, 5361, 5362, 5363, 5364, 5365, 5366, 5367, 5368, 5369, 5370, 5371, 5372, 5373, 5375, 5376, 5377, 5378, 5379, 5380, 5381, 5383, 5384, 5385, 5386, 5387, 5388, 5389, 5390, 5391, 5392, 5393, 5394, 5396, 5397, 5398, 5399, 5400, 5401, 5402, 5403, 5404, 5405, 5406, 5407, 5408, 5409, 5410, 5411, 5412, 5413, 5414, 5416, 5417, 5418, 5419, 5420, 5422, 5423, 5424, 5425, 5426, 5427, 5428, 5429, 5430, 5431, 5432, 5433, 5434, 5435, 5437, 5438, 5439, 5440, 5441, 5442, 5443, 5444, 5445, 5446, 5447, 5448, 5449, 5450, 5451, 5452, 5453, 5454, 5455, 5456, 5457, 5458, 5459, 5460, 5461, 5462, 5463, 5464, 5465, 5466, 5467, 5468, 5469, 5470, 5471, 5472, 5473, 5474, 5475, 5476, 5477, 5478, 5479, 5480, 5481, 5482, 5483, 5484, 5485, 5486, 5487, 5488, 5489, 5490, 5491, 5492, 5493, 5494, 5495, 5496, 5497, 5498, 5499, 5500, 5501, 5502, 5503, 5504, 5505, 5506, 5507, 5508, 5509, 5510, 5511, 5512, 5513, 5514, 5515, 5516, 5517, 5518, 5519, 5520, 5521, 5522, 5523, 5524, 5525, 5526, 5527, 5529, 5530, 5531, 5532, 5533, 5534, 5535, 5536, 5537, 5538, 5539, 5540, 5541, 5542, 5543, 5544, 5545, 5547, 5548, 5549, 5550, 5551, 5552, 5554, 5555, 5556, 5557, 5558, 5559, 5560, 5561, 5562, 5563, 5564, 5565, 5566, 5567, 5568, 5569, 5570, 5571, 5572, 5573, 5574, 5575, 5576, 5577, 5578, 5579, 5580, 5581, 5582, 5583, 5584, 5585, 5586, 5587, 5588, 5589, 5590, 5591, 5592, 5593, 5594, 5595, 5596, 5597, 5598, 5600, 5601, 5602, 5603, 5604, 5605, 5606, 5607, 5608, 5609, 5610, 5612, 5613, 5614, 5615, 5616, 5617, 5618, 5620, 5622, 5623, 5624, 5625, 5626, 5627, 5628, 5629, 5630, 5631, 5633, 5634, 5635, 5636, 5637, 5639, 5640, 5642, 5643, 5645, 5646, 5647, 5648, 5649, 5650, 5651, 5652, 5653, 5654, 5655, 5656, 5657, 5658, 5659, 5660, 5661, 5662, 5663, 5664, 5665, 5666, 5667, 5668, 5669, 5670, 5671, 5672, 5673, 5674, 5676, 5677, 5678, 5679, 5680, 5681, 5682, 5683, 5684, 5685, 5686, 5688, 5689, 5690, 5691, 5692, 5693, 5694, 5695, 5696, 5697, 5698, 5699, 5700, 5701, 5702, 5703, 5704, 5705, 5706, 5707, 5708, 5709, 5711, 5712, 5713, 5714, 5716, 5717, 5718, 5720, 5721, 5722, 5723, 5724, 5726, 5728, 5729, 5730, 5731, 5732, 5733, 5734, 5735, 5736, 5737, 5739, 5740, 5741, 5742, 5743, 5744, 5745, 5746, 5747, 5748, 5749, 5751, 5752, 5753, 5754, 5755, 5756, 5757, 5758, 5759, 5760, 5761, 5762, 5763, 5764, 5765, 5766, 5767, 5768, 5769, 5771, 5772, 5773, 5774, 5775, 5776, 5777, 5778, 5779, 5780, 5781, 5782, 5783, 5784, 5785, 5786, 5787, 5788, 5789, 5791, 5792, 5793, 5794, 5795, 5796, 5797, 5798, 5799, 5800, 5801, 5802, 5803, 5804, 5805, 5806, 5808, 5809, 5810, 5811, 5813, 5814, 5815, 5816, 5817, 5819, 5820, 5821, 5822, 5823, 5825, 5826, 5827, 5828, 5829, 5830, 5831, 5832, 5833, 5834, 5835, 5836, 5837, 5838, 5839, 5840, 5841, 5842, 5843, 5844, 5846, 5847, 5848, 5849, 5850, 5851, 5852, 5853, 5854, 5855, 5856, 5857, 5858, 5859, 5860, 5861, 5862, 5863, 5864, 5865, 5866, 5868, 5869, 5870, 5871, 5872, 5874, 5875, 5876, 5877, 5878, 5880, 5881, 5882, 5883, 5884, 5886, 5887, 5888, 5889, 5890, 5891, 5892, 5893, 5894, 5895, 5896, 5897, 5898, 5899, 5900, 5901, 5902, 5903, 5904, 5905, 5907, 5908, 5909, 5910, 5912, 5913, 5914, 5915, 5916, 5917, 5918, 5919, 5920, 5921, 5922, 5924, 5925, 5926, 5927, 5928, 5929, 5932, 5933, 5934, 5935, 5936, 5937, 5938, 5939, 5940, 5942, 5943, 5944, 5945, 5946, 5947, 5948, 5949, 5950, 5952, 5953, 5954, 5955, 5956, 5957, 5960, 5962, 5963, 5965, 5966, 5967, 5968, 5969, 5970, 5971, 5972, 5973, 5974, 5975, 5976, 5977, 5978, 5979, 5980, 5981, 5983, 5984, 5985, 5986, 5987, 5988, 5989, 5991, 5992, 5993, 5994, 5995, 5996, 5997, 5998, 5999, 6000, 6001, 6002, 6003, 6004, 6005, 6006, 6007, 6008, 6009, 6010, 6011, 6012, 6013, 6015, 6016, 6017, 6018, 6019, 6021, 6022, 6023, 6024, 6025, 6027, 6028, 6029, 6030, 6031, 6032, 6034, 6036, 6037, 6040, 6041, 6042, 6043, 6044, 6045, 6046, 6047, 6048, 6049, 6051, 6052, 6053, 6055, 6056, 6057, 6058, 6059, 6060, 6061, 6063, 6064, 6065, 6066, 6067, 6068, 6069, 6070, 6071, 6072, 6073, 6074, 6075, 6076, 6077, 6078, 6079, 6080, 6081, 6083, 6084, 6085, 6086, 6087, 6088, 6089, 6090, 6091, 6092, 6093, 6094, 6095, 6096, 6097, 6099, 6100, 6101, 6102, 6103, 6104, 6105, 6106, 6107, 6108, 6109, 6111, 6112, 6113, 6114, 6115, 6116, 6117, 6119, 6120, 6121, 6122, 6123, 6124, 6126, 6127, 6128, 6129, 6130, 6131, 6132, 6133, 6134, 6135, 6136, 6137, 6139, 6140, 6141, 6142, 6143, 6144, 6145, 6146, 6147, 6148, 6149, 6150, 6151, 6152, 6153, 6154, 6155, 6156, 6157, 6158, 6159, 6160, 6161, 6162, 6163, 6164, 6165, 6166, 6167, 6168, 6169, 6170, 6171, 6172, 6173, 6174, 6175, 6176, 6178, 6179, 6180, 6181, 6182, 6183, 6184, 6185, 6186, 6187, 6189, 6190, 6191, 6192, 6193, 6194, 6195, 6196, 6197, 6198, 6200, 6201, 6202, 6203, 6204, 6205, 6206, 6207, 6208, 6209, 6210, 6211, 6212, 6213, 6214, 6215, 6216, 6217, 6218, 6220, 6221, 6222, 6223, 6224, 6225, 6226, 6227, 6228, 6229, 6230, 6231, 6232, 6233, 6234, 6235, 6236, 6237, 6238, 6239, 6240, 6241, 6242, 6243, 6244, 6245, 6246, 6247, 6248, 6249, 6250, 6251, 6252, 6253, 6254, 6255, 6256, 6257, 6258, 6259, 6260, 6261, 6262, 6263, 6264, 6265, 6266, 6267, 6269, 6270, 6271, 6272, 6273, 6274, 6275, 6276, 6277, 6278, 6279, 6280, 6281, 6282, 6283, 6284, 6285, 6286, 6287, 6288, 6289, 6290, 6291, 6292, 6293, 6294, 6295, 6296, 6297, 6298, 6300, 6301, 6302, 6303, 6304, 6305, 6306, 6307, 6308, 6309, 6310, 6311, 6313, 6314, 6315, 6316, 6317, 6318, 6319, 6320, 6321, 6322, 6323, 6324, 6325, 6326, 6327, 6328, 6329, 6330, 6331, 6332, 6333, 6334, 6335, 6336, 6338, 6339, 6340, 6341, 6342, 6343, 6344, 6345, 6346, 6347, 6348, 6349, 6350, 6351, 6352, 6353, 6354, 6355, 6356, 6357, 6358, 6359, 6360, 6361, 6362, 6363, 6364, 6369, 6370, 6371, 6372, 6373, 6374, 6375, 6376, 6377, 6378, 6379, 6380, 6381, 6382, 6383, 6384, 6385, 6386, 6387, 6388, 6389, 6390, 6391, 6392, 6393, 6394, 6395, 6396, 6399, 6401, 6402, 6404, 6405, 6407, 6408, 6410, 6411, 6412, 6413, 6414, 6415, 6416, 6417, 6418, 6419, 6420, 6421, 6422, 6423, 6424, 6425, 6426, 6427, 6428, 6429, 6430, 6431, 6433, 6434, 6435, 6436, 6437, 6438, 6439, 6440, 6441, 6442, 6443, 6444, 6445, 6446, 6447, 6448, 6449, 6450, 6452, 6453, 6454, 6455, 6457, 6458, 6460, 6461, 6462, 6463, 6464, 6467, 6468, 6469, 6470, 6471, 6472, 6473, 6474, 6475, 6476, 6477, 6478, 6479, 6481, 6482, 6483, 6484, 6485, 6486, 6487, 6488, 6489, 6491, 6492, 6493, 6494, 6495, 6496, 6497, 6498, 6499, 6500, 6501, 6502, 6503, 6504, 6505, 6506, 6507, 6508, 6509, 6510, 6511, 6512, 6513, 6514, 6515, 6516, 6517, 6518, 6519, 6520, 6521, 6522, 6523, 6524, 6525, 6526, 6527, 6528, 6529, 6530, 6531, 6532, 6533, 6534, 6535, 6536, 6537, 6538, 6539, 6540, 6541, 6542, 6543, 6544, 6545, 6547, 6548, 6552, 6553, 6554, 6555, 6556, 6557, 6558, 6559, 6560, 6561, 6562, 6563, 6564, 6565, 6566, 6568, 6569, 6570, 6571, 6572, 6573, 6575, 6576, 6577, 6578, 6579, 6580, 6581, 6582, 6583, 6584, 6585, 6586, 6587, 6589, 6590, 6591, 6592, 6593, 6594, 6595, 6596, 6597, 6598, 6600, 6601, 6602, 6603, 6604, 6605, 6606, 6607, 6608, 6609, 6610, 6611, 6612, 6613, 6614, 6615, 6616, 6617, 6618, 6619, 6620, 6621, 6622, 6623, 6624, 6625, 6626, 6627, 6628, 6629, 6630, 6631, 6632, 6633, 6634, 6635, 6636, 6637, 6639, 6640, 6641, 6642, 6643, 6644, 6645, 6646, 6647, 6648, 6649, 6650, 6651, 6652, 6653, 6654, 6655, 6656, 6657, 6658, 6659, 6660, 6661, 6662, 6663, 6664, 6665, 6666, 6667, 6668, 6669, 6670, 6671, 6672, 6673, 6675, 6676, 6677, 6678, 6679, 6680, 6681, 6682, 6683, 6684, 6685, 6686, 6687, 6688, 6689, 6690, 6691, 6692, 6693, 6694, 6695, 6696, 6697, 6698, 6699, 6700, 6701, 6702, 6703, 6704, 6705, 6706, 6707, 6708, 6709, 6710, 6711, 6712, 6713, 6714, 6715, 6716, 6717, 6718, 6719, 6720, 6721, 6722, 6723, 6724, 6725, 6726, 6727, 6728, 6729, 6730, 6731, 6732, 6733, 6734, 6735, 6736, 6737, 6738, 6739, 6740, 6741, 6742, 6743, 6744, 6745, 6747, 6748, 6750, 6751, 6752, 6753, 6754, 6755, 6756, 6757, 6759, 6760, 6762, 6764, 6765, 6766, 6767, 6768, 6769, 6770, 6771, 6773, 6774, 6775, 6776, 6777, 6778, 6779, 6780, 6781, 6782, 6783, 6784, 6785, 6786, 6787, 6788, 6789, 6790, 6791, 6792, 6793}",6260,"{989, 1081, 1113, 1121, 1132, 1133, 1140, 1141, 1145, 1147, 1160, 1166, 1168, 1170, 1174, 1175, 1178, 1180, 1184, 1187, 1188, 1189, 1191, 1192, 1197, 1198, 1199, 1200, 1201, 1202, 1206, 1208, 1209, 1215, 1216, 1222, 1225, 1227, 1230, 1232, 1236, 1239, 1240, 1241, 1245, 1246, 1249, 1253, 1258, 1259, 1260, 1263, 1264, 1265, 1268, 1283, 1286, 1290, 1293, 1294, 1295, 1299, 1300, 1304, 1306, 1307, 1308, 1309, 1310, 1313, 1314, 1315, 1316, 1320, 1321, 1327, 1329, 1334, 1335, 1338, 1339, 1340, 1343, 1345, 1346, 1350, 1352, 1353, 1355, 1356, 1357, 1364, 1367, 1368, 1372, 1375, 1379, 1381, 1383, 1385, 1386, 1396, 1400, 1401, 1403, 1407, 1408, 1409, 1410, 1411, 1416, 1419, 1420, 1421, 1423, 1428, 1429, 1433, 1435, 1439, 1440, 1443, 1446, 1447, 1450, 1451, 1452, 1453, 1454, 1455, 1456, 1457, 1459, 1460, 1461, 1462, 1464, 1465, 1466, 1470, 1471, 1472, 1475, 1476, 1477, 1478, 1481, 1482, 1484, 1485, 1488, 1489, 1492, 1493, 1494, 1495, 1496, 1500, 1501, 1503, 1505, 1507, 1508, 1510, 1513, 1515, 1516, 1519, 1522, 1523, 1524, 1525, 1528, 1531, 1532, 1533, 1536, 1538, 1540, 1541, 1544, 1545, 1554, 1557, 1558, 1560, 1564, 1565, 1569, 1570, 1572, 1577, 1579, 1587, 1596, 1598, 1599, 1600, 1602, 1603, 1604, 1605, 1607, 1609, 1612, 1616, 1617, 1618, 1620, 1621, 1622, 1623, 1629, 1631, 1632, 1634, 1636, 1637, 1639, 1640, 1642, 1644, 1645, 1646, 1647, 1648, 1649, 1659, 1666, 1669, 1670, 1675, 1676, 1688, 1689, 1690, 1692, 1694, 1697, 1698, 1705, 1707, 1711, 1712, 1714, 1716, 1720, 1723, 1724, 1725, 1732, 1735, 1737, 1738, 1739, 1740, 1742, 1743, 1747, 1748, 1753, 1756, 1759, 1761, 1762, 1767, 1768, 1773, 1774, 1775, 1776, 1779, 1780, 1782, 1783, 1785, 1787, 1788, 1789, 1790, 1795, 1799, 1800, 1801, 1802, 1803, 1804, 1805, 1806, 1807, 1808, 1809, 1810, 1811, 1812, 1814, 1815, 1816, 1817, 1818, 1819, 1820, 1821, 1823, 1824, 1826, 1828, 1830, 1831, 1832, 1833, 1834, 1837, 1838, 1839, 1841, 1842, 1843, 1846, 1848, 1849, 1850, 1852, 1857, 1863, 1865, 1866, 1867, 1871, 1872, 1874, 1875, 1876, 1878, 1879, 1880, 1881, 1883, 1890, 1891, 1894, 1895, 1897, 1898, 1899, 1900, 1903, 1911, 1916, 1918, 1922, 1923, 1924, 1925, 1926, 1930, 1931, 1932, 1934, 1937, 1939, 1941, 1945, 1946, 1951, 1952, 1958, 1962, 1963, 1966, 1967, 1970, 1975, 1981, 1982, 1984, 1990, 1991, 1994, 1997, 1998, 1999, 2001, 2003, 2005, 2006, 2009, 2016, 2018, 2019, 2023, 2024, 2027, 2028, 2034, 2040, 2043, 2045, 2046, 2047, 2051, 2056, 2057, 2058, 2060, 2061, 2062, 2066, 2067, 2070, 2071, 2073, 2075, 2077, 2079, 2082, 2083, 2087, 2094, 2097, 2098, 2100, 2107, 2108, 2111, 2114, 2117, 2123, 2125, 2130, 2131, 2132, 2139, 2142, 2149, 2152, 2154, 2155, 2158, 2160, 2164, 2166, 2168, 2169, 2170, 2171, 2172, 2173, 2174, 2176, 2177, 2179, 2181, 2184, 2185, 2187, 2188, 2189, 2190, 2191, 2192, 2194, 2197, 2204, 2206, 2207, 2208, 2209, 2210, 2211, 2213, 2214, 2217, 2222, 2223, 2226, 2228, 2232, 2235, 2237, 2243, 2249, 2250, 2251, 2255, 2259, 2261, 2265, 2269, 2270, 2271, 2273, 2277, 2280, 2288, 2290, 2293, 2294, 2295, 2296, 2297, 2298, 2299, 2300, 2301, 2302, 2304, 2305, 2306, 2309, 2311, 2312, 2313, 2315, 2317, 2320, 2321, 2322, 2327, 2328, 2329, 2330, 2331, 2332, 2333, 2334, 2336, 2337, 2338, 2339, 2340, 2341, 2342, 2344, 2347, 2349, 2350, 2351, 2353, 2354, 2356, 2357, 2358, 2359, 2360, 2362, 2367, 2368, 2369, 2370, 2371, 2373, 2375, 2376, 2378, 2380, 2383, 2384, 2385, 2387, 2389, 2390, 2391, 2392, 2393, 2396, 2399, 2401, 2402, 2404, 2405, 2407, 2409, 2410, 2411, 2412, 2414, 2419, 2424, 2428, 2430, 2437, 2438, 2439, 2440, 2441, 2443, 2444, 2445, 2460, 2463, 2467, 2469, 2479, 2480, 2483, 2484, 2485, 2486, 2487, 2488, 2489, 2490, 2491, 2492, 2494, 2501, 2504, 2505, 2506, 2510, 2513, 2514, 2515, 2516, 2517, 2520, 2522, 2524, 2525, 2526, 2527, 2529, 2531, 2533, 2537, 2538, 2544, 2546, 2552, 2553, 2557, 2559, 2562, 2563, 2569, 2581, 2583, 2591, 2593, 2594, 2595, 2596, 2597, 2598, 2599, 2600, 2601, 2606, 2607, 2610, 2613, 2615, 2621, 2623, 2625, 2629, 2633, 2635, 2636, 2639, 2642, 2668, 2699, 2715, 2724, 2731, 2733, 2735, 2736, 2737, 2745, 2746, 2747, 2751, 2756, 2764, 2770, 2771, 2777, 2785, 2786, 2787, 2789, 2791, 2792, 2793, 2794, 2795, 2798, 2805, 2806, 2807, 2808, 2809, 2812, 2817, 2820, 2822, 2826, 2828, 2830, 2831, 2832, 2834, 2835, 2836, 2837, 2838, 2841, 2845, 2847, 2851, 2852, 2855, 2856, 2857, 2861, 2863, 2866, 2869, 2870, 2871, 2875, 2883, 2886, 2891, 2892, 2894, 2896, 2900, 2904, 2905, 2906, 2910, 2911, 2912, 2914, 2916, 2917, 2918, 2923, 2927, 2930, 2932, 2933, 2934, 2938, 2939, 2940, 2941, 2943, 2944, 2945, 2946, 2949, 2950, 2956, 2957, 2963, 2971, 2974, 2975, 2977, 3101, 3133, 3139, 3222, 3227, 3232, 3233, 3240, 3251, 3259, 3263, 3277, 3284, 3286, 3292, 3298, 3299, 3301, 3310, 3317, 3322, 3329, 3338, 3339, 3340, 3344, 3350, 3351, 3352, 3356, 3359, 3360, 3364, 3366, 3370, 3371, 3372, 3375, 3376, 3381, 3382, 3383, 3396, 3399, 3402, 3403, 3406, 3407, 3411, 3427, 3433, 3434, 3436, 3444, 3446, 3448, 3454, 3455, 3456, 3457, 3462, 3466, 3468, 3481, 3488, 3491, 3494, 3499, 3502, 3503, 3504, 3507, 3513, 3520, 3525, 3526, 3531, 3533, 3535, 3536, 3538, 3541, 3544, 3563, 3564, 3572, 3574, 3577, 3607, 3630, 3651, 3658, 3668, 3677, 3678, 3682, 3689, 3693, 3700, 3704, 3705, 3706, 3709, 3710, 3711, 3717, 3728, 3729, 3732, 3736, 3738, 3744, 3749, 3750, 3761, 3763, 3764, 3765, 3766, 3767, 3772, 3776, 3777, 3778, 3779, 3785, 3787, 3789, 3792, 3794, 3795, 3799, 3801, 3802, 3803, 3806, 3807, 3808, 3809, 3811, 3812, 3813, 3814, 3818, 3819, 3820, 3822, 3825, 3827, 3828, 3829, 3830, 3832, 3834, 3835, 3836, 3839, 3841, 3843, 3844, 3846, 3847, 3848, 3849, 3850, 3851, 3852, 3854, 3855, 3856, 3857, 3858, 3859, 3860, 3861, 3862, 3863, 3864, 3866, 3867, 3868, 3869, 3870, 3872, 3874, 3875, 3878, 3879, 3886, 3887, 3888, 3889, 3890, 3891, 3892, 3893, 3896, 3897, 3900, 3901, 3903, 3904, 3905, 3906, 3907, 3908, 3910, 3912, 3913, 3915, 3917, 3919, 3920, 3922, 3925, 3926, 3928, 3930, 3933, 3935, 3937, 3940, 3941, 3946, 3947, 3949, 3950, 3952, 3953, 3954, 3956, 3959, 3963, 3964, 3966, 3969, 3973, 3974, 3975, 3976, 3977, 3979, 3980, 3981, 3982, 3983, 3984, 3986, 3987, 3988, 3990, 3991, 3993, 3994, 3998, 4000, 4002, 4003, 4004, 4005, 4012, 4020, 4021, 4022, 4023, 4024, 4028, 4031, 4032, 4037, 4038, 4041, 4043, 4045, 4047, 4049, 4056, 4057, 4061, 4068, 4069, 4072, 4073, 4074, 4077, 4081, 4090, 4091, 4097, 4108, 4130, 4131, 4332, 4379, 4392, 4393, 4398, 4407, 4419, 4422, 4442, 4445, 4450, 4451, 4461, 4469, 4482, 4483, 4484, 4485, 4486, 4487, 4488, 4489, 4490, 4491, 4494, 4496, 4497, 4499, 4505, 4517, 4529, 4537, 4544, 4546, 4547, 4555, 4557, 4560, 4561, 4562, 4563, 4575, 4577, 4578, 4579, 4582, 4585, 4587, 4588, 4594, 4598, 4600, 4601, 4606, 4610, 4611, 4614, 4618, 4619, 4620, 4621, 4624, 4632, 4633, 4634, 4637, 4642, 4643, 4644, 4647, 4653, 4654, 4663, 4664, 4667, 4671, 4673, 4677, 4682, 4683, 4685, 4687, 4690, 4691, 4692, 4695, 4696, 4701, 4702, 4703, 4705, 4706, 4708, 4709, 4710, 4711, 4712, 4713, 4715, 4716, 4717, 4719, 4720, 4722, 4724, 4725, 4727, 4729, 4730, 4731, 4732, 4733, 4734, 4736, 4737, 4738, 4739, 4740, 4741, 4742, 4743, 4744, 4746, 4749, 4751, 4753, 4754, 4755, 4757, 4763, 4764, 4767, 4770, 4772, 4773, 4774, 4776, 4778, 4779, 4780, 4784, 4789, 4790, 4791, 4793, 4794, 4796, 4802, 4803, 4808, 4809, 4810, 4811, 4817, 4818, 4819, 4820, 4821, 4823, 4826, 4829, 4833, 4835, 4836, 4838, 4840, 4841, 4843, 4844, 4847, 4848, 4851, 4854, 4855, 4856, 4857, 4861, 4862, 4864, 4865, 4868, 4869, 4871, 4872, 4873, 4884, 4887, 4893, 4897, 4906, 4914, 4920, 4921, 4923, 4925, 4929, 4930, 4931, 4932, 4933, 4934, 4937, 4938, 4939, 4952, 4953, 4956, 4961, 4962, 4968, 4972, 4973, 4974, 4975, 4977, 4978, 4979, 4986, 4987, 4988, 4989, 4990, 4994, 4997, 4999, 5001, 5002, 5003, 5006, 5011, 5012, 5013, 5014, 5016, 5017, 5018, 5019, 5020, 5024, 5025, 5027, 5028, 5031, 5034, 5035, 5038, 5039, 5040, 5043, 5044, 5045, 5046, 5048, 5049, 5057, 5059, 5062, 5066, 5067, 5068, 5070, 5071, 5072, 5073, 5074, 5075, 5076, 5078, 5080, 5081, 5082, 5085, 5086, 5087, 5090, 5091, 5092, 5093, 5096, 5097, 5098, 5099, 5102, 5103, 5104, 5107, 5108, 5109, 5110, 5111, 5114, 5117, 5120, 5121, 5122, 5130, 5131, 5132, 5136, 5137, 5138, 5139, 5140, 5142, 5143, 5145, 5148, 5149, 5150, 5152, 5156, 5160, 5162, 5163, 5165, 5166, 5171, 5176, 5178, 5181, 5182, 5183, 5185, 5186, 5187, 5191, 5194, 5198, 5200, 5201, 5202, 5203, 5206, 5207, 5214, 5215, 5219, 5224, 5225, 5229, 5230, 5238, 5239, 5241, 5243, 5245, 5246, 5247, 5248, 5250, 5251, 5252, 5256, 5265, 5267, 5268, 5269, 5270, 5275, 5285, 5289, 5290, 5291, 5294, 5295, 5296, 5298, 5301, 5302, 5305, 5313, 5316, 5320, 5321, 5323, 5328, 5329, 5333, 5336, 5337, 5339, 5340, 5343, 5352, 5353, 5354, 5355, 5356, 5358, 5359, 5361, 5362, 5366, 5371, 5372, 5376, 5377, 5384, 5385, 5386, 5387, 5388, 5389, 5390, 5391, 5396, 5398, 5402, 5404, 5405, 5406, 5407, 5408, 5409, 5411, 5414, 5417, 5424, 5428, 5429, 5430, 5431, 5432, 5439, 5442, 5443, 5446, 5449, 5452, 5454, 5462, 5463, 5465, 5466, 5467, 5468, 5472, 5473, 5474, 5475, 5477, 5482, 5484, 5485, 5486, 5487, 5488, 5489, 5494, 5495, 5496, 5498, 5502, 5508, 5509, 5510, 5511, 5512, 5513, 5516, 5518, 5520, 5525, 5526, 5527, 5529, 5540, 5544, 5545, 5550, 5551, 5554, 5555, 5556, 5558, 5559, 5560, 5568, 5569, 5570, 5572, 5575, 5576, 5578, 5579, 5580, 5581, 5586, 5587, 5589, 5591, 5592, 5593, 5594, 5598, 5602, 5603, 5604, 5608, 5609, 5610, 5613, 5614, 5616, 5618, 5620, 5622, 5623, 5624, 5630, 5631, 5637, 5643, 5646, 5647, 5652, 5653, 5654, 5655, 5657, 5658, 5659, 5662, 5663, 5664, 5665, 5666, 5667, 5668, 5669, 5670, 5671, 5676, 5677, 5678, 5680, 5681, 5682, 5683, 5684, 5685, 5686, 5690, 5691, 5692, 5693, 5698, 5699, 5701, 5702, 5704, 5705, 5706, 5707, 5708, 5711, 5712, 5716, 5721, 5736, 5742, 5747, 5748, 5751, 5752, 5755, 5756, 5758, 5759, 5761, 5763, 5766, 5772, 5774, 5775, 5776, 5788, 5789, 5798, 5803, 5805, 5808, 5811, 5813, 5814, 5815, 5816, 5819, 5820, 5825, 5828, 5829, 5830, 5833, 5837, 5838, 5842, 5844, 5846, 5847, 5849, 5850, 5851, 5852, 5855, 5857, 5872, 5894, 5896, 5908, 5913, 5916, 5917, 5929, 5932, 5933, 5936, 5937, 5938, 5939, 5944, 5950, 5955, 5957, 5965, 5966, 5967, 5968, 5969, 5972, 5973, 5974, 5975, 5976, 5977, 5978, 5979, 5983, 5984, 5985, 5987, 5989, 5992, 5993, 5994, 5995, 6001, 6002, 6003, 6005, 6006, 6008, 6010, 6011, 6013, 6015, 6016, 6018, 6023, 6024, 6028, 6029, 6037, 6041, 6044, 6045, 6046, 6051, 6052, 6053, 6055, 6058, 6059, 6060, 6064, 6065, 6066, 6068, 6069, 6073, 6074, 6075, 6076, 6077, 6079, 6080, 6081, 6083, 6085, 6088, 6089, 6090, 6091, 6093, 6094, 6096, 6097, 6099, 6100, 6101, 6102, 6103, 6107, 6108, 6109, 6114, 6119, 6120, 6122, 6126, 6127, 6128, 6129, 6130, 6133, 6135, 6136, 6137, 6140, 6142, 6143, 6144, 6148, 6150, 6151, 6152, 6156, 6157, 6158, 6161, 6162, 6163, 6164, 6165, 6171, 6172, 6175, 6176, 6179, 6180, 6186, 6189, 6190, 6194, 6196, 6198, 6200, 6202, 6203, 6204, 6205, 6206, 6207, 6208, 6209, 6211, 6212, 6213, 6214, 6215, 6216, 6217, 6218, 6220, 6222, 6224, 6225, 6226, 6227, 6230, 6232, 6235, 6237, 6238, 6240, 6241, 6242, 6243, 6244, 6245, 6249, 6250, 6251, 6255, 6256, 6257, 6259, 6260, 6262, 6266, 6273, 6278, 6280, 6281, 6283, 6284, 6288, 6289, 6293, 6294, 6295, 6297, 6301, 6305, 6306, 6307, 6308, 6309, 6310, 6316, 6317, 6318, 6320, 6322, 6323, 6325, 6327, 6328, 6333, 6335, 6336, 6340, 6342, 6344, 6348, 6352, 6355, 6357, 6359, 6361, 6363, 6364, 6370, 6371, 6373, 6374, 6377, 6378, 6379, 6380, 6382, 6383, 6385, 6386, 6387, 6390, 6391, 6392, 6394, 6395, 6399, 6405, 6408, 6410, 6411, 6414, 6416, 6417, 6418, 6423, 6424, 6425, 6428, 6430, 6431, 6435, 6437, 6439, 6441, 6442, 6443, 6445, 6447, 6448, 6449, 6457, 6458, 6461, 6462, 6463, 6467, 6469, 6470, 6471, 6472, 6473, 6475, 6476, 6477, 6478, 6481, 6482, 6484, 6486, 6489, 6491, 6493, 6500, 6501, 6502, 6503, 6504, 6505, 6507, 6508, 6510, 6511, 6514, 6518, 6519, 6520, 6521, 6522, 6523, 6524, 6525, 6526, 6527, 6530, 6545, 6547, 6548, 6552, 6553, 6554, 6555, 6556, 6557, 6562, 6564, 6565, 6568, 6569, 6571, 6573, 6575, 6576, 6577, 6578, 6580, 6581, 6582, 6583, 6584, 6585, 6589, 6590, 6593, 6594, 6595, 6596, 6598, 6600, 6601, 6602, 6604, 6605, 6606, 6607, 6608, 6609, 6610, 6612, 6613, 6614, 6618, 6619, 6620, 6621, 6622, 6625, 6626, 6627, 6628, 6630, 6631, 6635, 6636, 6637, 6640, 6643, 6644, 6648, 6650, 6653, 6658, 6660, 6661, 6662, 6664, 6666, 6669, 6670, 6671, 6677, 6683, 6685, 6686, 6687, 6688, 6689, 6690, 6694, 6695, 6696, 6697, 6701, 6702, 6708, 6710, 6711, 6715, 6716, 6748, 6753, 6783}",2072,"{0, 1, 2, 3, 4, 5, 6, 7, 8, 9, 10, 11, 12, 14, 15, 16, 17, 18, 20, 21, 22, 23, 24, 25, 27, 28, 29, 30, 31, 32, 33, 34, 35, 36, 37, 38, 39, 42, 43, 44, 45, 46, 47, 48, 49, 50, 51, 52, 53, 54, 55, 56, 57, 58, 59, 60, 61, 62, 64, 65, 66, 67, 68, 69, 70, 71, 72, 73, 74, 75, 78, 79, 80, 81, 83, 84, 85, 86, 88, 89, 90, 91, 92, 93, 94, 95, 96, 97, 98, 99, 100, 101, 102, 103, 104, 105, 106, 107, 108, 109, 110, 111, 112, 113, 114, 116, 118, 123, 124, 125, 126, 127, 128, 129, 130, 131, 132, 133, 134, 135, 136, 137, 138, 139, 140, 141, 143, 144, 145, 146, 147, 148, 149, 150, 151, 153, 154, 155, 156, 158, 159, 160, 161, 162, 163, 164, 165, 166, 167, 168, 169, 171, 172, 175, 176, 179, 180, 181, 182, 183, 184, 185, 186, 187, 188, 189, 190, 191, 192, 193, 194, 195, 196, 198, 199, 200, 201, 202, 203, 204, 205, 206, 207, 208, 209, 210, 211, 212, 213, 214, 215, 216, 217, 218, 219, 220, 221, 222, 223, 224, 225, 226, 227, 228, 229, 230, 231, 232, 234, 235, 236, 237, 238, 239, 240, 241, 242, 243, 244, 245, 246, 247, 248, 249, 250, 251, 252, 253, 254, 256, 257, 258, 259, 260, 261, 262, 263, 264, 265, 266, 267, 268, 269, 271, 272, 273, 274, 275, 276, 277, 278, 279, 280, 281, 282, 283, 284, 285, 286, 287, 288, 289, 290, 291, 292, 293, 294, 295, 296, 297, 298, 300, 301, 302, 303, 305, 307, 310, 311, 312, 313, 314, 315, 316, 317, 318, 321, 322, 323, 324, 325, 326, 327, 331, 332, 333, 334, 335, 336, 337, 338, 339, 340, 341, 342, 343, 344, 345, 346, 348, 349, 350, 351, 352, 353, 356, 357, 358, 359, 360, 361, 362, 363, 364, 365, 366, 367, 368, 369, 370, 372, 373, 375, 376, 377, 378, 379, 380, 382, 383, 384, 385, 386, 387, 388, 389, 390, 391, 392, 393, 394, 395, 396, 397, 398, 399, 400, 401, 402, 403, 404, 405, 406, 407, 408, 409, 410, 411, 414, 415, 416, 417, 418, 419, 420, 421, 422, 423, 424, 425, 426, 427, 428, 429, 430, 431, 433, 434, 435, 436, 437, 438, 439, 440, 441, 443, 444, 445, 446, 447, 449, 450, 451, 452, 453, 454, 456, 457, 458, 459, 460, 461, 462, 463, 464, 466, 467, 468, 469, 470, 471, 473, 474, 475, 476, 477, 478, 479, 481, 482, 483, 484, 486, 487, 488, 489, 490, 491, 492, 493, 494, 495, 496, 497, 498, 499, 500, 501, 502, 503, 504, 505, 506, 508, 509, 510, 511, 512, 513, 514, 515, 516, 518, 519, 520, 521, 522, 523, 524, 525, 526, 527, 528, 530, 531, 533, 534, 535, 536, 537, 538, 539, 540, 541, 542, 543, 544, 545, 546, 547, 548, 549, 550, 551, 552, 553, 554, 555, 556, 557, 558, 559, 560, 561, 562, 563, 565, 566, 567, 568, 569, 570, 571, 572, 573, 574, 575, 576, 577, 578, 580, 582, 583, 584, 585, 586, 590, 591, 593, 594, 596, 597, 598, 599, 600, 601, 602, 603, 604, 605, 606, 607, 608, 610, 611, 612, 613, 614, 616, 617, 618, 620, 621, 622, 623, 624, 625, 626, 627, 628, 629, 631, 632, 633, 634, 635, 636, 637, 638, 639, 640, 641, 642, 643, 644, 645, 646, 647, 648, 649, 650, 651, 652, 653, 654, 655, 656, 657, 658, 659, 660, 661, 662, 663, 664, 665, 666, 667, 668, 669, 670, 671, 672, 673, 674, 675, 676, 677, 678, 679, 680, 681, 682, 683, 684, 685, 686, 687, 688, 689, 690, 693, 695, 696, 697, 698, 699, 700, 701, 702, 703, 704, 705, 706, 707, 708, 709, 710, 711, 712, 713, 714, 715, 716, 717, 718, 719, 720, 721, 722, 723, 724, 725, 726, 727, 728, 729, 730, 731, 732, 733, 734, 735, 736, 737, 738, 739, 740, 741, 742, 743, 744, 745, 746, 748, 749, 750, 751, 752, 753, 754, 755, 756, 757, 758, 759, 760, 761, 762, 763, 764, 765, 766, 767, 768, 769, 770, 771, 773, 774, 775, 776, 777, 778, 779, 780, 781, 782, 783, 784, 785, 786, 787, 788, 789, 790, 791, 792, 794, 795, 796, 797, 798, 799, 800, 801, 802, 803, 804, 805, 806, 807, 808, 809, 810, 811, 812, 813, 814, 815, 816, 817, 819, 820, 821, 824, 825, 826, 828, 829, 830, 831, 832, 833, 834, 835, 836, 837, 838, 839, 840, 841, 842, 843, 844, 845, 846, 847, 848, 849, 850, 851, 852, 854, 855, 856, 857, 858, 859, 860, 861, 862, 864, 865, 866, 867, 868, 869, 870, 871, 872, 873, 874, 875, 876, 877, 878, 879, 880, 881, 882, 883, 884, 885, 886, 887, 888, 889, 890, 891, 892, 893, 894, 895, 896, 897, 898, 899, 900, 901, 902, 903, 904, 905, 906, 907, 908, 909, 910, 911, 912, 913, 914, 915, 916, 917, 918, 919, 920, 921, 922, 923, 924, 925, 926, 927, 928, 929, 930, 931, 932, 933, 935, 936, 937, 939, 940, 941, 942, 943, 944, 945, 946, 947, 948, 949, 950, 951, 952, 953, 954, 955, 956, 957, 958, 959, 960, 961, 962, 963, 964, 965, 966, 967, 968, 969, 970, 971, 972, 973, 974, 975, 976, 977, 978, 979, 980, 981, 982, 983, 984, 985, 986, 987, 988, 990, 991, 992, 993, 994, 996, 997, 999, 1000, 1001, 1002, 1003, 1004, 1005, 1006, 1007, 1008, 1009, 1010, 1011, 1012, 1013, 1014, 1015, 1016, 1017, 1018, 1019, 1020, 1021, 1022, 1023, 1024, 1025, 1026, 1028, 1029, 1030, 1031, 1032, 1033, 1034, 1036, 1037, 1038, 1039, 1040, 1041, 1042, 1043, 1044, 1045, 1046, 1047, 1048, 1050, 1051, 1052, 1053, 1054, 1055, 1056, 1057, 1058, 1059, 1060, 1061, 1063, 1064, 1065, 1066, 1067, 1069, 1070, 1071, 1073, 1074, 1075, 1076, 1077, 1078, 1079, 1080, 1082, 1083, 1085, 1086, 1087, 1088, 1089, 1090, 1092, 1093, 1094, 1095, 1096, 1097, 1098, 1099, 1100, 1101, 1103, 1104, 1105, 1106, 1107, 1108, 1109, 1110, 1111, 1112, 1114, 1115, 1116, 1117, 1118, 1119, 1120, 1122, 1123, 1124, 1125, 1126, 1127, 1128, 1129, 1130, 1131, 1134, 1135, 1136, 1137, 1138, 1142, 1143, 1144, 1146, 1148, 1149, 1150, 1151, 1152, 1153, 1154, 1155, 1156, 1157, 1158, 1159, 1161, 1162, 1163, 1165, 1167, 1169, 1171, 1172, 1173, 1176, 1177, 1179, 1181, 1182, 1183, 1185, 1186, 1190, 1193, 1194, 1195, 1196, 1203, 1204, 1205, 1207, 1210, 1211, 1212, 1213, 1214, 1217, 1218, 1219, 1220, 1221, 1223, 1224, 1226, 1228, 1229, 1231, 1233, 1234, 1235, 1237, 1238, 1242, 1243, 1244, 1247, 1248, 1250, 1251, 1252, 1254, 1255, 1262, 1267, 1269, 1270, 1271, 1272, 1273, 1274, 1275, 1276, 1277, 1278, 1279, 1280, 1281, 1282, 1284, 1285, 1287, 1288, 1289, 1291, 1292, 1298, 1301, 1302, 1303, 1305, 1311, 1317, 1318, 1323, 1324, 1325, 1326, 1328, 1330, 1331, 1332, 1333, 1336, 1337, 1342, 1344, 1347, 1348, 1349, 1351, 1354, 1358, 1359, 1360, 1361, 1362, 1365, 1366, 1369, 1370, 1371, 1373, 1374, 1376, 1377, 1378, 1380, 1382, 1384, 1387, 1388, 1389, 1390, 1391, 1392, 1393, 1394, 1395, 1397, 1399, 1402, 1404, 1405, 1406, 1412, 1413, 1414, 1415, 1418, 1422, 1424, 1426, 1427, 1430, 1431, 1432, 1434, 1436, 1437, 1441, 1442, 1445, 1448, 1449, 1458, 1467, 1468, 1469, 1473, 1474, 1479, 1483, 1487, 1491, 1499, 1502, 1504, 1506, 1509, 1511, 1512, 1514, 1517, 1518, 1520, 1521, 1526, 1527, 1529, 1530, 1534, 1535, 1539, 1542, 1543, 1546, 1548, 1549, 1550, 1551, 1552, 1553, 1556, 1559, 1561, 1562, 1563, 1566, 1567, 1568, 1571, 1573, 1574, 1575, 1576, 1578, 1580, 1581, 1582, 1583, 1584, 1585, 1586, 1588, 1589, 1590, 1591, 1592, 1593, 1594, 1595, 1597, 1601, 1606, 1608, 1610, 1613, 1614, 1615, 1619, 1624, 1625, 1626, 1627, 1628, 1630, 1633, 1635, 1638, 1641, 1643, 1650, 1651, 1652, 1653, 1654, 1655, 1656, 1657, 1658, 1660, 1661, 1662, 1663, 1664, 1665, 1667, 1668, 1671, 1672, 1673, 1674, 1678, 1679, 1680, 1681, 1682, 1683, 1684, 1685, 1686, 1687, 1691, 1693, 1695, 1696, 1699, 1700, 1701, 1702, 1703, 1704, 1706, 1708, 1709, 1710, 1713, 1715, 1717, 1718, 1719, 1721, 1722, 1726, 1727, 1728, 1729, 1730, 1731, 1734, 1736, 1741, 1744, 1745, 1746, 1749, 1752, 1754, 1755, 1757, 1758, 1760, 1764, 1765, 1766, 1769, 1770, 1771, 1772, 1778, 1781, 1784, 1786, 1791, 1792, 1793, 1796, 1797, 1798, 1813, 1822, 1825, 1827, 1829, 1835, 1836, 1840, 1844, 1845, 1847, 1851, 1853, 1854, 1855, 1858, 1859, 1860, 1861, 1862, 1864, 1868, 1869, 1870, 1873, 1877, 1882, 1884, 1885, 1886, 1887, 1888, 1889, 1892, 1893, 1896, 1901, 1902, 1904, 1905, 1907, 1908, 1909, 1910, 1912, 1914, 1915, 1919, 1920, 1921, 1927, 1928, 1929, 1936, 1938, 1940, 1942, 1943, 1944, 1947, 1948, 1949, 1950, 1954, 1955, 1956, 1957, 1959, 1960, 1961, 1964, 1965, 1968, 1969, 1971, 1972, 1973, 1974, 1976, 1977, 1978, 1979, 1980, 1983, 1985, 1986, 1987, 1988, 1992, 1993, 1995, 1996, 2000, 2002, 2004, 2007, 2008, 2010, 2011, 2012, 2014, 2015, 2017, 2020, 2021, 2022, 2025, 2026, 2029, 2030, 2031, 2032, 2033, 2035, 2036, 2037, 2038, 2039, 2041, 2042, 2044, 2049, 2050, 2052, 2053, 2055, 2059, 2063, 2064, 2065, 2068, 2069, 2074, 2076, 2080, 2081, 2084, 2085, 2086, 2088, 2089, 2090, 2091, 2092, 2095, 2096, 2099, 2101, 2102, 2103, 2104, 2106, 2109, 2110, 2112, 2113, 2115, 2116, 2118, 2119, 2120, 2121, 2122, 2124, 2126, 2128, 2129, 2133, 2134, 2135, 2137, 2138, 2140, 2141, 2143, 2144, 2146, 2147, 2148, 2150, 2151, 2153, 2156, 2157, 2159, 2161, 2162, 2163, 2167, 2175, 2178, 2180, 2182, 2183, 2186, 2193, 2195, 2196, 2198, 2200, 2201, 2202, 2203, 2205, 2212, 2215, 2216, 2218, 2219, 2220, 2221, 2224, 2225, 2229, 2230, 2231, 2233, 2234, 2236, 2239, 2240, 2241, 2242, 2244, 2245, 2246, 2247, 2248, 2252, 2253, 2254, 2260, 2262, 2263, 2264, 2266, 2267, 2268, 2272, 2274, 2275, 2276, 2281, 2282, 2283, 2284, 2285, 2287, 2289, 2291, 2292, 2303, 2307, 2310, 2316, 2318, 2319, 2323, 2324, 2325, 2335, 2345, 2346, 2348, 2352, 2355, 2361, 2363, 2364, 2365, 2366, 2374, 2377, 2379, 2381, 2382, 2386, 2388, 2394, 2395, 2397, 2398, 2403, 2406, 2408, 2413, 2415, 2416, 2420, 2421, 2422, 2423, 2425, 2426, 2427, 2429, 2431, 2432, 2433, 2434, 2435, 2436, 2442, 2448, 2449, 2450, 2452, 2453, 2454, 2455, 2456, 2457, 2458, 2459, 2461, 2462, 2464, 2465, 2466, 2470, 2471, 2472, 2473, 2474, 2475, 2476, 2477, 2478, 2481, 2482, 2495, 2496, 2497, 2499, 2500, 2503, 2508, 2509, 2511, 2512, 2518, 2519, 2521, 2523, 2528, 2530, 2532, 2534, 2535, 2536, 2540, 2541, 2543, 2547, 2548, 2549, 2550, 2551, 2554, 2555, 2556, 2558, 2560, 2561, 2564, 2566, 2567, 2568, 2570, 2572, 2574, 2575, 2576, 2577, 2578, 2579, 2580, 2582, 2584, 2585, 2586, 2587, 2590, 2592, 2603, 2604, 2605, 2608, 2609, 2611, 2612, 2614, 2616, 2617, 2620, 2622, 2624, 2626, 2627, 2628, 2630, 2631, 2632, 2637, 2640, 2641, 2643, 2644, 2645, 2646, 2647, 2648, 2649, 2650, 2652, 2653, 2654, 2655, 2656, 2657, 2658, 2659, 2660, 2662, 2664, 2666, 2667, 2669, 2671, 2672, 2673, 2674, 2677, 2679, 2680, 2681, 2682, 2683, 2684, 2685, 2686, 2687, 2688, 2689, 2690, 2691, 2692, 2693, 2694, 2695, 2696, 2697, 2698, 2700, 2701, 2703, 2704, 2705, 2706, 2707, 2708, 2709, 2710, 2711, 2712, 2713, 2716, 2717, 2718, 2720, 2721, 2723, 2725, 2726, 2727, 2728, 2729, 2730, 2732, 2734, 2738, 2739, 2740, 2741, 2744, 2748, 2749, 2750, 2753, 2754, 2755, 2757, 2758, 2759, 2760, 2761, 2762, 2763, 2765, 2766, 2768, 2769, 2772, 2773, 2774, 2775, 2776, 2779, 2780, 2782, 2783, 2784, 2790, 2796, 2797, 2799, 2800, 2801, 2802, 2803, 2804, 2811, 2813, 2814, 2815, 2816, 2818, 2819, 2821, 2823, 2825, 2827, 2833, 2839, 2840, 2842, 2843, 2844, 2846, 2848, 2849, 2850, 2853, 2854, 2858, 2859, 2860, 2862, 2865, 2867, 2868, 2872, 2873, 2874, 2877, 2878, 2880, 2884, 2887, 2888, 2889, 2890, 2893, 2895, 2897, 2898, 2899, 2901, 2902, 2903, 2907, 2908, 2909, 2915, 2919, 2920, 2921, 2924, 2925, 2926, 2931, 2935, 2937, 2942, 2947, 2951, 2952, 2953, 2955, 2959, 2960, 2961, 2962, 2965, 2966, 2967, 2968, 2969, 2970, 2972, 2973, 2976, 2978, 2979, 2980, 2981, 2982, 2983, 2984, 2985, 2986, 2987, 2988, 2989, 2990, 2991, 2992, 2993, 2994, 2995, 2996, 2997, 2998, 2999, 3000, 3001, 3002, 3003, 3004, 3005, 3006, 3007, 3008, 3009, 3010, 3011, 3012, 3014, 3015, 3016, 3017, 3018, 3019, 3020, 3022, 3023, 3024, 3025, 3026, 3027, 3028, 3029, 3030, 3031, 3032, 3033, 3034, 3035, 3036, 3037, 3038, 3039, 3040, 3042, 3043, 3044, 3045, 3046, 3047, 3048, 3049, 3050, 3051, 3052, 3053, 3054, 3055, 3057, 3058, 3059, 3060, 3061, 3062, 3063, 3064, 3065, 3066, 3067, 3068, 3070, 3071, 3072, 3073, 3074, 3075, 3076, 3077, 3079, 3080, 3081, 3082, 3083, 3084, 3086, 3087, 3088, 3089, 3090, 3091, 3093, 3094, 3095, 3096, 3097, 3098, 3099, 3100, 3102, 3103, 3104, 3105, 3106, 3107, 3108, 3109, 3110, 3111, 3112, 3113, 3114, 3115, 3116, 3118, 3119, 3120, 3121, 3122, 3123, 3124, 3125, 3126, 3127, 3128, 3131, 3132, 3134, 3135, 3136, 3137, 3138, 3142, 3143, 3144, 3146, 3147, 3149, 3150, 3151, 3152, 3153, 3155, 3156, 3157, 3158, 3159, 3160, 3162, 3163, 3164, 3165, 3166, 3167, 3169, 3170, 3171, 3172, 3173, 3174, 3175, 3176, 3177, 3178, 3179, 3180, 3181, 3182, 3183, 3184, 3185, 3186, 3187, 3188, 3189, 3190, 3191, 3192, 3193, 3194, 3195, 3196, 3197, 3198, 3199, 3200, 3201, 3202, 3203, 3204, 3205, 3206, 3207, 3208, 3209, 3210, 3211, 3212, 3213, 3214, 3215, 3216, 3217, 3218, 3219, 3223, 3224, 3225, 3226, 3228, 3229, 3231, 3234, 3236, 3241, 3242, 3243, 3244, 3245, 3247, 3248, 3249, 3250, 3252, 3253, 3254, 3255, 3256, 3258, 3260, 3261, 3262, 3265, 3269, 3270, 3271, 3272, 3273, 3276, 3279, 3280, 3281, 3282, 3283, 3285, 3287, 3288, 3289, 3291, 3293, 3294, 3295, 3296, 3300, 3302, 3303, 3304, 3305, 3306, 3307, 3311, 3312, 3313, 3314, 3316, 3318, 3319, 3320, 3321, 3323, 3325, 3326, 3327, 3328, 3330, 3331, 3332, 3333, 3334, 3335, 3337, 3341, 3342, 3343, 3345, 3346, 3347, 3349, 3353, 3354, 3355, 3357, 3358, 3362, 3363, 3367, 3368, 3369, 3373, 3374, 3377, 3378, 3379, 3380, 3384, 3386, 3387, 3388, 3389, 3390, 3391, 3392, 3393, 3394, 3397, 3398, 3400, 3401, 3404, 3405, 3408, 3410, 3412, 3413, 3414, 3415, 3416, 3417, 3418, 3419, 3421, 3422, 3423, 3424, 3426, 3428, 3429, 3430, 3431, 3432, 3435, 3437, 3438, 3439, 3440, 3441, 3442, 3443, 3445, 3447, 3449, 3450, 3451, 3452, 3453, 3459, 3460, 3461, 3465, 3467, 3469, 3470, 3471, 3472, 3473, 3474, 3476, 3477, 3480, 3482, 3483, 3484, 3485, 3486, 3487, 3489, 3490, 3492, 3493, 3495, 3497, 3498, 3500, 3501, 3505, 3506, 3509, 3510, 3511, 3512, 3514, 3515, 3516, 3519, 3521, 3522, 3523, 3527, 3528, 3529, 3530, 3532, 3534, 3539, 3540, 3542, 3543, 3545, 3546, 3547, 3548, 3549, 3550, 3551, 3552, 3553, 3556, 3557, 3558, 3562, 3565, 3566, 3567, 3568, 3569, 3570, 3571, 3573, 3575, 3576, 3578, 3580, 3581, 3582, 3583, 3584, 3585, 3586, 3588, 3589, 3591, 3592, 3593, 3594, 3595, 3596, 3598, 3599, 3600, 3601, 3602, 3603, 3604, 3605, 3606, 3608, 3609, 3610, 3611, 3612, 3613, 3614, 3615, 3616, 3617, 3618, 3620, 3621, 3622, 3623, 3624, 3625, 3626, 3627, 3628, 3629, 3631, 3632, 3633, 3634, 3635, 3636, 3637, 3638, 3639, 3640, 3642, 3644, 3645, 3646, 3647, 3648, 3649, 3650, 3652, 3653, 3655, 3656, 3657, 3660, 3661, 3662, 3663, 3664, 3665, 3666, 3667, 3669, 3670, 3671, 3672, 3673, 3674, 3675, 3676, 3679, 3680, 3681, 3683, 3684, 3685, 3686, 3687, 3688, 3690, 3691, 3692, 3694, 3696, 3697, 3698, 3699, 3701, 3702, 3703, 3707, 3708, 3712, 3713, 3716, 3718, 3719, 3721, 3722, 3724, 3730, 3731, 3733, 3734, 3735, 3737, 3739, 3740, 3743, 3748, 3751, 3752, 3753, 3754, 3756, 3757, 3758, 3759, 3760, 3762, 3768, 3769, 3770, 3773, 3774, 3775, 3781, 3782, 3783, 3784, 3786, 3788, 3790, 3791, 3793, 3796, 3797, 3798, 3800, 3804, 3805, 3810, 3815, 3817, 3821, 3823, 3826, 3831, 3833, 3837, 3838, 3840, 3845, 3853, 3871, 3873, 3877, 3880, 3884, 3894, 3895, 3898, 3899, 3902, 3918, 3921, 3923, 3924, 3927, 3929, 3932, 3934, 3936, 3938, 3939, 3943, 3944, 3945, 3948, 3951, 3955, 3957, 3958, 3960, 3962, 3965, 3967, 3972, 3978, 3985, 3989, 3992, 3995, 3996, 3997, 3999, 4001, 4006, 4007, 4008, 4009, 4010, 4011, 4013, 4014, 4016, 4017, 4018, 4019, 4025, 4026, 4027, 4029, 4030, 4033, 4034, 4039, 4040, 4042, 4044, 4046, 4050, 4053, 4054, 4055, 4058, 4059, 4060, 4062, 4063, 4067, 4070, 4071, 4075, 4076, 4078, 4079, 4080, 4082, 4083, 4084, 4085, 4086, 4087, 4088, 4089, 4092, 4093, 4094, 4095, 4096, 4098, 4099, 4100, 4101, 4102, 4103, 4104, 4105, 4106, 4107, 4109, 4111, 4112, 4113, 4114, 4115, 4116, 4117, 4118, 4119, 4120, 4121, 4122, 4123, 4124, 4125, 4126, 4127, 4128, 4129, 4132, 4133, 4134, 4135, 4136, 4137, 4138, 4139, 4140, 4141, 4142, 4143, 4144, 4145, 4147, 4148, 4149, 4150, 4151, 4152, 4153, 4154, 4155, 4156, 4157, 4158, 4159, 4160, 4161, 4163, 4164, 4165, 4166, 4167, 4168, 4169, 4170, 4171, 4172, 4173, 4174, 4175, 4176, 4177, 4178, 4179, 4181, 4182, 4183, 4184, 4185, 4186, 4187, 4188, 4189, 4190, 4191, 4192, 4193, 4194, 4195, 4196, 4197, 4198, 4200, 4201, 4202, 4203, 4204, 4205, 4206, 4207, 4208, 4209, 4210, 4211, 4212, 4213, 4214, 4215, 4216, 4217, 4218, 4219, 4221, 4222, 4223, 4224, 4225, 4226, 4227, 4228, 4229, 4230, 4231, 4232, 4233, 4234, 4235, 4237, 4238, 4239, 4240, 4241, 4242, 4243, 4244, 4245, 4246, 4247, 4248, 4249, 4250, 4251, 4252, 4253, 4254, 4255, 4256, 4257, 4258, 4259, 4260, 4261, 4262, 4263, 4264, 4265, 4266, 4267, 4269, 4270, 4271, 4272, 4273, 4275, 4276, 4277, 4278, 4279, 4280, 4281, 4283, 4284, 4286, 4287, 4288, 4289, 4290, 4292, 4293, 4294, 4295, 4297, 4298, 4299, 4300, 4301, 4302, 4303, 4304, 4305, 4306, 4307, 4308, 4309, 4310, 4311, 4312, 4313, 4314, 4315, 4316, 4317, 4318, 4319, 4320, 4321, 4322, 4323, 4325, 4326, 4327, 4328, 4329, 4330, 4331, 4333, 4334, 4335, 4336, 4337, 4339, 4340, 4341, 4342, 4343, 4344, 4345, 4346, 4347, 4348, 4349, 4350, 4351, 4352, 4353, 4354, 4356, 4357, 4358, 4359, 4361, 4362, 4363, 4364, 4365, 4366, 4367, 4368, 4369, 4370, 4371, 4372, 4373, 4374, 4375, 4376, 4377, 4378, 4380, 4381, 4382, 4383, 4384, 4385, 4386, 4387, 4388, 4389, 4390, 4391, 4394, 4395, 4396, 4397, 4399, 4400, 4401, 4402, 4403, 4404, 4405, 4406, 4408, 4409, 4410, 4411, 4412, 4413, 4414, 4415, 4416, 4417, 4418, 4420, 4421, 4423, 4424, 4425, 4426, 4427, 4428, 4429, 4430, 4432, 4433, 4434, 4435, 4436, 4437, 4438, 4439, 4440, 4441, 4443, 4444, 4446, 4447, 4448, 4449, 4452, 4453, 4455, 4456, 4457, 4458, 4459, 4460, 4463, 4465, 4466, 4467, 4468, 4471, 4472, 4473, 4474, 4477, 4478, 4479, 4480, 4481, 4492, 4493, 4495, 4498, 4500, 4501, 4502, 4503, 4504, 4506, 4507, 4508, 4509, 4510, 4511, 4512, 4513, 4514, 4515, 4516, 4518, 4519, 4520, 4521, 4522, 4523, 4524, 4525, 4526, 4527, 4528, 4530, 4531, 4532, 4533, 4534, 4535, 4536, 4538, 4539, 4540, 4541, 4542, 4543, 4545, 4548, 4549, 4551, 4552, 4553, 4554, 4556, 4558, 4559, 4564, 4565, 4566, 4567, 4568, 4569, 4570, 4571, 4572, 4573, 4574, 4576, 4580, 4581, 4583, 4584, 4586, 4589, 4590, 4591, 4593, 4595, 4596, 4597, 4599, 4602, 4603, 4604, 4605, 4607, 4608, 4612, 4613, 4615, 4616, 4622, 4623, 4625, 4626, 4627, 4628, 4629, 4630, 4635, 4636, 4639, 4640, 4641, 4645, 4646, 4648, 4650, 4651, 4652, 4655, 4656, 4657, 4658, 4659, 4660, 4661, 4662, 4665, 4666, 4668, 4669, 4670, 4672, 4674, 4675, 4676, 4678, 4679, 4680, 4681, 4684, 4686, 4688, 4689, 4693, 4694, 4697, 4698, 4699, 4700, 4704, 4707, 4718, 4723, 4726, 4728, 4735, 4745, 4747, 4748, 4750, 4752, 4756, 4758, 4759, 4760, 4761, 4762, 4765, 4768, 4771, 4775, 4777, 4781, 4783, 4785, 4788, 4792, 4795, 4797, 4798, 4799, 4800, 4801, 4804, 4805, 4806, 4807, 4813, 4814, 4815, 4816, 4822, 4827, 4828, 4831, 4832, 4834, 4837, 4839, 4842, 4845, 4846, 4849, 4850, 4852, 4853, 4858, 4859, 4860, 4863, 4866, 4867, 4874, 4875, 4876, 4877, 4878, 4879, 4880, 4881, 4882, 4883, 4885, 4888, 4889, 4890, 4891, 4892, 4894, 4895, 4898, 4899, 4900, 4901, 4902, 4903, 4904, 4905, 4907, 4908, 4909, 4910, 4911, 4912, 4915, 4916, 4917, 4918, 4919, 4922, 4926, 4927, 4928, 4935, 4936, 4940, 4942, 4943, 4944, 4945, 4946, 4947, 4948, 4949, 4950, 4951, 4954, 4955, 4957, 4958, 4959, 4960, 4963, 4964, 4965, 4967, 4969, 4970, 4971, 4980, 4981, 4982, 4983, 4984, 4991, 4993, 4995, 4996, 4998, 5000, 5004, 5005, 5007, 5009, 5010, 5015, 5021, 5022, 5023, 5026, 5029, 5032, 5033, 5036, 5037, 5041, 5042, 5047, 5050, 5051, 5052, 5055, 5056, 5058, 5060, 5061, 5063, 5064, 5065, 5069, 5077, 5079, 5083, 5084, 5095, 5100, 5101, 5105, 5106, 5112, 5113, 5115, 5116, 5118, 5119, 5123, 5124, 5125, 5126, 5127, 5128, 5129, 5133, 5134, 5135, 5141, 5144, 5151, 5155, 5157, 5158, 5159, 5161, 5164, 5167, 5168, 5169, 5170, 5172, 5174, 5175, 5179, 5188, 5190, 5192, 5193, 5195, 5196, 5197, 5199, 5204, 5205, 5208, 5209, 5210, 5211, 5212, 5213, 5216, 5217, 5218, 5220, 5221, 5226, 5231, 5232, 5233, 5236, 5237, 5240, 5242, 5249, 5253, 5257, 5258, 5259, 5260, 5261, 5262, 5263, 5264, 5266, 5271, 5272, 5273, 5274, 5276, 5277, 5278, 5279, 5280, 5281, 5282, 5283, 5284, 5286, 5287, 5288, 5292, 5297, 5299, 5300, 5303, 5304, 5306, 5307, 5308, 5309, 5310, 5311, 5312, 5314, 5315, 5317, 5319, 5324, 5325, 5326, 5327, 5330, 5331, 5334, 5335, 5338, 5341, 5342, 5344, 5345, 5346, 5347, 5348, 5350, 5351, 5357, 5363, 5364, 5365, 5367, 5368, 5369, 5370, 5373, 5375, 5378, 5379, 5380, 5381, 5383, 5392, 5393, 5394, 5397, 5399, 5400, 5401, 5403, 5410, 5412, 5413, 5416, 5418, 5419, 5420, 5422, 5423, 5425, 5426, 5427, 5433, 5434, 5435, 5437, 5438, 5440, 5441, 5444, 5445, 5447, 5448, 5450, 5451, 5453, 5455, 5456, 5457, 5458, 5459, 5460, 5461, 5464, 5469, 5470, 5471, 5476, 5478, 5479, 5480, 5481, 5483, 5490, 5491, 5492, 5493, 5497, 5499, 5500, 5501, 5503, 5504, 5505, 5506, 5507, 5514, 5515, 5517, 5519, 5521, 5522, 5523, 5524, 5530, 5531, 5532, 5533, 5534, 5535, 5536, 5537, 5538, 5539, 5541, 5542, 5543, 5547, 5548, 5549, 5552, 5557, 5561, 5562, 5563, 5564, 5565, 5566, 5567, 5571, 5573, 5574, 5577, 5582, 5583, 5584, 5585, 5588, 5590, 5595, 5596, 5597, 5600, 5601, 5605, 5606, 5607, 5612, 5615, 5617, 5625, 5626, 5627, 5628, 5629, 5633, 5634, 5635, 5636, 5639, 5640, 5642, 5645, 5648, 5649, 5650, 5651, 5656, 5660, 5661, 5672, 5673, 5674, 5679, 5688, 5689, 5694, 5695, 5696, 5697, 5700, 5703, 5709, 5713, 5714, 5717, 5718, 5720, 5722, 5723, 5724, 5726, 5728, 5729, 5730, 5731, 5732, 5733, 5734, 5735, 5737, 5739, 5740, 5741, 5743, 5744, 5745, 5746, 5749, 5753, 5754, 5757, 5760, 5762, 5764, 5765, 5767, 5768, 5769, 5771, 5773, 5777, 5778, 5779, 5780, 5781, 5782, 5783, 5784, 5785, 5786, 5787, 5791, 5792, 5793, 5794, 5795, 5796, 5797, 5799, 5800, 5801, 5802, 5804, 5806, 5809, 5810, 5817, 5821, 5822, 5823, 5826, 5827, 5831, 5832, 5834, 5835, 5836, 5839, 5840, 5841, 5843, 5848, 5853, 5854, 5856, 5858, 5859, 5860, 5861, 5862, 5863, 5864, 5865, 5866, 5868, 5869, 5870, 5871, 5874, 5875, 5876, 5877, 5878, 5880, 5881, 5882, 5883, 5884, 5886, 5887, 5888, 5889, 5890, 5891, 5892, 5893, 5895, 5897, 5898, 5899, 5900, 5901, 5902, 5903, 5904, 5905, 5907, 5909, 5910, 5912, 5914, 5915, 5918, 5919, 5920, 5921, 5922, 5924, 5925, 5926, 5927, 5928, 5934, 5935, 5940, 5942, 5943, 5945, 5946, 5947, 5948, 5949, 5952, 5953, 5954, 5956, 5960, 5962, 5963, 5970, 5971, 5980, 5981, 5986, 5988, 5991, 5996, 5997, 5998, 5999, 6000, 6004, 6007, 6009, 6012, 6017, 6019, 6021, 6022, 6025, 6027, 6030, 6031, 6032, 6034, 6036, 6040, 6042, 6043, 6047, 6048, 6049, 6056, 6057, 6061, 6063, 6067, 6070, 6071, 6072, 6078, 6084, 6086, 6087, 6092, 6095, 6104, 6105, 6106, 6111, 6112, 6113, 6115, 6116, 6117, 6121, 6123, 6124, 6131, 6132, 6134, 6139, 6141, 6145, 6146, 6147, 6149, 6153, 6154, 6155, 6159, 6160, 6166, 6167, 6168, 6169, 6170, 6173, 6174, 6178, 6181, 6182, 6183, 6184, 6185, 6187, 6191, 6192, 6193, 6195, 6197, 6201, 6210, 6221, 6223, 6228, 6229, 6231, 6233, 6234, 6236, 6239, 6246, 6247, 6248, 6252, 6253, 6254, 6258, 6261, 6263, 6264, 6265, 6267, 6269, 6270, 6271, 6272, 6274, 6275, 6276, 6277, 6279, 6282, 6285, 6286, 6287, 6290, 6291, 6292, 6296, 6298, 6300, 6302, 6303, 6304, 6311, 6313, 6314, 6315, 6319, 6321, 6324, 6326, 6329, 6330, 6331, 6332, 6334, 6338, 6339, 6341, 6343, 6345, 6346, 6347, 6349, 6350, 6351, 6353, 6354, 6356, 6358, 6360, 6362, 6369, 6372, 6375, 6376, 6381, 6384, 6388, 6389, 6393, 6396, 6401, 6402, 6404, 6407, 6412, 6413, 6415, 6419, 6420, 6421, 6422, 6426, 6427, 6429, 6433, 6434, 6436, 6438, 6440, 6444, 6446, 6450, 6452, 6453, 6454, 6455, 6460, 6464, 6468, 6474, 6479, 6483, 6485, 6487, 6488, 6492, 6494, 6495, 6496, 6497, 6498, 6499, 6506, 6509, 6512, 6513, 6515, 6516, 6517, 6528, 6529, 6531, 6532, 6533, 6534, 6535, 6536, 6537, 6538, 6539, 6540, 6541, 6542, 6543, 6544, 6558, 6559, 6560, 6561, 6563, 6566, 6570, 6572, 6579, 6586, 6587, 6591, 6592, 6597, 6603, 6611, 6615, 6616, 6617, 6623, 6624, 6629, 6632, 6633, 6634, 6639, 6641, 6642, 6645, 6646, 6647, 6649, 6651, 6652, 6654, 6655, 6656, 6657, 6659, 6663, 6665, 6667, 6668, 6672, 6673, 6675, 6676, 6678, 6679, 6680, 6681, 6682, 6684, 6691, 6692, 6693, 6698, 6699, 6700, 6703, 6704, 6705, 6706, 6707, 6709, 6712, 6713, 6714, 6717, 6718, 6719, 6720, 6721, 6722, 6723, 6724, 6725, 6726, 6727, 6728, 6729, 6730, 6731, 6732, 6733, 6734, 6735, 6736, 6737, 6738, 6739, 6740, 6741, 6742, 6743, 6744, 6745, 6747, 6750, 6751, 6752, 6754, 6755, 6756, 6757, 6759, 6760, 6762, 6764, 6765, 6766, 6767, 6768, 6769, 6770, 6771, 6773, 6774, 6775, 6776, 6777, 6778, 6779, 6780, 6781, 6782, 6784, 6785, 6786, 6787, 6788, 6789, 6790, 6791, 6792, 6793}",4188
4,"(('exit', ('Request For Payment APPROVED by ADMINISTRATION', 'Request For Payment APPROVED by BUDGET OWNER')),)",1,26,"{1081, 1086, 1087, 1110, 1111, 1113, 1119, 1132, 1133, 1139, 1141, 1143, 1144, 1146, 1154, 1157, 1159, 1166, 1168, 1173, 1174, 1175, 1178, 1189, 1191, 1192, 1193, 1194, 1195, 1202, 1206, 1211, 1212, 1217, 1220, 1224, 1226, 1227, 1232, 1235, 1236, 1243, 1245, 1248, 1249, 1251, 1252, 1253, 1258, 1259, 1260, 1262, 1264, 1267, 1269, 1270, 1271, 1278, 1279, 1283, 1286, 1288, 1289, 1292, 1293, 1295, 1296, 1298, 1299, 1303, 1306, 1316, 1317, 1326, 1329, 1333, 1337, 1339, 1340, 1343, 1344, 1348, 1350, 1351, 1352, 1354, 1355, 1356, 1358, 1359, 1361, 1362, 1364, 1366, 1371, 1372, 1375, 1376, 1381, 1383, 1384, 1394, 1399, 1400, 1403, 1407, 1408, 1411, 1412, 1416, 1418, 1419, 1422, 1426, 1427, 1428, 1433, 1436, 1437, 1445, 1447, 1449, 1451, 1463, 1465, 1466, 1474, 1475, 1479, 1481, 1482, 1488, 1492, 1494, 1500, 1506, 1514, 1517, 1519, 1525, 1527, 1529, 1534, 1535, 1539, 1541, 1548, 1550, 1557, 1559, 1561, 1564, 1570, 1571, 1572, 1575, 1576, 1577, 1585, 1586, 1590, 1599, 1600, 1603, 1608, 1609, 1613, 1615, 1616, 1617, 1618, 1623, 1626, 1631, 1632, 1634, 1635, 1636, 1638, 1641, 1649, 1650, 1651, 1652, 1653, 1654, 1656, 1657, 1659, 1660, 1664, 1668, 1672, 1673, 1675, 1676, 1679, 1680, 1684, 1685, 1686, 1688, 1689, 1690, 1692, 1695, 1696, 1697, 1698, 1703, 1705, 1711, 1719, 1720, 1721, 1722, 1723, 1724, 1725, 1729, 1734, 1735, 1738, 1740, 1741, 1742, 1747, 1749, 1755, 1759, 1762, 1765, 1766, 1767, 1768, 1770, 1781, 1782, 1783, 1784, 1785, 1787, 1788, 1789, 1791, 1792, 1793, 1795, 1797, 1798, 1800, 1806, 1807, 1809, 1813, 1815, 1816, 1820, 1823, 1824, 1826, 1832, 1833, 1838, 1839, 1844, 1845, 1846, 1851, 1852, 1853, 1854, 1855, 1857, 1858, 1860, 1861, 1862, 1864, 1866, 1868, 1872, 1873, 1876, 1877, 1879, 1882, 1884, 1887, 1889, 1890, 1891, 1894, 1899, 1904, 1908, 1914, 1916, 1925, 1926, 1927, 1930, 1932, 1936, 1938, 1939, 1942, 1943, 1949, 1950, 1952, 1954, 1959, 1961, 1963, 1966, 1970, 1973, 1974, 1975, 1977, 1980, 1982, 1984, 1985, 1988, 1990, 1991, 1995, 1998, 2003, 2008, 2009, 2012, 2014, 2015, 2016, 2018, 2021, 2022, 2027, 2028, 2029, 2030, 2035, 2036, 2037, 2038, 2042, 2045, 2046, 2055, 2057, 2058, 2059, 2060, 2061, 2062, 2066, 2067, 2068, 2069, 2070, 2076, 2081, 2086, 2088, 2089, 2090, 2092, 2095, 2096, 2097, 2098, 2099, 2101, 2102, 2104, 2106, 2107, 2108, 2110, 2112, 2118, 2120, 2123, 2132, 2139, 2140, 2142, 2146, 2147, 2149, 2152, 2153, 2156, 2160, 2161, 2162, 2163, 2170, 2171, 2179, 2184, 2185, 2187, 2190, 2192, 2193, 2198, 2206, 2207, 2208, 2212, 2215, 2217, 2220, 2221, 2224, 2225, 2228, 2229, 2231, 2233, 2236, 2240, 2243, 2245, 2249, 2250, 2266, 2267, 2270, 2271, 2273, 2274, 2275, 2276, 2281, 2282, 2283, 2290, 2298, 2300, 2301, 2307, 2309, 2311, 2312, 2316, 2317, 2318, 2319, 2322, 2323, 2325, 2330, 2332, 2333, 2334, 2335, 2339, 2340, 2344, 2347, 2355, 2356, 2361, 2362, 2367, 2368, 2369, 2371, 2376, 2378, 2379, 2381, 2382, 2384, 2394, 2395, 2399, 2402, 2406, 2413, 2414, 2415, 2419, 2424, 2431, 2432, 2433, 2434, 2435, 2436, 2438, 2439, 2441, 2442, 2444, 2445, 2446, 2449, 2456, 2457, 2458, 2461, 2462, 2463, 2464, 2465, 2467, 2469, 2474, 2479, 2483, 2499, 2500, 2505, 2506, 2509, 2512, 2513, 2514, 2521, 2532, 2533, 2534, 2536, 2537, 2538, 2541, 2542, 2546, 2547, 2548, 2549, 2550, 2555, 2556, 2558, 2560, 2563, 2566, 2567, 2568, 2572, 2575, 2576, 2577, 2578, 2581, 2582, 2583, 2585, 2587, 2590, 2594, 2598, 2600, 2601, 2605, 2609, 2610, 2611, 2612, 2613, 2617, 2621, 2626, 2630, 2631, 2632, 2639, 2641, 2642, 2644, 2645, 2646, 2647, 2649, 2654, 2655, 2657, 2658, 2659, 2664, 2668, 2671, 2674, 2682, 2684, 2689, 2691, 2695, 2706, 2709, 2711, 2715, 2716, 2721, 2723, 2725, 2726, 2728, 2729, 2730, 2731, 2737, 2741, 2744, 2749, 2750, 2751, 2761, 2762, 2764, 2766, 2769, 2775, 2776, 2780, 2785, 2786, 2791, 2796, 2797, 2798, 2799, 2801, 2803, 2805, 2806, 2807, 2809, 2812, 2814, 2815, 2816, 2818, 2822, 2823, 2825, 2826, 2827, 2834, 2839, 2840, 2844, 2848, 2849, 2852, 2853, 2854, 2871, 2874, 2875, 2880, 2884, 2886, 2889, 2890, 2892, 2893, 2894, 2895, 2896, 2902, 2903, 2905, 2906, 2907, 2915, 2919, 2920, 2925, 2927, 2933, 2935, 2937, 2939, 2940, 2951, 2955, 2956, 2957, 2960, 2961, 2966, 2968, 2972, 2973, 2978, 2981, 2988, 2990, 2994, 2996, 3000, 3002, 3003, 3007, 3009, 3011, 3014, 3017, 3019, 3032, 3033, 3035, 3037, 3044, 3045, 3051, 3054, 3055, 3064, 3065, 3068, 3074, 3083, 3090, 3095, 3096, 3099, 3102, 3105, 3106, 3110, 3118, 3120, 3127, 3133, 3138, 3139, 3141, 3143, 3149, 3150, 3153, 3158, 3162, 3167, 3169, 3173, 3177, 3183, 3185, 3186, 3189, 3190, 3191, 3193, 3194, 3201, 3203, 3204, 3207, 3208, 3209, 3211, 3214, 3222, 3223, 3225, 3229, 3233, 3245, 3250, 3251, 3257, 3258, 3259, 3261, 3270, 3272, 3280, 3281, 3282, 3286, 3299, 3301, 3303, 3310, 3311, 3312, 3313, 3314, 3316, 3317, 3321, 3322, 3327, 3329, 3332, 3333, 3334, 3336, 3337, 3339, 3340, 3342, 3344, 3345, 3347, 3352, 3353, 3354, 3356, 3360, 3362, 3367, 3374, 3376, 3379, 3384, 3386, 3388, 3389, 3392, 3401, 3408, 3412, 3415, 3419, 3421, 3424, 3427, 3430, 3431, 3432, 3433, 3434, 3436, 3441, 3443, 3445, 3448, 3450, 3451, 3455, 3457, 3461, 3472, 3473, 3477, 3484, 3486, 3488, 3489, 3491, 3492, 3500, 3501, 3510, 3511, 3512, 3513, 3519, 3521, 3528, 3530, 3533, 3534, 3535, 3539, 3540, 3543, 3545, 3558, 3562, 3567, 3570, 3571, 3572, 3573, 3574, 3575, 3585, 3588, 3603, 3606, 3607, 3609, 3616, 3617, 3618, 3623, 3624, 3626, 3628, 3630, 3631, 3634, 3636, 3637, 3638, 3639, 3647, 3648, 3649, 3655, 3656, 3657, 3661, 3662, 3663, 3666, 3668, 3670, 3671, 3673, 3675, 3678, 3679, 3685, 3687, 3690, 3691, 3693, 3698, 3700, 3701, 3702, 3703, 3704, 3705, 3706, 3709, 3719, 3724, 3730, 3732, 3734, 3736, 3738, 3739, 3748, 3750, 3756, 3761, 3763, 3764, 3766, 3769, 3772, 3774, 3777, 3781, 3784, 3786, 3789, 3790, 3794, 3797, 3799, 3801, 3804, 3813, 3818, 3819, 3820, 3821, 3823, 3825, 3827, 3829, 3830, 3831, 3832, 3833, 3837, 3838, 3843, 3844, 3856, 3857, 3858, 3868, 3870, 3873, 3875, 3894, 3895, 3896, 3897, 3899, 3903, 3907, 3910, 3920, 3923, 3925, 3927, 3935, 3936, 3938, 3939, 3940, 3947, 3948, 3950, 3953, 3957, 3958, 3960, 3962, 3965, 3967, 3969, 3973, 3975, 3976, 3977, 3978, 3985, 3986, 3990, 3991, 3994, 3996, 3997, 3998, 4000, 4002, 4004, 4005, 4006, 4007, 4008, 4009, 4019, 4026, 4027, 4029, 4030, 4031, 4034, 4046, 4047, 4049, 4050, 4054, 4055, 4061, 4062, 4063, 4076, 4079, 4080, 4082, 4087, 4089, 4096, 4100, 4101, 4102, 4103, 4105, 4116, 4117, 4119, 4122, 4123, 4125, 4126, 4131, 4138, 4140, 4141, 4143, 4154, 4155, 4158, 4159, 4161, 4163, 4166, 4167, 4169, 4183, 4184, 4188, 4191, 4194, 4196, 4197, 4200, 4206, 4208, 4212, 4214, 4215, 4216, 4223, 4224, 4226, 4228, 4233, 4238, 4241, 4242, 4244, 4246, 4249, 4250, 4253, 4256, 4258, 4262, 4263, 4270, 4273, 4275, 4277, 4278, 4279, 4280, 4286, 4289, 4290, 4293, 4297, 4299, 4304, 4308, 4309, 4314, 4315, 4316, 4317, 4318, 4319, 4320, 4321, 4325, 4327, 4330, 4331, 4333, 4335, 4336, 4342, 4345, 4349, 4352, 4358, 4363, 4364, 4368, 4370, 4371, 4372, 4375, 4377, 4379, 4381, 4382, 4386, 4388, 4392, 4398, 4399, 4401, 4407, 4409, 4411, 4413, 4417, 4420, 4422, 4425, 4426, 4427, 4430, 4432, 4433, 4435, 4438, 4440, 4441, 4445, 4447, 4460, 4461, 4463, 4468, 4469, 4471, 4472, 4478, 4492, 4493, 4494, 4497, 4508, 4509, 4510, 4518, 4524, 4527, 4536, 4540, 4543, 4544, 4553, 4554, 4563, 4564, 4565, 4571, 4572, 4573, 4574, 4576, 4578, 4580, 4582, 4585, 4586, 4587, 4589, 4590, 4591, 4594, 4596, 4597, 4602, 4603, 4606, 4607, 4608, 4610, 4613, 4614, 4616, 4618, 4619, 4620, 4621, 4624, 4626, 4627, 4629, 4632, 4633, 4634, 4643, 4644, 4650, 4653, 4655, 4656, 4662, 4665, 4667, 4669, 4673, 4677, 4682, 4683, 4684, 4692, 4694, 4702, 4723, 4725, 4726, 4732, 4733, 4734, 4735, 4737, 4738, 4741, 4754, 4756, 4758, 4759, 4760, 4763, 4768, 4770, 4771, 4772, 4775, 4776, 4778, 4780, 4783, 4789, 4801, 4803, 4804, 4806, 4813, 4816, 4817, 4818, 4819, 4820, 4822, 4826, 4830, 4831, 4838, 4839, 4840, 4841, 4847, 4852, 4853, 4858, 4864, 4865, 4866, 4867, 4875, 4878, 4881, 4883, 4884, 4887, 4890, 4895, 4897, 4899, 4900, 4902, 4916, 4917, 4918, 4922, 4924, 4925, 4928, 4932, 4933, 4934, 4936, 4938, 4939, 4943, 4944, 4945, 4946, 4947, 4952, 4953, 4956, 4957, 4960, 4961, 4965, 4967, 4977, 4978, 4979, 4986, 4988, 4989, 4990, 4991, 4993, 4994, 4996, 4997, 4999, 5001, 5010, 5013, 5016, 5022, 5026, 5028, 5031, 5034, 5035, 5046, 5048, 5049, 5050, 5053, 5061, 5062, 5064, 5065, 5069, 5071, 5073, 5074, 5076, 5078, 5079, 5098, 5099, 5100, 5101, 5102, 5103, 5104, 5106, 5111, 5112, 5113, 5116, 5131, 5138, 5139, 5144, 5148, 5151, 5152, 5156, 5159, 5165, 5168, 5172, 5175, 5179, 5181, 5186, 5188, 5192, 5193, 5200, 5204, 5206, 5207, 5208, 5213, 5216, 5218, 5219, 5233, 5240, 5241, 5245, 5247, 5249, 5250, 5251, 5252, 5256, 5261, 5266, 5271, 5272, 5276, 5277, 5280, 5282, 5285, 5286, 5289, 5290, 5294, 5295, 5298, 5299, 5306, 5309, 5310, 5311, 5313, 5317, 5324, 5325, 5326, 5329, 5331, 5335, 5338, 5341, 5348, 5350, 5351, 5352, 5355, 5356, 5358, 5359, 5363, 5366, 5367, 5381, 5386, 5393, 5396, 5398, 5400, 5401, 5405, 5410, 5417, 5424, 5431, 5432, 5433, 5434, 5435, 5439, 5451, 5455, 5456, 5465, 5467, 5470, 5472, 5473, 5475, 5478, 5479, 5488, 5492, 5494, 5495, 5497, 5498, 5499, 5500, 5503, 5507, 5508, 5509, 5510, 5517, 5519, 5524, 5525, 5526, 5527, 5531, 5532, 5533, 5542, 5547, 5550, 5552, 5554, 5555, 5556, 5559, 5560, 5563, 5564, 5565, 5566, 5567, 5568, 5569, 5570, 5572, 5574, 5578, 5580, 5586, 5588, 5596, 5597, 5604, 5605, 5612, 5613, 5616, 5620, 5623, 5624, 5625, 5626, 5627, 5629, 5632, 5633, 5634, 5635, 5636, 5643, 5646, 5649, 5658, 5661, 5674, 5676, 5682, 5684, 5685, 5688, 5695, 5697, 5702, 5704, 5706, 5708, 5711, 5713, 5717, 5718, 5731, 5732, 5733, 5734, 5735, 5740, 5753, 5757, 5760, 5764, 5765, 5767, 5769, 5771, 5775, 5777, 5780, 5782, 5783, 5787, 5799, 5800, 5801, 5804, 5805, 5806, 5810, 5820, 5821, 5822, 5825, 5826, 5827, 5829, 5831, 5833, 5835, 5836, 5839, 5840, 5841, 5842, 5843, 5846, 5847, 5850, 5852, 5856, 5857, 5858, 5859, 5863, 5869, 5870, 5871, 5872, 5875, 5876, 5877, 5878, 5880, 5883, 5884, 5889, 5890, 5891, 5893, 5894, 5895, 5896, 5901, 5904, 5908, 5914, 5917, 5919, 5924, 5926, 5929, 5937, 5938, 5946, 5969, 5972, 5973, 5974, 5975, 5976, 5977, 5978, 5981, 5986, 5990, 5991, 5999, 6001, 6005, 6009, 6015, 6016, 6018, 6019, 6022, 6024, 6030, 6031, 6036, 6037, 6041, 6047, 6048, 6056, 6057, 6059, 6060, 6061, 6063, 6065, 6067, 6068, 6070, 6074, 6075, 6076, 6077, 6080, 6085, 6087, 6090, 6092, 6095, 6101, 6102, 6104, 6111, 6114, 6116, 6119, 6120, 6121, 6124, 6126, 6128, 6129, 6131, 6135, 6136, 6137, 6140, 6141, 6145, 6146, 6164, 6165, 6175, 6176, 6178, 6179, 6189, 6194, 6196, 6200, 6203, 6204, 6205, 6206, 6208, 6209, 6210, 6211, 6212, 6213, 6214, 6215, 6216, 6217, 6218, 6219, 6220, 6221, 6222, 6225, 6226, 6227, 6228, 6229, 6231, 6232, 6233, 6248, 6250, 6252, 6257, 6262, 6272, 6273, 6274, 6278, 6279, 6280, 6286, 6289, 6292, 6295, 6296, 6298, 6302, 6311, 6314, 6316, 6317, 6319, 6325, 6328, 6334, 6336, 6338, 6340, 6343, 6350, 6353, 6358, 6360, 6362, 6363, 6365, 6373, 6374, 6378, 6379, 6380, 6381, 6382, 6383, 6384, 6385, 6387, 6389, 6390, 6391, 6392, 6395, 6396, 6402, 6419, 6420, 6421, 6425, 6427, 6429, 6435, 6437, 6439, 6442, 6446, 6448, 6450, 6453, 6455, 6457, 6468, 6469, 6476, 6481, 6482, 6489, 6493, 6497, 6500, 6501, 6503, 6505, 6511, 6512, 6513, 6515, 6518, 6519, 6520, 6521, 6522, 6523, 6524, 6525, 6530, 6536, 6537, 6538, 6539, 6540, 6541, 6542, 6544, 6554, 6555, 6556, 6558, 6562, 6563, 6564, 6565, 6567, 6568, 6569, 6570, 6573, 6575, 6576, 6584, 6591, 6592, 6594, 6595, 6596, 6597, 6600, 6601, 6603, 6606, 6607, 6608, 6610, 6612, 6615, 6616, 6617, 6620, 6623, 6624, 6625, 6630, 6631, 6634, 6636, 6639, 6640, 6641, 6642, 6646, 6650, 6658, 6662, 6665, 6667, 6668, 6670, 6673, 6675, 6676, 6678, 6679, 6683, 6684, 6685, 6691, 6692, 6695, 6700, 6706, 6709, 6711, 6712, 6716, 6720, 6721, 6722, 6723, 6726, 6727, 6729, 6730, 6731, 6732, 6734, 6735, 6736, 6737, 6744, 6747, 6752, 6754, 6757, 6762, 6768, 6771, 6774, 6782, 6786, 6787, 6792, 6793}",1989,"{4096, 4100, 4101, 4102, 4103, 2057, 2058, 2059, 2060, 2061, 2062, 2066, 2067, 6164, 2070, 2076, 2081, 6179, 2086, 2088, 6194, 4154, 4155, 6203, 6204, 6206, 6208, 6209, 6210, 6211, 6212, 6213, 6214, 6215, 4169, 6218, 6219, 6220, 6227, 6231, 6232, 4194, 4212, 4228, 6278, 6279, 6286, 4241, 4242, 6289, 4244, 6295, 6296, 6298, 4253, 6302, 6316, 6317, 4273, 6325, 6328, 6336, 4290, 6338, 6340, 6350, 6353, 4308, 6358, 6362, 6374, 6379, 6381, 6382, 6383, 6384, 6389, 6390, 6396, 6402, 4358, 2319, 6419, 6420, 6421, 6425, 6427, 6429, 6435, 6437, 6439, 6442, 4398, 6446, 6448, 6450, 6453, 6457, 6468, 6469, 6482, 6500, 6501, 6503, 2413, 6511, 6515, 6555, 6558, 6562, 6563, 6564, 6565, 6569, 6570, 4527, 6575, 6576, 6591, 6592, 6594, 6595, 6596, 6597, 6600, 6601, 6603, 6606, 6607, 6608, 2513, 6610, 6612, 6615, 6620, 6623, 6624, 6625, 2532, 2533, 6630, 6631, 2536, 6634, 2538, 6636, 2541, 2542, 6639, 6640, 6641, 6642, 6650, 2555, 4607, 6658, 2563, 6662, 2566, 2567, 6665, 2568, 6667, 2572, 6670, 6673, 2578, 6675, 6676, 4626, 6678, 6679, 4627, 2585, 6683, 6684, 6685, 6692, 6695, 4656, 2613, 4677, 2641, 4692, 4702, 4734, 4741, 4770, 4772, 4776, 4780, 4803, 4817, 4838, 4840, 2797, 4847, 2807, 2809, 2812, 4864, 4865, 2818, 2822, 2825, 2826, 2827, 2834, 4884, 2839, 2840, 2844, 2848, 2849, 4897, 2853, 2854, 4932, 4939, 4947, 4953, 4961, 4978, 4979, 4988, 4991, 4994, 4996, 4997, 4999, 5001, 5013, 5016, 5022, 5026, 5028, 5031, 5034, 5035, 5048, 5061, 5062, 3017, 5069, 5071, 5073, 5074, 5076, 5078, 5079, 5098, 5099, 5100, 5101, 5102, 5106, 5116, 5139, 5148, 5152, 5159, 5175, 5188, 5192, 5193, 5204, 5206, 5208, 5216, 5218, 5219, 1132, 5233, 5250, 1166, 1226, 1227, 1249, 3301, 1262, 1278, 1288, 1293, 1296, 3354, 1316, 1329, 1333, 1337, 1339, 1340, 1344, 1348, 1351, 3401, 1354, 1356, 1358, 1359, 5470, 3434, 3448, 3451, 3457, 5507, 5508, 5509, 3472, 5524, 5525, 5526, 5531, 5532, 3489, 3492, 3501, 5550, 5555, 3510, 5563, 5564, 5565, 5566, 5567, 3521, 5572, 5580, 3533, 3534, 3535, 1488, 3540, 3545, 5596, 5597, 5604, 5613, 5620, 1525, 5623, 5624, 5625, 5626, 5627, 1527, 5633, 5643, 5646, 1550, 5649, 1559, 5658, 1576, 1577, 5674, 5676, 1585, 1586, 5685, 5688, 5695, 1603, 5704, 1608, 5706, 5708, 1613, 1615, 1616, 1617, 1618, 5713, 5717, 5718, 1623, 1626, 3678, 3679, 1634, 5731, 1636, 3685, 5732, 3687, 1638, 5733, 3693, 3698, 3702, 1654, 3704, 1657, 1660, 1668, 1672, 1675, 1676, 5771, 1679, 1680, 3732, 1685, 1686, 5787, 1692, 5799, 5800, 5801, 5804, 5805, 3769, 5822, 3777, 5829, 5831, 3789, 5843, 5846, 5847, 5850, 1755, 3804, 5852, 5856, 5857, 5859, 5863, 3819, 3823, 5871, 1781, 1782, 1783, 5877, 3833, 5878, 5883, 1788, 3837, 1789, 1791, 1792, 1793, 1795, 1798, 5895, 1800, 1806, 1807, 3856, 1809, 1813, 1815, 1816, 1820, 1823, 1824, 3873, 1826, 5929, 3894, 3895, 3897, 1851, 3907, 5969, 3923, 5972, 5973, 5974, 5975, 5976, 5977, 5978, 3935, 3938, 3939, 5990, 5991, 3948, 5999, 3958, 3967, 3973, 6022, 6024, 3977, 3978, 3985, 4000, 1954, 4004, 4005, 6056, 1961, 4019, 1974, 1975, 4026, 4027, 6076, 4029, 4031, 6090, 4046, 4047, 1998, 4049, 4050, 4054, 4063, 6114, 2021, 6120, 2027, 2028, 4082, 2035, 2036, 2037, 2038, 6131, 6136, 6137}",524,"{1081, 1086, 1087, 1110, 1111, 1113, 1119, 1133, 1139, 1141, 1143, 1144, 1146, 1154, 1157, 1159, 1168, 1173, 1174, 1175, 1178, 1189, 1191, 1192, 1193, 1194, 1195, 1202, 1206, 1211, 1212, 1217, 1220, 1224, 1232, 1235, 1236, 1243, 1245, 1248, 1251, 1252, 1253, 1258, 1259, 1260, 1264, 1267, 1269, 1270, 1271, 1279, 1283, 1286, 1289, 1292, 1295, 1298, 1299, 1303, 1306, 1317, 1326, 1343, 1350, 1352, 1355, 1361, 1362, 1364, 1366, 1371, 1372, 1375, 1376, 1381, 1383, 1384, 1394, 1399, 1400, 1403, 1407, 1408, 1411, 1412, 1416, 1418, 1419, 1422, 1426, 1427, 1428, 1433, 1436, 1437, 1445, 1447, 1449, 1451, 1463, 1465, 1466, 1474, 1475, 1479, 1481, 1482, 1492, 1494, 1500, 1506, 1514, 1517, 1519, 1529, 1534, 1535, 1539, 1541, 1548, 1557, 1561, 1564, 1570, 1571, 1572, 1575, 1590, 1599, 1600, 1609, 1631, 1632, 1635, 1641, 1649, 1650, 1651, 1652, 1653, 1656, 1659, 1664, 1673, 1684, 1688, 1689, 1690, 1695, 1696, 1697, 1698, 1703, 1705, 1711, 1719, 1720, 1721, 1722, 1723, 1724, 1725, 1729, 1734, 1735, 1738, 1740, 1741, 1742, 1747, 1749, 1759, 1762, 1765, 1766, 1767, 1768, 1770, 1784, 1785, 1787, 1797, 1832, 1833, 1838, 1839, 1844, 1845, 1846, 1852, 1853, 1854, 1855, 1857, 1858, 1860, 1861, 1862, 1864, 1866, 1868, 1872, 1873, 1876, 1877, 1879, 1882, 1884, 1887, 1889, 1890, 1891, 1894, 1899, 1904, 1908, 1914, 1916, 1925, 1926, 1927, 1930, 1932, 1936, 1938, 1939, 1942, 1943, 1949, 1950, 1952, 1959, 1963, 1966, 1970, 1973, 1977, 1980, 1982, 1984, 1985, 1988, 1990, 1991, 1995, 2003, 2008, 2009, 2012, 2014, 2015, 2016, 2018, 2022, 2029, 2030, 2042, 2045, 2046, 2055, 2068, 2069, 2089, 2090, 2092, 2095, 2096, 2097, 2098, 2099, 2101, 2102, 2104, 2106, 2107, 2108, 2110, 2112, 2118, 2120, 2123, 2132, 2139, 2140, 2142, 2146, 2147, 2149, 2152, 2153, 2156, 2160, 2161, 2162, 2163, 2170, 2171, 2179, 2184, 2185, 2187, 2190, 2192, 2193, 2198, 2206, 2207, 2208, 2212, 2215, 2217, 2220, 2221, 2224, 2225, 2228, 2229, 2231, 2233, 2236, 2240, 2243, 2245, 2249, 2250, 2266, 2267, 2270, 2271, 2273, 2274, 2275, 2276, 2281, 2282, 2283, 2290, 2298, 2300, 2301, 2307, 2309, 2311, 2312, 2316, 2317, 2318, 2322, 2323, 2325, 2330, 2332, 2333, 2334, 2335, 2339, 2340, 2344, 2347, 2355, 2356, 2361, 2362, 2367, 2368, 2369, 2371, 2376, 2378, 2379, 2381, 2382, 2384, 2394, 2395, 2399, 2402, 2406, 2414, 2415, 2419, 2424, 2431, 2432, 2433, 2434, 2435, 2436, 2438, 2439, 2441, 2442, 2444, 2445, 2446, 2449, 2456, 2457, 2458, 2461, 2462, 2463, 2464, 2465, 2467, 2469, 2474, 2479, 2483, 2499, 2500, 2505, 2506, 2509, 2512, 2514, 2521, 2534, 2537, 2546, 2547, 2548, 2549, 2550, 2556, 2558, 2560, 2575, 2576, 2577, 2581, 2582, 2583, 2587, 2590, 2594, 2598, 2600, 2601, 2605, 2609, 2610, 2611, 2612, 2617, 2621, 2626, 2630, 2631, 2632, 2639, 2642, 2644, 2645, 2646, 2647, 2649, 2654, 2655, 2657, 2658, 2659, 2664, 2668, 2671, 2674, 2682, 2684, 2689, 2691, 2695, 2706, 2709, 2711, 2715, 2716, 2721, 2723, 2725, 2726, 2728, 2729, 2730, 2731, 2737, 2741, 2744, 2749, 2750, 2751, 2761, 2762, 2764, 2766, 2769, 2775, 2776, 2780, 2785, 2786, 2791, 2796, 2798, 2799, 2801, 2803, 2805, 2806, 2814, 2815, 2816, 2823, 2852, 2871, 2874, 2875, 2880, 2884, 2886, 2889, 2890, 2892, 2893, 2894, 2895, 2896, 2902, 2903, 2905, 2906, 2907, 2915, 2919, 2920, 2925, 2927, 2933, 2935, 2937, 2939, 2940, 2951, 2955, 2956, 2957, 2960, 2961, 2966, 2968, 2972, 2973, 2978, 2981, 2988, 2990, 2994, 2996, 3000, 3002, 3003, 3007, 3009, 3011, 3014, 3019, 3032, 3033, 3035, 3037, 3044, 3045, 3051, 3054, 3055, 3064, 3065, 3068, 3074, 3083, 3090, 3095, 3096, 3099, 3102, 3105, 3106, 3110, 3118, 3120, 3127, 3133, 3138, 3139, 3141, 3143, 3149, 3150, 3153, 3158, 3162, 3167, 3169, 3173, 3177, 3183, 3185, 3186, 3189, 3190, 3191, 3193, 3194, 3201, 3203, 3204, 3207, 3208, 3209, 3211, 3214, 3222, 3223, 3225, 3229, 3233, 3245, 3250, 3251, 3257, 3258, 3259, 3261, 3270, 3272, 3280, 3281, 3282, 3286, 3299, 3303, 3310, 3311, 3312, 3313, 3314, 3316, 3317, 3321, 3322, 3327, 3329, 3332, 3333, 3334, 3336, 3337, 3339, 3340, 3342, 3344, 3345, 3347, 3352, 3353, 3356, 3360, 3362, 3367, 3374, 3376, 3379, 3384, 3386, 3388, 3389, 3392, 3408, 3412, 3415, 3419, 3421, 3424, 3427, 3430, 3431, 3432, 3433, 3436, 3441, 3443, 3445, 3450, 3455, 3461, 3473, 3477, 3484, 3486, 3488, 3491, 3500, 3511, 3512, 3513, 3519, 3528, 3530, 3539, 3543, 3558, 3562, 3567, 3570, 3571, 3572, 3573, 3574, 3575, 3585, 3588, 3603, 3606, 3607, 3609, 3616, 3617, 3618, 3623, 3624, 3626, 3628, 3630, 3631, 3634, 3636, 3637, 3638, 3639, 3647, 3648, 3649, 3655, 3656, 3657, 3661, 3662, 3663, 3666, 3668, 3670, 3671, 3673, 3675, 3690, 3691, 3700, 3701, 3703, 3705, 3706, 3709, 3719, 3724, 3730, 3734, 3736, 3738, 3739, 3748, 3750, 3756, 3761, 3763, 3764, 3766, 3772, 3774, 3781, 3784, 3786, 3790, 3794, 3797, 3799, 3801, 3813, 3818, 3820, 3821, 3825, 3827, 3829, 3830, 3831, 3832, 3838, 3843, 3844, 3857, 3858, 3868, 3870, 3875, 3896, 3899, 3903, 3910, 3920, 3925, 3927, 3936, 3940, 3947, 3950, 3953, 3957, 3960, 3962, 3965, 3969, 3975, 3976, 3986, 3990, 3991, 3994, 3996, 3997, 3998, 4002, 4006, 4007, 4008, 4009, 4030, 4034, 4055, 4061, 4062, 4076, 4079, 4080, 4087, 4089, 4105, 4116, 4117, 4119, 4122, 4123, 4125, 4126, 4131, 4138, 4140, 4141, 4143, 4158, 4159, 4161, 4163, 4166, 4167, 4183, 4184, 4188, 4191, 4196, 4197, 4200, 4206, 4208, 4214, 4215, 4216, 4223, 4224, 4226, 4233, 4238, 4246, 4249, 4250, 4256, 4258, 4262, 4263, 4270, 4275, 4277, 4278, 4279, 4280, 4286, 4289, 4293, 4297, 4299, 4304, 4309, 4314, 4315, 4316, 4317, 4318, 4319, 4320, 4321, 4325, 4327, 4330, 4331, 4333, 4335, 4336, 4342, 4345, 4349, 4352, 4363, 4364, 4368, 4370, 4371, 4372, 4375, 4377, 4379, 4381, 4382, 4386, 4388, 4392, 4399, 4401, 4407, 4409, 4411, 4413, 4417, 4420, 4422, 4425, 4426, 4427, 4430, 4432, 4433, 4435, 4438, 4440, 4441, 4445, 4447, 4460, 4461, 4463, 4468, 4469, 4471, 4472, 4478, 4492, 4493, 4494, 4497, 4508, 4509, 4510, 4518, 4524, 4536, 4540, 4543, 4544, 4553, 4554, 4563, 4564, 4565, 4571, 4572, 4573, 4574, 4576, 4578, 4580, 4582, 4585, 4586, 4587, 4589, 4590, 4591, 4594, 4596, 4597, 4602, 4603, 4606, 4608, 4610, 4613, 4614, 4616, 4618, 4619, 4620, 4621, 4624, 4629, 4632, 4633, 4634, 4643, 4644, 4650, 4653, 4655, 4662, 4665, 4667, 4669, 4673, 4682, 4683, 4684, 4694, 4723, 4725, 4726, 4732, 4733, 4735, 4737, 4738, 4754, 4756, 4758, 4759, 4760, 4763, 4768, 4771, 4775, 4778, 4783, 4789, 4801, 4804, 4806, 4813, 4816, 4818, 4819, 4820, 4822, 4826, 4830, 4831, 4839, 4841, 4852, 4853, 4858, 4866, 4867, 4875, 4878, 4881, 4883, 4887, 4890, 4895, 4899, 4900, 4902, 4916, 4917, 4918, 4922, 4924, 4925, 4928, 4933, 4934, 4936, 4938, 4943, 4944, 4945, 4946, 4952, 4956, 4957, 4960, 4965, 4967, 4977, 4986, 4989, 4990, 4993, 5010, 5046, 5049, 5050, 5053, 5064, 5065, 5103, 5104, 5111, 5112, 5113, 5131, 5138, 5144, 5151, 5156, 5165, 5168, 5172, 5179, 5181, 5186, 5200, 5207, 5213, 5240, 5241, 5245, 5247, 5249, 5251, 5252, 5256, 5261, 5266, 5271, 5272, 5276, 5277, 5280, 5282, 5285, 5286, 5289, 5290, 5294, 5295, 5298, 5299, 5306, 5309, 5310, 5311, 5313, 5317, 5324, 5325, 5326, 5329, 5331, 5335, 5338, 5341, 5348, 5350, 5351, 5352, 5355, 5356, 5358, 5359, 5363, 5366, 5367, 5381, 5386, 5393, 5396, 5398, 5400, 5401, 5405, 5410, 5417, 5424, 5431, 5432, 5433, 5434, 5435, 5439, 5451, 5455, 5456, 5465, 5467, 5472, 5473, 5475, 5478, 5479, 5488, 5492, 5494, 5495, 5497, 5498, 5499, 5500, 5503, 5510, 5517, 5519, 5527, 5533, 5542, 5547, 5552, 5554, 5556, 5559, 5560, 5568, 5569, 5570, 5574, 5578, 5586, 5588, 5605, 5612, 5616, 5629, 5632, 5634, 5635, 5636, 5661, 5682, 5684, 5697, 5702, 5711, 5734, 5735, 5740, 5753, 5757, 5760, 5764, 5765, 5767, 5769, 5775, 5777, 5780, 5782, 5783, 5806, 5810, 5820, 5821, 5825, 5826, 5827, 5833, 5835, 5836, 5839, 5840, 5841, 5842, 5858, 5869, 5870, 5872, 5875, 5876, 5880, 5884, 5889, 5890, 5891, 5893, 5894, 5896, 5901, 5904, 5908, 5914, 5917, 5919, 5924, 5926, 5937, 5938, 5946, 5981, 5986, 6001, 6005, 6009, 6015, 6016, 6018, 6019, 6030, 6031, 6036, 6037, 6041, 6047, 6048, 6057, 6059, 6060, 6061, 6063, 6065, 6067, 6068, 6070, 6074, 6075, 6077, 6080, 6085, 6087, 6092, 6095, 6101, 6102, 6104, 6111, 6116, 6119, 6121, 6124, 6126, 6128, 6129, 6135, 6140, 6141, 6145, 6146, 6165, 6175, 6176, 6178, 6189, 6196, 6200, 6205, 6216, 6217, 6221, 6222, 6225, 6226, 6228, 6229, 6233, 6248, 6250, 6252, 6257, 6262, 6272, 6273, 6274, 6280, 6292, 6311, 6314, 6319, 6334, 6343, 6360, 6363, 6365, 6373, 6378, 6380, 6385, 6387, 6391, 6392, 6395, 6455, 6476, 6481, 6489, 6493, 6497, 6505, 6512, 6513, 6518, 6519, 6520, 6521, 6522, 6523, 6524, 6525, 6530, 6536, 6537, 6538, 6539, 6540, 6541, 6542, 6544, 6554, 6556, 6567, 6568, 6573, 6584, 6616, 6617, 6646, 6668, 6691, 6700, 6706, 6709, 6711, 6712, 6716, 6720, 6721, 6722, 6723, 6726, 6727, 6729, 6730, 6731, 6732, 6734, 6735, 6736, 6737, 6744, 6747, 6752, 6754, 6757, 6762, 6768, 6771, 6774, 6782, 6786, 6787, 6792, 6793}",1465
5,"(('exit', ('Request Payment', 'Payment Handled')),)",1,19,"{0, 1, 2, 3, 4, 5, 6, 7, 8, 9, 10, 11, 12, 13, 14, 15, 16, 17, 18, 20, 21, 22, 23, 24, 25, 27, 28, 29, 30, 31, 32, 33, 34, 35, 36, 37, 38, 39, 42, 43, 44, 45, 46, 47, 48, 49, 50, 51, 52, 53, 54, 55, 56, 57, 58, 59, 60, 61, 62, 64, 65, 66, 67, 68, 69, 70, 71, 72, 73, 74, 75, 78, 79, 80, 81, 83, 84, 85, 86, 88, 89, 90, 91, 92, 93, 94, 95, 96, 97, 98, 99, 100, 101, 102, 103, 104, 105, 106, 107, 108, 109, 110, 111, 112, 113, 114, 115, 116, 117, 118, 123, 124, 125, 126, 127, 128, 129, 130, 131, 132, 133, 134, 135, 136, 137, 138, 139, 140, 141, 143, 144, 145, 146, 147, 148, 149, 150, 151, 153, 154, 155, 156, 158, 159, 160, 161, 162, 163, 164, 165, 166, 167, 168, 169, 171, 172, 175, 176, 179, 180, 181, 182, 183, 184, 185, 186, 187, 188, 189, 190, 191, 192, 193, 194, 195, 196, 198, 199, 200, 201, 202, 203, 204, 205, 206, 207, 208, 209, 210, 211, 212, 213, 214, 215, 216, 217, 218, 219, 220, 221, 222, 223, 224, 225, 226, 227, 228, 229, 230, 231, 232, 234, 235, 236, 237, 238, 239, 240, 241, 242, 243, 244, 245, 246, 247, 248, 249, 250, 251, 252, 253, 254, 256, 257, 258, 259, 260, 261, 262, 263, 264, 265, 266, 267, 268, 269, 271, 272, 273, 274, 275, 276, 277, 278, 279, 280, 281, 282, 283, 284, 285, 286, 287, 288, 289, 290, 291, 292, 293, 294, 295, 296, 297, 298, 300, 301, 302, 303, 305, 307, 310, 311, 312, 313, 314, 315, 316, 317, 318, 321, 322, 323, 324, 325, 326, 327, 331, 332, 333, 334, 335, 336, 337, 338, 339, 340, 341, 342, 343, 344, 345, 346, 348, 349, 350, 351, 352, 353, 356, 357, 358, 359, 360, 361, 362, 363, 364, 365, 366, 367, 368, 369, 370, 372, 373, 375, 376, 377, 378, 379, 380, 382, 383, 384, 385, 386, 387, 388, 389, 390, 391, 392, 393, 394, 395, 396, 397, 398, 399, 400, 401, 402, 403, 404, 405, 406, 407, 408, 409, 410, 411, 414, 415, 416, 417, 418, 419, 420, 421, 422, 423, 424, 425, 426, 427, 428, 429, 430, 431, 433, 434, 435, 436, 437, 438, 439, 440, 441, 443, 444, 445, 446, 447, 449, 450, 451, 452, 453, 454, 456, 457, 458, 459, 460, 461, 462, 463, 464, 465, 466, 467, 468, 469, 470, 471, 472, 473, 474, 475, 476, 477, 478, 479, 481, 482, 483, 484, 486, 487, 488, 489, 490, 491, 492, 493, 494, 495, 496, 497, 498, 499, 500, 501, 502, 503, 504, 505, 506, 507, 508, 509, 510, 511, 512, 513, 514, 515, 516, 518, 519, 520, 521, 522, 523, 524, 525, 526, 527, 528, 530, 531, 532, 533, 534, 535, 536, 537, 538, 539, 540, 541, 542, 543, 544, 545, 546, 547, 548, 549, 550, 551, 552, 553, 554, 555, 556, 557, 558, 559, 560, 561, 562, 563, 564, 565, 566, 567, 568, 569, 570, 571, 572, 573, 574, 575, 576, 577, 578, 580, 582, 583, 584, 585, 586, 590, 591, 592, 593, 594, 596, 597, 598, 599, 600, 601, 602, 603, 604, 605, 606, 607, 608, 609, 610, 611, 612, 613, 614, 616, 617, 618, 620, 621, 622, 623, 624, 625, 626, 627, 628, 629, 631, 632, 633, 634, 635, 636, 637, 638, 639, 640, 641, 642, 643, 644, 645, 646, 647, 648, 649, 650, 651, 652, 653, 654, 655, 656, 657, 658, 659, 660, 661, 662, 663, 664, 665, 666, 667, 668, 669, 670, 671, 672, 673, 674, 675, 676, 677, 678, 679, 680, 681, 682, 683, 684, 685, 686, 687, 688, 689, 690, 693, 695, 696, 697, 698, 699, 700, 701, 702, 703, 704, 705, 706, 707, 708, 709, 710, 711, 712, 713, 714, 715, 716, 717, 718, 719, 720, 721, 722, 723, 724, 725, 726, 727, 728, 729, 730, 731, 732, 733, 734, 735, 736, 737, 738, 739, 740, 741, 742, 743, 744, 745, 746, 748, 749, 750, 751, 752, 753, 754, 755, 756, 757, 758, 759, 760, 761, 762, 763, 764, 765, 766, 767, 768, 769, 770, 771, 773, 774, 775, 776, 777, 778, 779, 780, 781, 782, 783, 784, 785, 786, 787, 788, 789, 790, 791, 792, 794, 795, 796, 797, 798, 799, 800, 801, 802, 803, 804, 805, 806, 807, 808, 809, 810, 811, 812, 813, 814, 815, 816, 817, 819, 820, 821, 824, 825, 826, 828, 829, 830, 831, 832, 833, 834, 835, 836, 837, 838, 839, 840, 841, 842, 843, 844, 845, 846, 847, 848, 849, 850, 851, 852, 854, 855, 856, 857, 858, 859, 860, 861, 862, 864, 865, 866, 867, 868, 869, 870, 871, 872, 873, 874, 875, 876, 877, 878, 879, 880, 881, 882, 883, 884, 885, 886, 887, 888, 889, 890, 891, 892, 893, 894, 895, 896, 897, 898, 899, 900, 901, 902, 903, 904, 905, 906, 907, 908, 909, 910, 911, 912, 913, 914, 915, 916, 917, 918, 919, 920, 921, 922, 923, 924, 925, 926, 927, 928, 929, 930, 931, 932, 933, 935, 936, 937, 939, 940, 941, 942, 943, 944, 945, 946, 947, 948, 949, 950, 951, 952, 953, 954, 955, 956, 957, 958, 959, 960, 961, 962, 963, 964, 965, 966, 967, 968, 969, 970, 971, 972, 973, 974, 975, 976, 977, 978, 979, 980, 981, 982, 983, 984, 985, 986, 987, 988, 989, 990, 991, 992, 993, 994, 996, 997, 998, 999, 1000, 1001, 1002, 1003, 1004, 1005, 1006, 1007, 1008, 1009, 1010, 1011, 1012, 1013, 1014, 1015, 1016, 1017, 1018, 1019, 1020, 1021, 1022, 1023, 1024, 1025, 1026, 1028, 1029, 1030, 1031, 1032, 1033, 1034, 1036, 1037, 1038, 1039, 1040, 1041, 1042, 1043, 1044, 1045, 1046, 1047, 1048, 1050, 1051, 1052, 1053, 1054, 1055, 1056, 1057, 1058, 1059, 1060, 1061, 1063, 1064, 1065, 1066, 1067, 1069, 1070, 1071, 1072, 1073, 1074, 1075, 1076, 1077, 1078, 1079, 1080, 1081, 1082, 1083, 1085, 1086, 1087, 1088, 1089, 1090, 1092, 1093, 1094, 1095, 1096, 1097, 1098, 1099, 1100, 1101, 1103, 1104, 1105, 1106, 1107, 1108, 1109, 1110, 1111, 1112, 1113, 1114, 1115, 1116, 1117, 1118, 1119, 1120, 1121, 1122, 1123, 1124, 1125, 1126, 1127, 1128, 1129, 1130, 1131, 1132, 1133, 1134, 1135, 1136, 1137, 1138, 1139, 1140, 1141, 1142, 1143, 1144, 1145, 1146, 1147, 1148, 1149, 1150, 1151, 1152, 1153, 1154, 1155, 1156, 1157, 1158, 1159, 1160, 1161, 1162, 1163, 1164, 1165, 1166, 1167, 1168, 1169, 1170, 1171, 1172, 1173, 1174, 1175, 1176, 1177, 1178, 1179, 1180, 1181, 1182, 1183, 1184, 1185, 1186, 1187, 1188, 1189, 1190, 1191, 1192, 1193, 1194, 1195, 1196, 1197, 1198, 1199, 1200, 1201, 1202, 1203, 1204, 1205, 1206, 1207, 1208, 1209, 1210, 1211, 1212, 1213, 1214, 1215, 1216, 1217, 1218, 1219, 1220, 1221, 1222, 1223, 1224, 1225, 1226, 1227, 1228, 1229, 1230, 1231, 1232, 1233, 1234, 1235, 1236, 1237, 1238, 1239, 1240, 1241, 1242, 1243, 1244, 1245, 1246, 1247, 1248, 1249, 1250, 1251, 1252, 1253, 1254, 1255, 1258, 1259, 1260, 1262, 1263, 1264, 1265, 1267, 1268, 1269, 1270, 1271, 1272, 1273, 1274, 1275, 1276, 1277, 1278, 1279, 1280, 1281, 1282, 1283, 1284, 1285, 1286, 1287, 1288, 1289, 1290, 1291, 1292, 1293, 1294, 1295, 1297, 1298, 1299, 1300, 1301, 1302, 1303, 1304, 1305, 1306, 1307, 1308, 1309, 1310, 1311, 1313, 1314, 1315, 1316, 1317, 1318, 1320, 1321, 1323, 1324, 1325, 1326, 1327, 1328, 1329, 1330, 1331, 1332, 1333, 1334, 1335, 1336, 1337, 1338, 1339, 1340, 1342, 1343, 1344, 1345, 1346, 1347, 1348, 1349, 1350, 1351, 1352, 1353, 1354, 1355, 1356, 1357, 1358, 1359, 1360, 1361, 1362, 1363, 1364, 1365, 1366, 1367, 1368, 1369, 1370, 1371, 1372, 1373, 1374, 1375, 1376, 1377, 1378, 1379, 1380, 1381, 1382, 1383, 1384, 1385, 1386, 1387, 1388, 1389, 1390, 1391, 1392, 1393, 1394, 1395, 1396, 1397, 1399, 1400, 1401, 1402, 1403, 1404, 1405, 1406, 1407, 1408, 1409, 1410, 1411, 1412, 1413, 1414, 1415, 1416, 1418, 1419, 1420, 1421, 1422, 1423, 1424, 1426, 1427, 1428, 1429, 1430, 1431, 1432, 1433, 1434, 1435, 1436, 1437, 1439, 1440, 1441, 1442, 1443, 1445, 1446, 1447, 1448, 1449, 1450, 1451, 1452, 1453, 1454, 1455, 1456, 1457, 1458, 1459, 1460, 1461, 1462, 1464, 1465, 1466, 1467, 1468, 1469, 1470, 1471, 1472, 1473, 1474, 1475, 1476, 1477, 1478, 1479, 1481, 1482, 1483, 1484, 1485, 1487, 1488, 1489, 1490, 1491, 1492, 1493, 1494, 1495, 1496, 1499, 1500, 1501, 1502, 1503, 1504, 1505, 1506, 1507, 1508, 1509, 1510, 1511, 1512, 1513, 1514, 1515, 1516, 1517, 1518, 1519, 1520, 1521, 1522, 1523, 1524, 1525, 1526, 1527, 1528, 1529, 1530, 1531, 1532, 1533, 1534, 1535, 1536, 1538, 1539, 1540, 1541, 1542, 1543, 1544, 1545, 1546, 1548, 1549, 1550, 1551, 1552, 1553, 1554, 1556, 1557, 1558, 1559, 1560, 1561, 1562, 1563, 1564, 1565, 1566, 1567, 1568, 1569, 1570, 1571, 1572, 1573, 1574, 1575, 1576, 1577, 1578, 1579, 1580, 1581, 1582, 1583, 1584, 1585, 1586, 1587, 1588, 1589, 1590, 1591, 1592, 1593, 1594, 1595, 1596, 1597, 1598, 1599, 1600, 1601, 1602, 1603, 1604, 1605, 1606, 1607, 1608, 1609, 1610, 1612, 1613, 1614, 1615, 1616, 1617, 1618, 1619, 1620, 1621, 1622, 1623, 1624, 1625, 1626, 1627, 1628, 1629, 1630, 1631, 1632, 1633, 1634, 1635, 1636, 1637, 1638, 1639, 1640, 1641, 1642, 1643, 1644, 1645, 1646, 1647, 1648, 1649, 1650, 1651, 1652, 1653, 1654, 1655, 1656, 1657, 1658, 1659, 1660, 1661, 1662, 1663, 1664, 1665, 1666, 1667, 1668, 1669, 1670, 1671, 1672, 1673, 1674, 1675, 1676, 1678, 1679, 1680, 1681, 1682, 1683, 1684, 1685, 1686, 1687, 1688, 1689, 1690, 1691, 1692, 1693, 1694, 1695, 1696, 1697, 1698, 1699, 1700, 1701, 1702, 1703, 1704, 1705, 1706, 1707, 1708, 1709, 1710, 1711, 1712, 1713, 1714, 1715, 1716, 1717, 1718, 1719, 1720, 1721, 1722, 1723, 1724, 1725, 1726, 1727, 1728, 1729, 1730, 1731, 1732, 1734, 1735, 1736, 1737, 1738, 1739, 1740, 1741, 1742, 1743, 1744, 1745, 1746, 1747, 1748, 1749, 1752, 1753, 1754, 1755, 1756, 1757, 1758, 1759, 1760, 1761, 1762, 1764, 1765, 1766, 1767, 1768, 1769, 1770, 1771, 1772, 1773, 1774, 1775, 1776, 1778, 1779, 1780, 1781, 1782, 1783, 1784, 1785, 1786, 1787, 1788, 1789, 1790, 1791, 1792, 1793, 1795, 1796, 1797, 1798, 1799, 1800, 1801, 1802, 1803, 1804, 1805, 1806, 1807, 1808, 1809, 1810, 1811, 1812, 1813, 1814, 1815, 1816, 1817, 1818, 1819, 1820, 1821, 1822, 1823, 1824, 1825, 1826, 1827, 1828, 1829, 1830, 1831, 1832, 1833, 1834, 1835, 1836, 1837, 1838, 1839, 1840, 1841, 1842, 1843, 1844, 1845, 1846, 1847, 1848, 1849, 1850, 1851, 1852, 1853, 1854, 1855, 1857, 1858, 1859, 1860, 1861, 1862, 1863, 1864, 1865, 1866, 1867, 1868, 1869, 1870, 1871, 1872, 1873, 1874, 1875, 1876, 1877, 1878, 1879, 1880, 1881, 1882, 1883, 1884, 1885, 1886, 1887, 1888, 1889, 1890, 1891, 1892, 1893, 1894, 1895, 1896, 1897, 1898, 1899, 1900, 1901, 1902, 1903, 1904, 1905, 1907, 1908, 1909, 1910, 1911, 1912, 1914, 1915, 1916, 1918, 1919, 1920, 1921, 1922, 1923, 1924, 1925, 1926, 1927, 1928, 1929, 1930, 1931, 1932, 1934, 1936, 1937, 1938, 1939, 1940, 1941, 1942, 1943, 1944, 1945, 1946, 1947, 1948, 1949, 1950, 1951, 1952, 1954, 1955, 1956, 1957, 1958, 1959, 1960, 1961, 1962, 1963, 1964, 1965, 1966, 1967, 1968, 1969, 1970, 1971, 1972, 1973, 1974, 1975, 1976, 1977, 1978, 1979, 1980, 1981, 1982, 1983, 1984, 1985, 1986, 1987, 1988, 1990, 1991, 1992, 1993, 1994, 1995, 1996, 1997, 1998, 1999, 2000, 2001, 2002, 2003, 2004, 2005, 2006, 2007, 2008, 2009, 2010, 2011, 2012, 2014, 2015, 2016, 2017, 2018, 2019, 2020, 2021, 2022, 2023, 2024, 2025, 2026, 2027, 2028, 2029, 2030, 2031, 2032, 2033, 2034, 2035, 2036, 2037, 2038, 2039, 2040, 2041, 2042, 2043, 2044, 2045, 2046, 2047, 2048, 2049, 2050, 2051, 2052, 2053, 2055, 2056, 2057, 2058, 2059, 2060, 2061, 2062, 2063, 2064, 2065, 2066, 2067, 2068, 2069, 2070, 2071, 2073, 2074, 2075, 2076, 2077, 2079, 2080, 2081, 2082, 2083, 2084, 2085, 2086, 2087, 2088, 2089, 2090, 2091, 2092, 2094, 2095, 2096, 2097, 2098, 2099, 2100, 2101, 2102, 2103, 2104, 2106, 2107, 2108, 2109, 2110, 2111, 2112, 2113, 2114, 2115, 2116, 2117, 2118, 2119, 2120, 2121, 2122, 2123, 2124, 2125, 2126, 2128, 2129, 2130, 2131, 2132, 2133, 2134, 2135, 2137, 2138, 2139, 2140, 2141, 2142, 2143, 2144, 2146, 2147, 2148, 2149, 2150, 2151, 2152, 2153, 2154, 2155, 2156, 2157, 2158, 2159, 2160, 2161, 2162, 2163, 2164, 2166, 2167, 2168, 2169, 2170, 2171, 2172, 2173, 2174, 2175, 2176, 2177, 2178, 2179, 2180, 2181, 2182, 2183, 2184, 2185, 2186, 2187, 2188, 2189, 2190, 2191, 2192, 2193, 2194, 2195, 2196, 2197, 2198, 2200, 2201, 2202, 2203, 2204, 2205, 2206, 2207, 2208, 2209, 2210, 2211, 2212, 2213, 2214, 2215, 2216, 2217, 2218, 2219, 2220, 2221, 2222, 2223, 2224, 2225, 2226, 2228, 2229, 2230, 2231, 2232, 2233, 2234, 2235, 2236, 2237, 2239, 2240, 2241, 2242, 2243, 2244, 2245, 2246, 2247, 2248, 2249, 2250, 2251, 2252, 2253, 2254, 2255, 2259, 2260, 2261, 2262, 2263, 2264, 2265, 2266, 2267, 2268, 2269, 2270, 2271, 2272, 2273, 2274, 2275, 2276, 2277, 2280, 2281, 2282, 2283, 2284, 2285, 2287, 2288, 2289, 2290, 2291, 2292, 2293, 2294, 2295, 2296, 2297, 2298, 2299, 2300, 2301, 2302, 2303, 2304, 2305, 2306, 2307, 2309, 2310, 2311, 2312, 2313, 2315, 2316, 2317, 2318, 2319, 2320, 2321, 2322, 2323, 2324, 2325, 2327, 2328, 2329, 2330, 2331, 2332, 2333, 2334, 2335, 2336, 2337, 2338, 2339, 2340, 2341, 2342, 2344, 2345, 2346, 2347, 2348, 2349, 2350, 2351, 2352, 2353, 2354, 2355, 2356, 2357, 2358, 2359, 2360, 2361, 2362, 2363, 2364, 2365, 2366, 2367, 2368, 2369, 2370, 2371, 2373, 2374, 2375, 2376, 2377, 2378, 2379, 2380, 2381, 2382, 2383, 2384, 2385, 2386, 2387, 2388, 2389, 2390, 2391, 2392, 2393, 2394, 2395, 2396, 2397, 2398, 2399, 2401, 2402, 2403, 2404, 2405, 2406, 2407, 2408, 2409, 2410, 2411, 2412, 2413, 2414, 2415, 2416, 2419, 2420, 2421, 2422, 2423, 2424, 2425, 2426, 2427, 2428, 2429, 2430, 2431, 2432, 2433, 2434, 2435, 2436, 2437, 2438, 2439, 2440, 2441, 2442, 2443, 2444, 2445, 2446, 2448, 2449, 2450, 2452, 2453, 2454, 2455, 2456, 2457, 2458, 2459, 2460, 2461, 2462, 2463, 2464, 2465, 2466, 2467, 2469, 2470, 2471, 2472, 2473, 2474, 2475, 2476, 2477, 2478, 2479, 2480, 2481, 2482, 2483, 2484, 2485, 2486, 2487, 2488, 2489, 2490, 2491, 2492, 2494, 2495, 2496, 2497, 2499, 2500, 2501, 2503, 2504, 2505, 2506, 2508, 2509, 2510, 2511, 2512, 2513, 2514, 2515, 2516, 2517, 2518, 2519, 2520, 2521, 2522, 2523, 2524, 2525, 2526, 2527, 2528, 2529, 2530, 2531, 2532, 2533, 2534, 2535, 2536, 2537, 2538, 2540, 2541, 2542, 2543, 2544, 2546, 2547, 2548, 2549, 2550, 2551, 2552, 2553, 2554, 2555, 2556, 2557, 2558, 2559, 2560, 2561, 2562, 2563, 2564, 2566, 2567, 2568, 2569, 2570, 2572, 2574, 2575, 2576, 2577, 2578, 2579, 2580, 2581, 2582, 2583, 2584, 2585, 2586, 2587, 2590, 2591, 2592, 2593, 2594, 2595, 2596, 2597, 2598, 2599, 2600, 2601, 2603, 2604, 2605, 2606, 2607, 2608, 2609, 2610, 2611, 2612, 2613, 2614, 2615, 2616, 2617, 2620, 2621, 2622, 2623, 2624, 2625, 2626, 2627, 2628, 2629, 2630, 2631, 2632, 2633, 2635, 2636, 2637, 2638, 2639, 2640, 2641, 2642, 2643, 2644, 2645, 2646, 2647, 2648, 2649, 2650, 2652, 2653, 2654, 2655, 2656, 2657, 2658, 2659, 2660, 2662, 2664, 2666, 2667, 2668, 2669, 2671, 2672, 2673, 2674, 2677, 2679, 2680, 2681, 2682, 2683, 2684, 2685, 2686, 2687, 2688, 2689, 2690, 2691, 2692, 2693, 2694, 2695, 2696, 2697, 2698, 2699, 2700, 2701, 2703, 2704, 2705, 2706, 2707, 2708, 2709, 2710, 2711, 2712, 2713, 2715, 2716, 2717, 2718, 2720, 2721, 2723, 2724, 2725, 2726, 2727, 2728, 2729, 2730, 2731, 2732, 2733, 2734, 2735, 2736, 2737, 2738, 2739, 2740, 2741, 2744, 2745, 2746, 2747, 2748, 2749, 2750, 2751, 2753, 2754, 2755, 2756, 2757, 2758, 2759, 2760, 2761, 2762, 2763, 2764, 2765, 2766, 2768, 2769, 2770, 2771, 2772, 2773, 2774, 2775, 2776, 2777, 2779, 2780, 2782, 2783, 2784, 2785, 2786, 2787, 2789, 2790, 2791, 2792, 2793, 2794, 2795, 2796, 2797, 2798, 2799, 2800, 2801, 2802, 2803, 2804, 2805, 2806, 2807, 2808, 2809, 2811, 2812, 2813, 2814, 2815, 2816, 2817, 2818, 2819, 2820, 2821, 2822, 2823, 2825, 2826, 2827, 2828, 2830, 2831, 2832, 2833, 2834, 2835, 2836, 2837, 2838, 2839, 2840, 2841, 2842, 2843, 2844, 2845, 2846, 2847, 2848, 2849, 2850, 2851, 2852, 2853, 2854, 2855, 2856, 2857, 2858, 2859, 2860, 2861, 2862, 2863, 2865, 2866, 2867, 2868, 2869, 2870, 2871, 2872, 2873, 2874, 2875, 2877, 2878, 2880, 2883, 2884, 2886, 2887, 2888, 2889, 2890, 2891, 2892, 2893, 2894, 2895, 2896, 2897, 2898, 2899, 2900, 2901, 2902, 2903, 2904, 2905, 2906, 2907, 2908, 2909, 2910, 2911, 2912, 2914, 2915, 2916, 2917, 2918, 2919, 2920, 2921, 2923, 2924, 2925, 2926, 2927, 2930, 2931, 2932, 2933, 2934, 2935, 2937, 2938, 2939, 2940, 2941, 2942, 2943, 2944, 2945, 2946, 2947, 2949, 2950, 2951, 2952, 2953, 2955, 2956, 2957, 2959, 2960, 2961, 2962, 2963, 2965, 2966, 2967, 2968, 2969, 2970, 2971, 2972, 2973, 2974, 2975, 2976, 2977, 2978, 2979, 2980, 2981, 2982, 2983, 2984, 2985, 2986, 2987, 2988, 2989, 2990, 2991, 2992, 2993, 2994, 2995, 2996, 2997, 2998, 2999, 3000, 3001, 3002, 3003, 3004, 3005, 3006, 3007, 3008, 3009, 3010, 3011, 3012, 3014, 3015, 3016, 3017, 3018, 3019, 3020, 3022, 3023, 3024, 3025, 3026, 3027, 3028, 3029, 3030, 3031, 3032, 3033, 3034, 3035, 3036, 3037, 3038, 3039, 3040, 3042, 3043, 3044, 3045, 3046, 3047, 3048, 3049, 3050, 3051, 3052, 3053, 3054, 3055, 3057, 3058, 3059, 3060, 3061, 3062, 3063, 3064, 3065, 3066, 3067, 3068, 3070, 3071, 3072, 3073, 3074, 3075, 3076, 3077, 3079, 3080, 3081, 3082, 3083, 3084, 3086, 3087, 3088, 3089, 3090, 3091, 3093, 3094, 3095, 3096, 3097, 3098, 3099, 3100, 3101, 3102, 3103, 3104, 3105, 3106, 3107, 3108, 3109, 3110, 3111, 3112, 3113, 3114, 3115, 3116, 3118, 3119, 3120, 3121, 3122, 3123, 3124, 3125, 3126, 3127, 3128, 3131, 3132, 3133, 3134, 3135, 3136, 3137, 3138, 3139, 3141, 3142, 3143, 3144, 3146, 3147, 3149, 3150, 3151, 3152, 3153, 3155, 3156, 3157, 3158, 3159, 3160, 3162, 3163, 3164, 3165, 3166, 3167, 3169, 3170, 3171, 3172, 3173, 3174, 3175, 3176, 3177, 3178, 3179, 3180, 3181, 3182, 3183, 3184, 3185, 3186, 3187, 3188, 3189, 3190, 3191, 3192, 3193, 3194, 3195, 3196, 3197, 3198, 3199, 3200, 3201, 3202, 3203, 3204, 3205, 3206, 3207, 3208, 3209, 3210, 3211, 3212, 3213, 3214, 3215, 3216, 3217, 3218, 3219, 3222, 3223, 3224, 3225, 3226, 3227, 3228, 3229, 3231, 3232, 3233, 3234, 3236, 3240, 3241, 3242, 3243, 3244, 3245, 3247, 3248, 3249, 3250, 3251, 3252, 3253, 3254, 3255, 3256, 3257, 3258, 3259, 3260, 3261, 3262, 3263, 3265, 3269, 3270, 3271, 3272, 3273, 3276, 3277, 3279, 3280, 3281, 3282, 3283, 3284, 3285, 3286, 3287, 3288, 3289, 3291, 3292, 3293, 3294, 3295, 3296, 3298, 3299, 3300, 3301, 3302, 3303, 3304, 3305, 3306, 3307, 3310, 3311, 3312, 3313, 3314, 3316, 3317, 3318, 3319, 3320, 3321, 3322, 3323, 3325, 3326, 3327, 3328, 3329, 3330, 3331, 3332, 3333, 3334, 3335, 3337, 3338, 3339, 3340, 3341, 3342, 3343, 3344, 3345, 3346, 3347, 3349, 3350, 3351, 3352, 3353, 3354, 3355, 3356, 3357, 3358, 3359, 3360, 3362, 3363, 3364, 3366, 3367, 3368, 3369, 3370, 3371, 3372, 3373, 3374, 3375, 3376, 3377, 3378, 3379, 3380, 3381, 3382, 3383, 3384, 3386, 3387, 3388, 3389, 3390, 3391, 3392, 3393, 3394, 3396, 3397, 3398, 3399, 3400, 3401, 3402, 3403, 3404, 3405, 3406, 3407, 3408, 3410, 3411, 3412, 3413, 3414, 3415, 3416, 3417, 3418, 3419, 3421, 3422, 3423, 3424, 3426, 3427, 3428, 3429, 3430, 3431, 3432, 3433, 3434, 3435, 3436, 3437, 3438, 3439, 3440, 3441, 3442, 3443, 3444, 3445, 3446, 3447, 3448, 3449, 3450, 3451, 3452, 3453, 3454, 3455, 3456, 3457, 3459, 3460, 3461, 3462, 3465, 3466, 3467, 3468, 3469, 3470, 3471, 3472, 3473, 3474, 3476, 3477, 3480, 3481, 3482, 3483, 3484, 3485, 3486, 3487, 3488, 3489, 3490, 3491, 3492, 3493, 3494, 3495, 3497, 3498, 3499, 3500, 3501, 3502, 3503, 3504, 3505, 3506, 3507, 3509, 3510, 3511, 3512, 3513, 3514, 3515, 3516, 3519, 3520, 3521, 3522, 3523, 3525, 3526, 3527, 3528, 3529, 3530, 3531, 3532, 3533, 3534, 3535, 3536, 3538, 3539, 3540, 3541, 3542, 3543, 3544, 3545, 3546, 3547, 3548, 3549, 3550, 3551, 3552, 3553, 3554, 3556, 3557, 3558, 3559, 3562, 3563, 3564, 3565, 3566, 3567, 3568, 3569, 3570, 3571, 3572, 3573, 3574, 3575, 3576, 3577, 3578, 3580, 3581, 3582, 3583, 3584, 3585, 3586, 3588, 3589, 3591, 3592, 3593, 3594, 3595, 3596, 3598, 3599, 3600, 3601, 3602, 3603, 3604, 3605, 3606, 3607, 3608, 3609, 3610, 3611, 3612, 3613, 3614, 3615, 3616, 3617, 3618, 3620, 3621, 3622, 3623, 3624, 3625, 3626, 3627, 3628, 3629, 3630, 3631, 3632, 3633, 3634, 3635, 3636, 3637, 3638, 3639, 3640, 3642, 3644, 3645, 3646, 3647, 3648, 3649, 3650, 3651, 3652, 3653, 3655, 3656, 3657, 3658, 3660, 3661, 3662, 3663, 3664, 3665, 3666, 3667, 3668, 3669, 3670, 3671, 3672, 3673, 3674, 3675, 3676, 3677, 3678, 3679, 3680, 3681, 3682, 3683, 3684, 3685, 3686, 3687, 3688, 3689, 3690, 3691, 3692, 3693, 3694, 3696, 3697, 3698, 3699, 3700, 3701, 3702, 3703, 3704, 3705, 3706, 3707, 3708, 3709, 3710, 3711, 3712, 3713, 3716, 3717, 3718, 3719, 3721, 3722, 3724, 3728, 3729, 3730, 3731, 3732, 3733, 3734, 3735, 3736, 3737, 3738, 3739, 3740, 3743, 3744, 3748, 3749, 3750, 3751, 3752, 3753, 3754, 3756, 3757, 3758, 3759, 3760, 3761, 3762, 3763, 3764, 3765, 3766, 3767, 3768, 3769, 3770, 3772, 3773, 3774, 3775, 3776, 3777, 3778, 3779, 3781, 3782, 3783, 3784, 3785, 3786, 3787, 3788, 3789, 3790, 3791, 3792, 3793, 3794, 3795, 3796, 3797, 3798, 3799, 3800, 3801, 3802, 3803, 3804, 3805, 3806, 3807, 3808, 3809, 3810, 3811, 3812, 3813, 3814, 3815, 3817, 3818, 3819, 3820, 3821, 3822, 3823, 3825, 3826, 3827, 3828, 3829, 3830, 3831, 3832, 3833, 3834, 3835, 3836, 3837, 3838, 3839, 3840, 3841, 3843, 3844, 3845, 3846, 3847, 3848, 3849, 3850, 3851, 3852, 3853, 3854, 3855, 3856, 3857, 3858, 3859, 3860, 3861, 3862, 3863, 3864, 3866, 3867, 3868, 3869, 3870, 3871, 3872, 3873, 3874, 3875, 3877, 3878, 3879, 3880, 3884, 3886, 3887, 3888, 3889, 3890, 3891, 3892, 3893, 3894, 3895, 3896, 3897, 3898, 3899, 3900, 3901, 3902, 3903, 3904, 3905, 3906, 3907, 3908, 3910, 3912, 3913, 3915, 3917, 3918, 3919, 3920, 3921, 3922, 3923, 3924, 3925, 3926, 3927, 3928, 3929, 3930, 3932, 3933, 3934, 3935, 3936, 3937, 3938, 3939, 3940, 3941, 3943, 3944, 3945, 3946, 3947, 3948, 3949, 3950, 3951, 3952, 3953, 3954, 3955, 3956, 3957, 3958, 3959, 3960, 3962, 3963, 3964, 3965, 3966, 3967, 3969, 3972, 3973, 3974, 3975, 3976, 3977, 3978, 3979, 3980, 3981, 3982, 3983, 3984, 3985, 3986, 3987, 3988, 3989, 3990, 3991, 3992, 3993, 3994, 3995, 3996, 3997, 3998, 3999, 4000, 4001, 4002, 4003, 4004, 4005, 4006, 4007, 4008, 4009, 4010, 4011, 4012, 4013, 4014, 4016, 4017, 4018, 4019, 4020, 4021, 4022, 4023, 4024, 4025, 4026, 4027, 4028, 4029, 4030, 4031, 4032, 4033, 4034, 4037, 4038, 4039, 4040, 4041, 4042, 4043, 4044, 4045, 4046, 4047, 4049, 4050, 4053, 4054, 4055, 4056, 4057, 4058, 4059, 4060, 4061, 4062, 4063, 4067, 4068, 4069, 4070, 4071, 4072, 4073, 4074, 4075, 4076, 4077, 4078, 4079, 4080, 4081, 4082, 4083, 4084, 4085, 4086, 4087, 4088, 4089, 4090, 4091, 4092, 4093, 4094, 4095, 4096, 4097, 4098, 4099, 4100, 4101, 4102, 4103, 4104, 4105, 4106, 4107, 4108, 4109, 4111, 4112, 4113, 4114, 4115, 4116, 4117, 4118, 4119, 4120, 4121, 4122, 4123, 4124, 4125, 4126, 4127, 4128, 4129, 4130, 4131, 4132, 4133, 4134, 4135, 4136, 4137, 4138, 4139, 4140, 4141, 4142, 4143, 4144, 4145, 4147, 4148, 4149, 4150, 4151, 4152, 4153, 4154, 4155, 4156, 4157, 4158, 4159, 4160, 4161, 4163, 4164, 4165, 4166, 4167, 4168, 4169, 4170, 4171, 4172, 4173, 4174, 4175, 4176, 4177, 4178, 4179, 4181, 4182, 4183, 4184, 4185, 4186, 4187, 4188, 4189, 4190, 4191, 4192, 4193, 4194, 4195, 4196, 4197, 4198, 4200, 4201, 4202, 4203, 4204, 4205, 4206, 4207, 4208, 4209, 4210, 4211, 4212, 4213, 4214, 4215, 4216, 4217, 4218, 4219, 4221, 4222, 4223, 4224, 4225, 4226, 4227, 4228, 4229, 4230, 4231, 4232, 4233, 4234, 4235, 4237, 4238, 4239, 4240, 4241, 4242, 4243, 4244, 4245, 4246, 4247, 4248, 4249, 4250, 4251, 4252, 4253, 4254, 4255, 4256, 4257, 4258, 4259, 4260, 4261, 4262, 4263, 4264, 4265, 4266, 4267, 4269, 4270, 4271, 4272, 4273, 4275, 4276, 4277, 4278, 4279, 4280, 4281, 4282, 4283, 4284, 4286, 4287, 4288, 4289, 4290, 4292, 4293, 4294, 4295, 4297, 4298, 4299, 4300, 4301, 4302, 4303, 4304, 4305, 4306, 4307, 4308, 4309, 4310, 4311, 4312, 4313, 4314, 4315, 4316, 4317, 4318, 4319, 4320, 4321, 4322, 4323, 4325, 4326, 4327, 4328, 4329, 4330, 4331, 4332, 4333, 4334, 4335, 4336, 4337, 4339, 4340, 4341, 4342, 4343, 4344, 4345, 4346, 4347, 4348, 4349, 4350, 4351, 4352, 4353, 4354, 4356, 4357, 4358, 4359, 4361, 4362, 4363, 4364, 4365, 4366, 4367, 4368, 4369, 4370, 4371, 4372, 4373, 4374, 4375, 4376, 4377, 4378, 4379, 4380, 4381, 4382, 4383, 4384, 4385, 4386, 4387, 4388, 4389, 4390, 4391, 4392, 4393, 4394, 4395, 4396, 4397, 4398, 4399, 4400, 4401, 4402, 4403, 4404, 4405, 4406, 4407, 4408, 4409, 4410, 4411, 4412, 4413, 4414, 4415, 4416, 4417, 4418, 4419, 4420, 4421, 4422, 4423, 4424, 4425, 4426, 4427, 4428, 4429, 4430, 4432, 4433, 4434, 4435, 4436, 4437, 4438, 4439, 4440, 4441, 4442, 4443, 4444, 4445, 4446, 4447, 4448, 4449, 4450, 4451, 4452, 4453, 4455, 4456, 4457, 4458, 4459, 4460, 4461, 4463, 4465, 4466, 4467, 4468, 4469, 4471, 4472, 4473, 4474, 4477, 4478, 4479, 4480, 4481, 4482, 4483, 4484, 4485, 4486, 4487, 4488, 4489, 4490, 4491, 4492, 4493, 4494, 4495, 4496, 4497, 4498, 4499, 4500, 4501, 4502, 4503, 4504, 4505, 4506, 4507, 4508, 4509, 4510, 4511, 4512, 4513, 4514, 4515, 4516, 4517, 4518, 4519, 4520, 4521, 4522, 4523, 4524, 4525, 4526, 4527, 4528, 4529, 4530, 4531, 4532, 4533, 4534, 4535, 4536, 4537, 4538, 4539, 4540, 4541, 4542, 4543, 4544, 4545, 4546, 4547, 4548, 4549, 4551, 4552, 4553, 4554, 4555, 4556, 4557, 4558, 4559, 4560, 4561, 4562, 4563, 4564, 4565, 4566, 4567, 4568, 4569, 4570, 4571, 4572, 4573, 4574, 4575, 4576, 4577, 4578, 4579, 4580, 4581, 4582, 4583, 4584, 4585, 4586, 4587, 4588, 4589, 4590, 4591, 4593, 4594, 4595, 4596, 4597, 4598, 4599, 4600, 4601, 4602, 4603, 4604, 4605, 4606, 4607, 4608, 4610, 4611, 4612, 4613, 4614, 4615, 4616, 4618, 4619, 4620, 4621, 4622, 4623, 4624, 4625, 4626, 4627, 4628, 4629, 4630, 4632, 4633, 4634, 4635, 4636, 4637, 4639, 4640, 4641, 4642, 4643, 4644, 4645, 4646, 4647, 4648, 4650, 4651, 4652, 4653, 4654, 4655, 4656, 4657, 4658, 4659, 4660, 4661, 4662, 4663, 4664, 4665, 4666, 4667, 4668, 4669, 4670, 4671, 4672, 4673, 4674, 4675, 4676, 4677, 4678, 4679, 4680, 4681, 4682, 4683, 4684, 4685, 4686, 4687, 4688, 4689, 4690, 4691, 4692, 4693, 4694, 4695, 4696, 4697, 4698, 4699, 4700, 4701, 4702, 4703, 4704, 4705, 4706, 4707, 4708, 4709, 4710, 4711, 4712, 4713, 4714, 4715, 4716, 4717, 4718, 4719, 4720, 4722, 4723, 4724, 4725, 4726, 4727, 4728, 4729, 4730, 4731, 4732, 4733, 4734, 4735, 4736, 4737, 4738, 4739, 4740, 4741, 4742, 4743, 4744, 4745, 4746, 4747, 4748, 4749, 4750, 4751, 4752, 4753, 4754, 4755, 4756, 4757, 4758, 4759, 4760, 4761, 4762, 4763, 4764, 4765, 4767, 4768, 4770, 4771, 4772, 4773, 4774, 4775, 4776, 4777, 4778, 4779, 4780, 4781, 4783, 4784, 4785, 4788, 4789, 4790, 4791, 4792, 4793, 4794, 4795, 4796, 4797, 4798, 4799, 4800, 4801, 4802, 4803, 4804, 4805, 4806, 4807, 4808, 4809, 4810, 4811, 4813, 4814, 4815, 4816, 4817, 4818, 4819, 4820, 4821, 4822, 4823, 4826, 4827, 4828, 4829, 4831, 4832, 4833, 4834, 4835, 4836, 4837, 4838, 4839, 4840, 4841, 4842, 4843, 4844, 4845, 4846, 4847, 4848, 4849, 4850, 4851, 4852, 4853, 4854, 4855, 4856, 4857, 4858, 4859, 4860, 4861, 4862, 4863, 4864, 4865, 4866, 4867, 4868, 4869, 4871, 4872, 4873, 4874, 4875, 4876, 4877, 4878, 4879, 4880, 4881, 4882, 4883, 4884, 4885, 4887, 4888, 4889, 4890, 4891, 4892, 4893, 4894, 4895, 4897, 4898, 4899, 4900, 4901, 4902, 4903, 4904, 4905, 4906, 4907, 4908, 4909, 4910, 4911, 4912, 4914, 4915, 4916, 4917, 4918, 4919, 4920, 4921, 4922, 4923, 4925, 4926, 4927, 4928, 4929, 4930, 4931, 4932, 4933, 4934, 4935, 4936, 4937, 4938, 4939, 4940, 4942, 4943, 4944, 4945, 4946, 4947, 4948, 4949, 4950, 4951, 4952, 4953, 4954, 4955, 4956, 4957, 4958, 4959, 4960, 4961, 4962, 4963, 4964, 4965, 4967, 4968, 4969, 4970, 4971, 4972, 4973, 4974, 4975, 4977, 4978, 4979, 4980, 4981, 4982, 4983, 4984, 4986, 4987, 4988, 4989, 4990, 4991, 4993, 4994, 4995, 4996, 4997, 4998, 4999, 5000, 5001, 5002, 5003, 5004, 5005, 5006, 5007, 5009, 5010, 5011, 5012, 5013, 5014, 5015, 5016, 5017, 5018, 5019, 5020, 5021, 5022, 5023, 5024, 5025, 5026, 5027, 5028, 5029, 5031, 5032, 5033, 5034, 5035, 5036, 5037, 5038, 5039, 5040, 5041, 5042, 5043, 5044, 5045, 5046, 5047, 5048, 5049, 5050, 5051, 5052, 5053, 5055, 5056, 5057, 5058, 5059, 5060, 5061, 5062, 5063, 5064, 5065, 5066, 5067, 5068, 5069, 5070, 5071, 5072, 5073, 5074, 5075, 5076, 5077, 5078, 5079, 5080, 5081, 5082, 5083, 5084, 5085, 5086, 5087, 5090, 5091, 5092, 5093, 5095, 5096, 5097, 5098, 5099, 5100, 5101, 5102, 5103, 5104, 5105, 5106, 5107, 5108, 5109, 5110, 5111, 5112, 5113, 5114, 5115, 5116, 5117, 5118, 5119, 5120, 5121, 5122, 5123, 5124, 5125, 5126, 5127, 5128, 5129, 5130, 5131, 5132, 5133, 5134, 5135, 5136, 5137, 5138, 5139, 5140, 5141, 5142, 5143, 5144, 5145, 5148, 5149, 5150, 5151, 5152, 5153, 5155, 5156, 5157, 5158, 5159, 5160, 5161, 5162, 5163, 5164, 5165, 5166, 5167, 5168, 5169, 5170, 5171, 5172, 5174, 5175, 5176, 5178, 5179, 5181, 5182, 5183, 5185, 5186, 5187, 5188, 5190, 5191, 5192, 5193, 5194, 5195, 5196, 5197, 5198, 5199, 5200, 5201, 5202, 5203, 5204, 5205, 5206, 5207, 5208, 5209, 5210, 5211, 5212, 5213, 5214, 5215, 5216, 5217, 5218, 5219, 5220, 5221, 5224, 5225, 5226, 5229, 5230, 5231, 5232, 5233, 5236, 5237, 5238, 5239, 5240, 5241, 5242, 5243, 5245, 5246, 5247, 5248, 5249, 5250, 5251, 5252, 5253, 5254, 5256, 5257, 5258, 5259, 5260, 5261, 5262, 5263, 5264, 5265, 5266, 5267, 5268, 5269, 5270, 5271, 5272, 5273, 5274, 5275, 5276, 5277, 5278, 5279, 5280, 5281, 5282, 5283, 5284, 5285, 5286, 5287, 5288, 5289, 5290, 5291, 5292, 5294, 5295, 5296, 5297, 5298, 5299, 5300, 5301, 5302, 5303, 5304, 5305, 5306, 5307, 5308, 5309, 5310, 5311, 5312, 5313, 5314, 5315, 5316, 5317, 5319, 5320, 5321, 5323, 5324, 5325, 5326, 5327, 5328, 5329, 5330, 5331, 5333, 5334, 5335, 5336, 5337, 5338, 5339, 5340, 5341, 5342, 5343, 5344, 5345, 5346, 5347, 5348, 5350, 5351, 5352, 5353, 5354, 5355, 5356, 5357, 5358, 5359, 5361, 5362, 5363, 5364, 5365, 5366, 5367, 5368, 5369, 5370, 5371, 5372, 5373, 5375, 5376, 5377, 5378, 5379, 5380, 5381, 5383, 5384, 5385, 5386, 5387, 5388, 5389, 5390, 5391, 5392, 5393, 5394, 5396, 5397, 5398, 5399, 5400, 5401, 5402, 5403, 5404, 5405, 5406, 5407, 5408, 5409, 5410, 5411, 5412, 5413, 5414, 5416, 5417, 5418, 5419, 5420, 5422, 5423, 5424, 5425, 5426, 5427, 5428, 5429, 5430, 5431, 5432, 5433, 5434, 5435, 5437, 5438, 5439, 5440, 5441, 5442, 5443, 5444, 5445, 5446, 5447, 5448, 5449, 5450, 5451, 5452, 5453, 5454, 5455, 5456, 5457, 5458, 5459, 5460, 5461, 5462, 5463, 5464, 5465, 5466, 5467, 5468, 5469, 5470, 5471, 5472, 5473, 5474, 5475, 5476, 5477, 5478, 5479, 5480, 5481, 5482, 5483, 5484, 5485, 5486, 5487, 5488, 5489, 5490, 5491, 5492, 5493, 5494, 5495, 5496, 5497, 5498, 5499, 5500, 5501, 5502, 5503, 5504, 5505, 5506, 5507, 5508, 5509, 5510, 5511, 5512, 5513, 5514, 5515, 5516, 5517, 5518, 5519, 5520, 5521, 5522, 5523, 5524, 5525, 5526, 5527, 5529, 5530, 5531, 5532, 5533, 5534, 5535, 5536, 5537, 5538, 5539, 5540, 5541, 5542, 5543, 5544, 5545, 5547, 5548, 5549, 5550, 5551, 5552, 5554, 5555, 5556, 5557, 5558, 5559, 5560, 5561, 5562, 5563, 5564, 5565, 5566, 5567, 5568, 5569, 5570, 5571, 5572, 5573, 5574, 5575, 5576, 5577, 5578, 5579, 5580, 5581, 5582, 5583, 5584, 5585, 5586, 5587, 5588, 5589, 5590, 5591, 5592, 5593, 5594, 5595, 5596, 5597, 5598, 5600, 5601, 5602, 5603, 5604, 5605, 5606, 5607, 5608, 5609, 5610, 5612, 5613, 5614, 5615, 5616, 5617, 5618, 5620, 5621, 5622, 5623, 5624, 5625, 5626, 5627, 5628, 5629, 5630, 5631, 5633, 5634, 5635, 5636, 5637, 5639, 5640, 5642, 5643, 5645, 5646, 5647, 5648, 5649, 5650, 5651, 5652, 5653, 5654, 5655, 5656, 5657, 5658, 5659, 5660, 5661, 5662, 5663, 5664, 5665, 5666, 5667, 5668, 5669, 5670, 5671, 5672, 5673, 5674, 5676, 5677, 5678, 5679, 5680, 5681, 5682, 5683, 5684, 5685, 5686, 5688, 5689, 5690, 5691, 5692, 5693, 5694, 5695, 5696, 5697, 5698, 5699, 5700, 5701, 5702, 5703, 5704, 5705, 5706, 5707, 5708, 5709, 5711, 5712, 5713, 5714, 5716, 5717, 5718, 5720, 5721, 5722, 5723, 5724, 5726, 5728, 5729, 5730, 5731, 5732, 5733, 5734, 5735, 5736, 5737, 5739, 5740, 5741, 5742, 5743, 5744, 5745, 5746, 5747, 5748, 5749, 5751, 5752, 5753, 5754, 5755, 5756, 5757, 5758, 5759, 5760, 5761, 5762, 5763, 5764, 5765, 5766, 5767, 5768, 5769, 5771, 5772, 5773, 5774, 5775, 5776, 5777, 5778, 5779, 5780, 5781, 5782, 5783, 5784, 5785, 5786, 5787, 5788, 5789, 5791, 5792, 5793, 5794, 5795, 5796, 5797, 5798, 5799, 5800, 5801, 5802, 5803, 5804, 5805, 5806, 5808, 5809, 5810, 5811, 5813, 5814, 5815, 5816, 5817, 5819, 5820, 5821, 5822, 5823, 5825, 5826, 5827, 5828, 5829, 5830, 5831, 5832, 5833, 5834, 5835, 5836, 5837, 5838, 5839, 5840, 5841, 5842, 5843, 5844, 5846, 5847, 5848, 5849, 5850, 5851, 5852, 5853, 5854, 5855, 5856, 5857, 5858, 5859, 5860, 5861, 5862, 5863, 5864, 5865, 5866, 5868, 5869, 5870, 5871, 5872, 5874, 5875, 5876, 5877, 5878, 5880, 5881, 5882, 5883, 5884, 5886, 5887, 5888, 5889, 5890, 5891, 5892, 5893, 5894, 5895, 5896, 5897, 5898, 5899, 5900, 5901, 5902, 5903, 5904, 5905, 5906, 5907, 5908, 5909, 5910, 5912, 5913, 5914, 5915, 5916, 5917, 5918, 5919, 5920, 5921, 5922, 5924, 5925, 5926, 5927, 5928, 5929, 5932, 5933, 5934, 5935, 5936, 5937, 5938, 5939, 5940, 5942, 5943, 5944, 5945, 5946, 5947, 5948, 5949, 5950, 5952, 5953, 5954, 5955, 5956, 5957, 5960, 5962, 5963, 5965, 5966, 5967, 5968, 5969, 5970, 5971, 5972, 5973, 5974, 5975, 5976, 5977, 5978, 5979, 5980, 5981, 5983, 5984, 5985, 5986, 5987, 5988, 5989, 5990, 5991, 5992, 5993, 5994, 5995, 5996, 5997, 5998, 5999, 6000, 6001, 6002, 6003, 6004, 6005, 6006, 6007, 6008, 6009, 6010, 6011, 6012, 6013, 6015, 6016, 6017, 6018, 6019, 6021, 6022, 6023, 6024, 6025, 6027, 6028, 6029, 6030, 6031, 6032, 6034, 6036, 6037, 6040, 6041, 6042, 6043, 6044, 6045, 6046, 6047, 6048, 6049, 6051, 6052, 6053, 6055, 6056, 6057, 6058, 6059, 6060, 6061, 6063, 6064, 6065, 6066, 6067, 6068, 6069, 6070, 6071, 6072, 6073, 6074, 6075, 6076, 6077, 6078, 6079, 6080, 6081, 6083, 6084, 6085, 6086, 6087, 6088, 6089, 6090, 6091, 6092, 6093, 6094, 6095, 6096, 6097, 6099, 6100, 6101, 6102, 6103, 6104, 6105, 6106, 6107, 6108, 6109, 6111, 6112, 6113, 6114, 6115, 6116, 6117, 6118, 6119, 6120, 6121, 6122, 6123, 6124, 6126, 6127, 6128, 6129, 6130, 6131, 6132, 6133, 6134, 6135, 6136, 6137, 6139, 6140, 6141, 6142, 6143, 6144, 6145, 6146, 6147, 6148, 6149, 6150, 6151, 6152, 6153, 6154, 6155, 6156, 6157, 6158, 6159, 6160, 6161, 6162, 6163, 6164, 6165, 6166, 6167, 6168, 6169, 6170, 6171, 6172, 6173, 6174, 6175, 6176, 6178, 6179, 6180, 6181, 6182, 6183, 6184, 6185, 6186, 6187, 6189, 6190, 6191, 6192, 6193, 6194, 6195, 6196, 6197, 6198, 6200, 6201, 6202, 6203, 6204, 6205, 6206, 6207, 6208, 6209, 6210, 6211, 6212, 6213, 6214, 6215, 6216, 6217, 6218, 6219, 6220, 6221, 6222, 6223, 6224, 6225, 6226, 6227, 6228, 6229, 6230, 6231, 6232, 6233, 6234, 6235, 6236, 6237, 6238, 6239, 6240, 6241, 6242, 6243, 6244, 6245, 6246, 6247, 6248, 6249, 6250, 6251, 6252, 6253, 6254, 6255, 6256, 6257, 6258, 6259, 6260, 6261, 6262, 6263, 6264, 6265, 6266, 6267, 6269, 6270, 6271, 6272, 6273, 6274, 6275, 6276, 6277, 6278, 6279, 6280, 6281, 6282, 6283, 6284, 6285, 6286, 6287, 6288, 6289, 6290, 6291, 6292, 6293, 6294, 6295, 6296, 6297, 6298, 6300, 6301, 6302, 6303, 6304, 6305, 6306, 6307, 6308, 6309, 6310, 6311, 6313, 6314, 6315, 6316, 6317, 6318, 6319, 6320, 6321, 6322, 6323, 6324, 6325, 6326, 6327, 6328, 6329, 6330, 6331, 6332, 6333, 6334, 6335, 6336, 6338, 6339, 6340, 6341, 6342, 6343, 6344, 6345, 6346, 6347, 6348, 6349, 6350, 6351, 6352, 6353, 6354, 6355, 6356, 6357, 6358, 6359, 6360, 6361, 6362, 6363, 6364, 6369, 6370, 6371, 6372, 6373, 6374, 6375, 6376, 6377, 6378, 6379, 6380, 6381, 6382, 6383, 6384, 6385, 6386, 6387, 6388, 6389, 6390, 6391, 6392, 6393, 6394, 6395, 6396, 6398, 6399, 6401, 6402, 6404, 6405, 6407, 6408, 6410, 6411, 6412, 6413, 6414, 6415, 6416, 6417, 6418, 6419, 6420, 6421, 6422, 6423, 6424, 6425, 6426, 6427, 6428, 6429, 6430, 6431, 6433, 6434, 6435, 6436, 6437, 6438, 6439, 6440, 6441, 6442, 6443, 6444, 6445, 6446, 6447, 6448, 6449, 6450, 6452, 6453, 6454, 6455, 6457, 6458, 6460, 6461, 6462, 6463, 6464, 6466, 6467, 6468, 6469, 6470, 6471, 6472, 6473, 6474, 6475, 6476, 6477, 6478, 6479, 6481, 6482, 6483, 6484, 6485, 6486, 6487, 6488, 6489, 6491, 6492, 6493, 6494, 6495, 6496, 6497, 6498, 6499, 6500, 6501, 6502, 6503, 6504, 6505, 6506, 6507, 6508, 6509, 6510, 6511, 6512, 6513, 6514, 6515, 6516, 6517, 6518, 6519, 6520, 6521, 6522, 6523, 6524, 6525, 6526, 6527, 6528, 6529, 6530, 6531, 6532, 6533, 6534, 6535, 6536, 6537, 6538, 6539, 6540, 6541, 6542, 6543, 6544, 6545, 6547, 6548, 6552, 6553, 6554, 6555, 6556, 6557, 6558, 6559, 6560, 6561, 6562, 6563, 6564, 6565, 6566, 6567, 6568, 6569, 6570, 6571, 6572, 6573, 6575, 6576, 6577, 6578, 6579, 6580, 6581, 6582, 6583, 6584, 6585, 6586, 6587, 6589, 6590, 6591, 6592, 6593, 6594, 6595, 6596, 6597, 6598, 6600, 6601, 6602, 6603, 6604, 6605, 6606, 6607, 6608, 6609, 6610, 6611, 6612, 6613, 6614, 6615, 6616, 6617, 6618, 6619, 6620, 6621, 6622, 6623, 6624, 6625, 6626, 6627, 6628, 6629, 6630, 6631, 6632, 6633, 6634, 6635, 6636, 6637, 6639, 6640, 6641, 6642, 6643, 6644, 6645, 6646, 6647, 6648, 6649, 6650, 6651, 6652, 6653, 6654, 6655, 6656, 6657, 6658, 6659, 6660, 6661, 6662, 6663, 6664, 6665, 6666, 6667, 6668, 6669, 6670, 6671, 6672, 6673, 6675, 6676, 6677, 6678, 6679, 6680, 6681, 6682, 6683, 6684, 6685, 6686, 6687, 6688, 6689, 6690, 6691, 6692, 6693, 6694, 6695, 6696, 6697, 6698, 6699, 6700, 6701, 6702, 6703, 6704, 6705, 6706, 6707, 6708, 6709, 6710, 6711, 6712, 6713, 6714, 6715, 6716, 6717, 6718, 6719, 6720, 6721, 6722, 6723, 6724, 6725, 6726, 6727, 6728, 6729, 6730, 6731, 6732, 6733, 6734, 6735, 6736, 6737, 6738, 6739, 6740, 6741, 6742, 6743, 6744, 6745, 6747, 6748, 6750, 6751, 6752, 6753, 6754, 6755, 6756, 6757, 6758, 6759, 6760, 6762, 6764, 6765, 6766, 6767, 6768, 6769, 6770, 6771, 6772, 6773, 6774, 6775, 6776, 6777, 6778, 6779, 6780, 6781, 6782, 6783, 6784, 6785, 6786, 6787, 6788, 6789, 6790, 6791, 6792, 6793}",6300,"{4130, 2452, 2455, 6527, 2457, 6531, 2462, 2466, 4241, 2471, 2472, 2475, 2477, 2478, 2481, 2482, 4358, 2496, 2497, 2499, 2500, 2503, 4422, 2508, 4446, 4492, 4493, 4537, 2530, 4621, 4626, 4637, 4667, 4669, 4677, 4690, 4695, 4698, 4699, 4700, 4701, 4702, 4703, 4704, 4705, 4706, 4707, 4708, 4710, 4711, 4712, 4713, 4714, 4715, 4716, 4717, 4718, 4719, 4727, 4728, 4732, 4733, 4734, 4735, 4743, 4750, 4752, 4753, 4754, 4760, 4762, 4765, 4768, 4770, 4777, 4778, 4791, 4792, 4793, 4794, 4800, 4802, 4808, 4809, 4810, 4811, 4817, 4818, 4819, 4820, 4821, 4823, 4826, 4831, 4838, 4841, 4845, 4851, 4861, 4868, 4869, 4871, 4873, 4874, 4881, 4884, 4904, 4905, 4906, 4911, 4919, 4925, 4928, 4933, 4934, 4935, 4937, 4938, 4939, 4953, 4954, 4955, 4961, 4962, 4967, 4968, 4970, 4980, 4982, 4994, 4998, 4999, 5002, 5007, 5010, 5011, 5012, 5013, 5016, 5022, 5025, 5028, 5037, 5039, 5040, 5041, 5042, 5047, 5050, 5051, 5052, 5055, 5058, 5060, 5061, 5063, 5064, 5065, 5066, 5067, 5068, 5069, 5072, 5073, 5074, 5076, 5077, 5078, 5079, 5080, 5081, 5082, 5083, 5084, 989, 5085, 5091, 5092, 5093, 5095, 5096, 5097, 5098, 5099, 5100, 5101, 5102, 5105, 5107, 5108, 5109, 5110, 5115, 5117, 5119, 5121, 5122, 5123, 5148, 5152, 5157, 5164, 5171, 5172, 5176, 5181, 5188, 5191, 5194, 1098, 1110, 5211, 5212, 5216, 5221, 5224, 5226, 5236, 5241, 5243, 5245, 5247, 5250, 5253, 1157, 5258, 5261, 5263, 5265, 5267, 5268, 5271, 1178, 5276, 5277, 5280, 5281, 5282, 5284, 1192, 5289, 5291, 5294, 5296, 5300, 5301, 5302, 5303, 5305, 5306, 5307, 5308, 5310, 5311, 5314, 5315, 5316, 5319, 5323, 5324, 5325, 5326, 5330, 5331, 5335, 5336, 5337, 1243, 5341, 1245, 5343, 5344, 5345, 5346, 5347, 5348, 1248, 1249, 5353, 5355, 5356, 5357, 5361, 5362, 5363, 5365, 5367, 5368, 5369, 5370, 1272, 5373, 5378, 5379, 5380, 1286, 5392, 1299, 5396, 5399, 5400, 1306, 5403, 5405, 5410, 5412, 1316, 5413, 5416, 5418, 5419, 5420, 5422, 5423, 5424, 1326, 1329, 5427, 1330, 1331, 1332, 5426, 5431, 5433, 1337, 5438, 1343, 5440, 5441, 1347, 1350, 5447, 1352, 1356, 5453, 1360, 5457, 5458, 5459, 5460, 5461, 1363, 1364, 5464, 5465, 5467, 1371, 5469, 1372, 1374, 5472, 1376, 1379, 1381, 5478, 1382, 1383, 5481, 5482, 5480, 5483, 1395, 5496, 1400, 5498, 5499, 1401, 5501, 1402, 1404, 1406, 5505, 1407, 1408, 5508, 5509, 5510, 5511, 5512, 1410, 5514, 5515, 5516, 1413, 1414, 1419, 5520, 1422, 1424, 1426, 5525, 5526, 5527, 1429, 1430, 1431, 1432, 1433, 1434, 1435, 1436, 5532, 1439, 1440, 5540, 1445, 1446, 5542, 5544, 5545, 1448, 1452, 1453, 1454, 5551, 1455, 1456, 1457, 1458, 5556, 5550, 5558, 1460, 5560, 1461, 1462, 1464, 1467, 1469, 1470, 1471, 5568, 1472, 5570, 1474, 5572, 1478, 1479, 5574, 1481, 5578, 5579, 1484, 5581, 5582, 1485, 1487, 5585, 1488, 5586, 5587, 1489, 5589, 1490, 5591, 5592, 5593, 5594, 1491, 1493, 1495, 5598, 1496, 1501, 1503, 5602, 5603, 1504, 1505, 1507, 5604, 5608, 5609, 5605, 1511, 1512, 5613, 5614, 1513, 5616, 5610, 1516, 1518, 5620, 5621, 5622, 1524, 5624, 1525, 1526, 1529, 1530, 5627, 5630, 5631, 1536, 1539, 1546, 5643, 1548, 1549, 5646, 1550, 5652, 1556, 1557, 1558, 1560, 1561, 5658, 5659, 5656, 1563, 5662, 5663, 5664, 1565, 5666, 5667, 5668, 5669, 5670, 1567, 1569, 5665, 1573, 1574, 5674, 5677, 5678, 1579, 5680, 5681, 5676, 1583, 1587, 1589, 5686, 1591, 1592, 5688, 1594, 5691, 1595, 5693, 1596, 1599, 1600, 5697, 1603, 5703, 5704, 1610, 5706, 5708, 5714, 1620, 1622, 1623, 1624, 1625, 5718, 1627, 5722, 1637, 1640, 1642, 5739, 1645, 1648, 5749, 1655, 5751, 5752, 5754, 5759, 5763, 5768, 5769, 1676, 5773, 5776, 5781, 5783, 5784, 5787, 5793, 1699, 5798, 5802, 5803, 5811, 5813, 5814, 5815, 5816, 5817, 5819, 5820, 5821, 5825, 5828, 5830, 1737, 5833, 5834, 1742, 1743, 5838, 5841, 5842, 5844, 5846, 5847, 5848, 5849, 5850, 1755, 5852, 5851, 1759, 1760, 5855, 1770, 5868, 1775, 5877, 1782, 1784, 5883, 1791, 1792, 1793, 5887, 1798, 5895, 1799, 1801, 1802, 1803, 1804, 1805, 1808, 1810, 1811, 1812, 1814, 1817, 1819, 1824, 1826, 5925, 1832, 1836, 1839, 1844, 1845, 1847, 1850, 1852, 1857, 1858, 1861, 1865, 1866, 1867, 1868, 1869, 1871, 1872, 1874, 1877, 1879, 1880, 1881, 1882, 1883, 1884, 1885, 1886, 1888, 1890, 1891, 1894, 1895, 1897, 1898, 1899, 1900, 1901, 1902, 1903, 1907, 6004, 1908, 1911, 1912, 1915, 1916, 1918, 1921, 1922, 1923, 1924, 1925, 1926, 1927, 6022, 6024, 1930, 1931, 1932, 1934, 1936, 1937, 6032, 1939, 1940, 1941, 1942, 1943, 1944, 1945, 1946, 6036, 6042, 6043, 1950, 1951, 1952, 1954, 1955, 1956, 6053, 1958, 1960, 6057, 1961, 1962, 1963, 1964, 6056, 1966, 1967, 1968, 1969, 1970, 6066, 1973, 1974, 1975, 1980, 1981, 1982, 1983, 6080, 1984, 1990, 1991, 1992, 6089, 1994, 6090, 1997, 1999, 2001, 2002, 2003, 6099, 6100, 2006, 2008, 2009, 6105, 2012, 2014, 2015, 2016, 2017, 2018, 2019, 6114, 6115, 6117, 2023, 2024, 6120, 2027, 2028, 2033, 2034, 6131, 6132, 2039, 2040, 6136, 2042, 2043, 2045, 2046, 2047, 2051, 2053, 2055, 2056, 2057, 2058, 2059, 2060, 2061, 6158, 2062, 2065, 2066, 2067, 2068, 2069, 6164, 6167, 2070, 2071, 2073, 2074, 2075, 2076, 2077, 2079, 2080, 2081, 2082, 2083, 2084, 2085, 6179, 2087, 6186, 6187, 6190, 6191, 2095, 2097, 2098, 6194, 2100, 6197, 6196, 2106, 6202, 2108, 2110, 2111, 6207, 6210, 2116, 2125, 2126, 6224, 2129, 6226, 2133, 2134, 6231, 6232, 6233, 2137, 2138, 2139, 2141, 2143, 2144, 2148, 2150, 6248, 2153, 2154, 2155, 6251, 6252, 2159, 6255, 2160, 2161, 2164, 6260, 2166, 2167, 2168, 2169, 2171, 2173, 2174, 2175, 2176, 2177, 6269, 6270, 6271, 6276, 6278, 6277, 2184, 6280, 6282, 2186, 6283, 2188, 2189, 6285, 2191, 6289, 2194, 2195, 2196, 2197, 6293, 6295, 6296, 6297, 6300, 6302, 6304, 2208, 2209, 6307, 2210, 6306, 2213, 2214, 6311, 6314, 6315, 2220, 6317, 6316, 6318, 6319, 2224, 2225, 6323, 6320, 6321, 6325, 6326, 6327, 2232, 6328, 6331, 2234, 6329, 6332, 6333, 6336, 6334, 6335, 6338, 6340, 6341, 6342, 6343, 6344, 6345, 6346, 6347, 6348, 6349, 6350, 6351, 6352, 6354, 6355, 6356, 6357, 2262, 6358, 6359, 6360, 6362, 6363, 2266, 6361, 6364, 2269, 2270, 2271, 2272, 6369, 2274, 6373, 6370, 6375, 6371, 6372, 6374, 6379, 2281, 6381, 6382, 6383, 6384, 6377, 6378, 6387, 6380, 6385, 6386, 6391, 6392, 6388, 6394, 6389, 6396, 6390, 6398, 6399, 6393, 2298, 6402, 6395, 2302, 2304, 6401, 2307, 6404, 6405, 6410, 6407, 6412, 6413, 6408, 2313, 6416, 6411, 6418, 2316, 2318, 6414, 6422, 6415, 6417, 6425, 6426, 2323, 6428, 2324, 6430, 6424, 6429, 6433, 6434, 6435, 6431, 6437, 2339, 6439, 6436, 6438, 6442, 6440, 6444, 2345, 2346, 2347, 6448, 2348, 2349, 2350, 6452, 6453, 2351, 2352, 2354, 2355, 6449, 6450, 6460, 6454, 6458, 6461, 6462, 6463, 6467, 6468, 2373, 6470, 6469, 2375, 6473, 6474, 6471, 6476, 6472, 6475, 2380, 2381, 6481, 2382, 6483, 6477, 6485, 2384, 2385, 6488, 6489, 6484, 2391, 6487, 6493, 2394, 2395, 6491, 6492, 6498, 6499, 6500, 6494, 2399, 6503, 6495, 6505, 6506, 2406, 2407, 6509, 6510, 6511, 2408, 2410, 6514, 6515, 2411, 6517, 6518, 6519, 6520, 6521, 6522, 6523, 6524, 6525, 6526, 2424, 6528, 6529, 6530, 2426, 6532, 6533, 6534, 2430, 6536, 6537, 6538, 6539, 6540, 6541, 6542, 6535, 6544, 6545, 2443, 6547, 6548, 6543, 2449, 2450, 6552, 6553, 6554, 6555, 6556, 6557, 6558, 6559, 6560, 2456, 6562, 6563, 2459, 6565, 6566, 6567, 6568, 6569, 6570, 6571, 6572, 6573, 2470, 6575, 6576, 6577, 6578, 6579, 6580, 6581, 6582, 6583, 6584, 6585, 6586, 6587, 6589, 6590, 6591, 6592, 6593, 6594, 6595, 6596, 6597, 6598, 2495, 6600, 6601, 6602, 6603, 6604, 6605, 6606, 6607, 6608, 6609, 6610, 6611, 6612, 6613, 6614, 6615, 2511, 6618, 6619, 6620, 6621, 6622, 6623, 6624, 2523, 6626, 6627, 6628, 6629, 6630, 6631, 6632, 2528, 6634, 6635, 6636, 6637, 2543, 6642, 6644, 6645, 2548, 6648, 6649, 6650, 6651, 6652, 2554, 6656, 6657, 6658, 6659, 6662, 6663, 6664, 2566, 6666, 2567, 2568, 6669, 6670, 6671, 6672, 6673, 6678, 6679, 6680, 6681, 6682, 6683, 6685, 6686, 6687, 6688, 6689, 6693, 6694, 6696, 6697, 6698, 6699, 2605, 6702, 2609, 6708, 2612, 2614, 6713, 2630, 2632, 2637, 6734, 2640, 2644, 2654, 2655, 2660, 2662, 2666, 2667, 2672, 2681, 2683, 2684, 2685, 2686, 2689, 2691, 2692, 2693, 2694, 2695, 2696, 2697, 2698, 2700, 2701, 2703, 2704, 2705, 2707, 2709, 2710, 2712, 2713, 2716, 2717, 2718, 2728, 2730, 2734, 2740, 2748, 2782, 3101, 3133, 3139, 3142, 3203, 3207, 3222, 3226, 3227, 3231, 3232, 3233, 3243, 3247, 3251, 3256, 3257, 3259, 3263, 3277, 3284, 3286, 3292, 3293, 3298, 3299, 3310, 3312, 3317, 3319, 3320, 3322, 3329, 3332, 3333, 3335, 3338, 3339, 3340, 3341, 3344, 3349, 3350, 3351, 3359, 3360, 3362, 3363, 3364, 3366, 3367, 3370, 3371, 3372, 3373, 3375, 3376, 3379, 3381, 3382, 3383, 3384, 3386, 3396, 3399, 3402, 3403, 3406, 3408, 3411, 3412, 3414, 3419, 3426, 2325, 3550, 6419, 6421, 3651, 3664, 3668, 3693, 3700, 3704, 3710, 3717, 3729, 6441, 3736, 3738, 6443, 6445, 3764, 6447, 3768, 3776, 3778, 3779, 3783, 3785, 3789, 3790, 3792, 3794, 3801, 3803, 3809, 3812, 3814, 3825, 3827, 3828, 3829, 3833, 3836, 3841, 3847, 3848, 3849, 3851, 3854, 3855, 3857, 3858, 3860, 3861, 3862, 3863, 3864, 3866, 3867, 3868, 3869, 3872, 3874, 3879, 3886, 3887, 3888, 3889, 3890, 3891, 3892, 3893, 3896, 3897, 3900, 3901, 3905, 5661, 3908, 3915, 3917, 6478, 3926, 3928, 3930, 3943, 3946, 3947, 3950, 3951, 3953, 3954, 3956, 2415, 3959, 3963, 2416, 3966, 2419, 3980, 3981, 2421, 3992, 3997, 4006, 6496, 6497, 2427, 2431, 6502, 2432, 2433, 6504, 2434, 2435, 2436, 6507, 2440}",1536,"{0, 1, 2, 3, 4, 5, 6, 7, 8, 9, 10, 11, 12, 13, 14, 15, 16, 17, 18, 20, 21, 22, 23, 24, 25, 27, 28, 29, 30, 31, 32, 33, 34, 35, 36, 37, 38, 39, 42, 43, 44, 45, 46, 47, 48, 49, 50, 51, 52, 53, 54, 55, 56, 57, 58, 59, 60, 61, 62, 64, 65, 66, 67, 68, 69, 70, 71, 72, 73, 74, 75, 78, 79, 80, 81, 83, 84, 85, 86, 88, 89, 90, 91, 92, 93, 94, 95, 96, 97, 98, 99, 100, 101, 102, 103, 104, 105, 106, 107, 108, 109, 110, 111, 112, 113, 114, 115, 116, 117, 118, 123, 124, 125, 126, 127, 128, 129, 130, 131, 132, 133, 134, 135, 136, 137, 138, 139, 140, 141, 143, 144, 145, 146, 147, 148, 149, 150, 151, 153, 154, 155, 156, 158, 159, 160, 161, 162, 163, 164, 165, 166, 167, 168, 169, 171, 172, 175, 176, 179, 180, 181, 182, 183, 184, 185, 186, 187, 188, 189, 190, 191, 192, 193, 194, 195, 196, 198, 199, 200, 201, 202, 203, 204, 205, 206, 207, 208, 209, 210, 211, 212, 213, 214, 215, 216, 217, 218, 219, 220, 221, 222, 223, 224, 225, 226, 227, 228, 229, 230, 231, 232, 234, 235, 236, 237, 238, 239, 240, 241, 242, 243, 244, 245, 246, 247, 248, 249, 250, 251, 252, 253, 254, 256, 257, 258, 259, 260, 261, 262, 263, 264, 265, 266, 267, 268, 269, 271, 272, 273, 274, 275, 276, 277, 278, 279, 280, 281, 282, 283, 284, 285, 286, 287, 288, 289, 290, 291, 292, 293, 294, 295, 296, 297, 298, 300, 301, 302, 303, 305, 307, 310, 311, 312, 313, 314, 315, 316, 317, 318, 321, 322, 323, 324, 325, 326, 327, 331, 332, 333, 334, 335, 336, 337, 338, 339, 340, 341, 342, 343, 344, 345, 346, 348, 349, 350, 351, 352, 353, 356, 357, 358, 359, 360, 361, 362, 363, 364, 365, 366, 367, 368, 369, 370, 372, 373, 375, 376, 377, 378, 379, 380, 382, 383, 384, 385, 386, 387, 388, 389, 390, 391, 392, 393, 394, 395, 396, 397, 398, 399, 400, 401, 402, 403, 404, 405, 406, 407, 408, 409, 410, 411, 414, 415, 416, 417, 418, 419, 420, 421, 422, 423, 424, 425, 426, 427, 428, 429, 430, 431, 433, 434, 435, 436, 437, 438, 439, 440, 441, 443, 444, 445, 446, 447, 449, 450, 451, 452, 453, 454, 456, 457, 458, 459, 460, 461, 462, 463, 464, 465, 466, 467, 468, 469, 470, 471, 472, 473, 474, 475, 476, 477, 478, 479, 481, 482, 483, 484, 486, 487, 488, 489, 490, 491, 492, 493, 494, 495, 496, 497, 498, 499, 500, 501, 502, 503, 504, 505, 506, 507, 508, 509, 510, 511, 512, 513, 514, 515, 516, 518, 519, 520, 521, 522, 523, 524, 525, 526, 527, 528, 530, 531, 532, 533, 534, 535, 536, 537, 538, 539, 540, 541, 542, 543, 544, 545, 546, 547, 548, 549, 550, 551, 552, 553, 554, 555, 556, 557, 558, 559, 560, 561, 562, 563, 564, 565, 566, 567, 568, 569, 570, 571, 572, 573, 574, 575, 576, 577, 578, 580, 582, 583, 584, 585, 586, 590, 591, 592, 593, 594, 596, 597, 598, 599, 600, 601, 602, 603, 604, 605, 606, 607, 608, 609, 610, 611, 612, 613, 614, 616, 617, 618, 620, 621, 622, 623, 624, 625, 626, 627, 628, 629, 631, 632, 633, 634, 635, 636, 637, 638, 639, 640, 641, 642, 643, 644, 645, 646, 647, 648, 649, 650, 651, 652, 653, 654, 655, 656, 657, 658, 659, 660, 661, 662, 663, 664, 665, 666, 667, 668, 669, 670, 671, 672, 673, 674, 675, 676, 677, 678, 679, 680, 681, 682, 683, 684, 685, 686, 687, 688, 689, 690, 693, 695, 696, 697, 698, 699, 700, 701, 702, 703, 704, 705, 706, 707, 708, 709, 710, 711, 712, 713, 714, 715, 716, 717, 718, 719, 720, 721, 722, 723, 724, 725, 726, 727, 728, 729, 730, 731, 732, 733, 734, 735, 736, 737, 738, 739, 740, 741, 742, 743, 744, 745, 746, 748, 749, 750, 751, 752, 753, 754, 755, 756, 757, 758, 759, 760, 761, 762, 763, 764, 765, 766, 767, 768, 769, 770, 771, 773, 774, 775, 776, 777, 778, 779, 780, 781, 782, 783, 784, 785, 786, 787, 788, 789, 790, 791, 792, 794, 795, 796, 797, 798, 799, 800, 801, 802, 803, 804, 805, 806, 807, 808, 809, 810, 811, 812, 813, 814, 815, 816, 817, 819, 820, 821, 824, 825, 826, 828, 829, 830, 831, 832, 833, 834, 835, 836, 837, 838, 839, 840, 841, 842, 843, 844, 845, 846, 847, 848, 849, 850, 851, 852, 854, 855, 856, 857, 858, 859, 860, 861, 862, 864, 865, 866, 867, 868, 869, 870, 871, 872, 873, 874, 875, 876, 877, 878, 879, 880, 881, 882, 883, 884, 885, 886, 887, 888, 889, 890, 891, 892, 893, 894, 895, 896, 897, 898, 899, 900, 901, 902, 903, 904, 905, 906, 907, 908, 909, 910, 911, 912, 913, 914, 915, 916, 917, 918, 919, 920, 921, 922, 923, 924, 925, 926, 927, 928, 929, 930, 931, 932, 933, 935, 936, 937, 939, 940, 941, 942, 943, 944, 945, 946, 947, 948, 949, 950, 951, 952, 953, 954, 955, 956, 957, 958, 959, 960, 961, 962, 963, 964, 965, 966, 967, 968, 969, 970, 971, 972, 973, 974, 975, 976, 977, 978, 979, 980, 981, 982, 983, 984, 985, 986, 987, 988, 990, 991, 992, 993, 994, 996, 997, 998, 999, 1000, 1001, 1002, 1003, 1004, 1005, 1006, 1007, 1008, 1009, 1010, 1011, 1012, 1013, 1014, 1015, 1016, 1017, 1018, 1019, 1020, 1021, 1022, 1023, 1024, 1025, 1026, 1028, 1029, 1030, 1031, 1032, 1033, 1034, 1036, 1037, 1038, 1039, 1040, 1041, 1042, 1043, 1044, 1045, 1046, 1047, 1048, 1050, 1051, 1052, 1053, 1054, 1055, 1056, 1057, 1058, 1059, 1060, 1061, 1063, 1064, 1065, 1066, 1067, 1069, 1070, 1071, 1072, 1073, 1074, 1075, 1076, 1077, 1078, 1079, 1080, 1081, 1082, 1083, 1085, 1086, 1087, 1088, 1089, 1090, 1092, 1093, 1094, 1095, 1096, 1097, 1099, 1100, 1101, 1103, 1104, 1105, 1106, 1107, 1108, 1109, 1111, 1112, 1113, 1114, 1115, 1116, 1117, 1118, 1119, 1120, 1121, 1122, 1123, 1124, 1125, 1126, 1127, 1128, 1129, 1130, 1131, 1132, 1133, 1134, 1135, 1136, 1137, 1138, 1139, 1140, 1141, 1142, 1143, 1144, 1145, 1146, 1147, 1148, 1149, 1150, 1151, 1152, 1153, 1154, 1155, 1156, 1158, 1159, 1160, 1161, 1162, 1163, 1164, 1165, 1166, 1167, 1168, 1169, 1170, 1171, 1172, 1173, 1174, 1175, 1176, 1177, 1179, 1180, 1181, 1182, 1183, 1184, 1185, 1186, 1187, 1188, 1189, 1190, 1191, 1193, 1194, 1195, 1196, 1197, 1198, 1199, 1200, 1201, 1202, 1203, 1204, 1205, 1206, 1207, 1208, 1209, 1210, 1211, 1212, 1213, 1214, 1215, 1216, 1217, 1218, 1219, 1220, 1221, 1222, 1223, 1224, 1225, 1226, 1227, 1228, 1229, 1230, 1231, 1232, 1233, 1234, 1235, 1236, 1237, 1238, 1239, 1240, 1241, 1242, 1244, 1246, 1247, 1250, 1251, 1252, 1253, 1254, 1255, 1258, 1259, 1260, 1262, 1263, 1264, 1265, 1267, 1268, 1269, 1270, 1271, 1273, 1274, 1275, 1276, 1277, 1278, 1279, 1280, 1281, 1282, 1283, 1284, 1285, 1287, 1288, 1289, 1290, 1291, 1292, 1293, 1294, 1295, 1297, 1298, 1300, 1301, 1302, 1303, 1304, 1305, 1307, 1308, 1309, 1310, 1311, 1313, 1314, 1315, 1317, 1318, 1320, 1321, 1323, 1324, 1325, 1327, 1328, 1333, 1334, 1335, 1336, 1338, 1339, 1340, 1342, 1344, 1345, 1346, 1348, 1349, 1351, 1353, 1354, 1355, 1357, 1358, 1359, 1361, 1362, 1365, 1366, 1367, 1368, 1369, 1370, 1373, 1375, 1377, 1378, 1380, 1384, 1385, 1386, 1387, 1388, 1389, 1390, 1391, 1392, 1393, 1394, 1396, 1397, 1399, 1403, 1405, 1409, 1411, 1412, 1415, 1416, 1418, 1420, 1421, 1423, 1427, 1428, 1437, 1441, 1442, 1443, 1447, 1449, 1450, 1451, 1459, 1465, 1466, 1468, 1473, 1475, 1476, 1477, 1482, 1483, 1492, 1494, 1499, 1500, 1502, 1506, 1508, 1509, 1510, 1514, 1515, 1517, 1519, 1520, 1521, 1522, 1523, 1527, 1528, 1531, 1532, 1533, 1534, 1535, 1538, 1540, 1541, 1542, 1543, 1544, 1545, 1551, 1552, 1553, 1554, 1559, 1562, 1564, 1566, 1568, 1570, 1571, 1572, 1575, 1576, 1577, 1578, 1580, 1581, 1582, 1584, 1585, 1586, 1588, 1590, 1593, 1597, 1598, 1601, 1602, 1604, 1605, 1606, 1607, 1608, 1609, 1612, 1613, 1614, 1615, 1616, 1617, 1618, 1619, 1621, 1626, 1628, 1629, 1630, 1631, 1632, 1633, 1634, 1635, 1636, 1638, 1639, 1641, 1643, 1644, 1646, 1647, 1649, 1650, 1651, 1652, 1653, 1654, 1656, 1657, 1658, 1659, 1660, 1661, 1662, 1663, 1664, 1665, 1666, 1667, 1668, 1669, 1670, 1671, 1672, 1673, 1674, 1675, 1678, 1679, 1680, 1681, 1682, 1683, 1684, 1685, 1686, 1687, 1688, 1689, 1690, 1691, 1692, 1693, 1694, 1695, 1696, 1697, 1698, 1700, 1701, 1702, 1703, 1704, 1705, 1706, 1707, 1708, 1709, 1710, 1711, 1712, 1713, 1714, 1715, 1716, 1717, 1718, 1719, 1720, 1721, 1722, 1723, 1724, 1725, 1726, 1727, 1728, 1729, 1730, 1731, 1732, 1734, 1735, 1736, 1738, 1739, 1740, 1741, 1744, 1745, 1746, 1747, 1748, 1749, 1752, 1753, 1754, 1756, 1757, 1758, 1761, 1762, 1764, 1765, 1766, 1767, 1768, 1769, 1771, 1772, 1773, 1774, 1776, 1778, 1779, 1780, 1781, 1783, 1785, 1786, 1787, 1788, 1789, 1790, 1795, 1796, 1797, 1800, 1806, 1807, 1809, 1813, 1815, 1816, 1818, 1820, 1821, 1822, 1823, 1825, 1827, 1828, 1829, 1830, 1831, 1833, 1834, 1835, 1837, 1838, 1840, 1841, 1842, 1843, 1846, 1848, 1849, 1851, 1853, 1854, 1855, 1859, 1860, 1862, 1863, 1864, 1870, 1873, 1875, 1876, 1878, 1887, 1889, 1892, 1893, 1896, 1904, 1905, 1909, 1910, 1914, 1919, 1920, 1928, 1929, 1938, 1947, 1948, 1949, 1957, 1959, 1965, 1971, 1972, 1976, 1977, 1978, 1979, 1985, 1986, 1987, 1988, 1993, 1995, 1996, 1998, 2000, 2004, 2005, 2007, 2010, 2011, 2020, 2021, 2022, 2025, 2026, 2029, 2030, 2031, 2032, 2035, 2036, 2037, 2038, 2041, 2044, 2048, 2049, 2050, 2052, 2063, 2064, 2086, 2088, 2089, 2090, 2091, 2092, 2094, 2096, 2099, 2101, 2102, 2103, 2104, 2107, 2109, 2112, 2113, 2114, 2115, 2117, 2118, 2119, 2120, 2121, 2122, 2123, 2124, 2128, 2130, 2131, 2132, 2135, 2140, 2142, 2146, 2147, 2149, 2151, 2152, 2156, 2157, 2158, 2162, 2163, 2170, 2172, 2178, 2179, 2180, 2181, 2182, 2183, 2185, 2187, 2190, 2192, 2193, 2198, 2200, 2201, 2202, 2203, 2204, 2205, 2206, 2207, 2211, 2212, 2215, 2216, 2217, 2218, 2219, 2221, 2222, 2223, 2226, 2228, 2229, 2230, 2231, 2233, 2235, 2236, 2237, 2239, 2240, 2241, 2242, 2243, 2244, 2245, 2246, 2247, 2248, 2249, 2250, 2251, 2252, 2253, 2254, 2255, 2259, 2260, 2261, 2263, 2264, 2265, 2267, 2268, 2273, 2275, 2276, 2277, 2280, 2282, 2283, 2284, 2285, 2287, 2288, 2289, 2290, 2291, 2292, 2293, 2294, 2295, 2296, 2297, 2299, 2300, 2301, 2303, 2305, 2306, 2309, 2310, 2311, 2312, 2315, 2317, 2319, 2320, 2321, 2322, 2327, 2328, 2329, 2330, 2331, 2332, 2333, 2334, 2335, 2336, 2337, 2338, 2340, 2341, 2342, 2344, 2353, 2356, 2357, 2358, 2359, 2360, 2361, 2362, 2363, 2364, 2365, 2366, 2367, 2368, 2369, 2370, 2371, 2374, 2376, 2377, 2378, 2379, 2383, 2386, 2387, 2388, 2389, 2390, 2392, 2393, 2396, 2397, 2398, 2401, 2402, 2403, 2404, 2405, 2409, 2412, 2413, 2414, 2420, 2422, 2423, 2425, 2428, 2429, 2437, 2438, 2439, 2441, 2442, 2444, 2445, 2446, 2448, 2453, 2454, 2458, 2460, 2461, 2463, 2464, 2465, 2467, 2469, 2473, 2474, 2476, 2479, 2480, 2483, 2484, 2485, 2486, 2487, 2488, 2489, 2490, 2491, 2492, 2494, 2501, 2504, 2505, 2506, 2509, 2510, 2512, 2513, 2514, 2515, 2516, 2517, 2518, 2519, 2520, 2521, 2522, 2524, 2525, 2526, 2527, 2529, 2531, 2532, 2533, 2534, 2535, 2536, 2537, 2538, 2540, 2541, 2542, 2544, 2546, 2547, 2549, 2550, 2551, 2552, 2553, 2555, 2556, 2557, 2558, 2559, 2560, 2561, 2562, 2563, 2564, 2569, 2570, 2572, 2574, 2575, 2576, 2577, 2578, 2579, 2580, 2581, 2582, 2583, 2584, 2585, 2586, 2587, 2590, 2591, 2592, 2593, 2594, 2595, 2596, 2597, 2598, 2599, 2600, 2601, 2603, 2604, 2606, 2607, 2608, 2610, 2611, 2613, 2615, 2616, 2617, 2620, 2621, 2622, 2623, 2624, 2625, 2626, 2627, 2628, 2629, 2631, 2633, 2635, 2636, 2638, 2639, 2641, 2642, 2643, 2645, 2646, 2647, 2648, 2649, 2650, 2652, 2653, 2656, 2657, 2658, 2659, 2664, 2668, 2669, 2671, 2673, 2674, 2677, 2679, 2680, 2682, 2687, 2688, 2690, 2699, 2706, 2708, 2711, 2715, 2720, 2721, 2723, 2724, 2725, 2726, 2727, 2729, 2731, 2732, 2733, 2735, 2736, 2737, 2738, 2739, 2741, 2744, 2745, 2746, 2747, 2749, 2750, 2751, 2753, 2754, 2755, 2756, 2757, 2758, 2759, 2760, 2761, 2762, 2763, 2764, 2765, 2766, 2768, 2769, 2770, 2771, 2772, 2773, 2774, 2775, 2776, 2777, 2779, 2780, 2783, 2784, 2785, 2786, 2787, 2789, 2790, 2791, 2792, 2793, 2794, 2795, 2796, 2797, 2798, 2799, 2800, 2801, 2802, 2803, 2804, 2805, 2806, 2807, 2808, 2809, 2811, 2812, 2813, 2814, 2815, 2816, 2817, 2818, 2819, 2820, 2821, 2822, 2823, 2825, 2826, 2827, 2828, 2830, 2831, 2832, 2833, 2834, 2835, 2836, 2837, 2838, 2839, 2840, 2841, 2842, 2843, 2844, 2845, 2846, 2847, 2848, 2849, 2850, 2851, 2852, 2853, 2854, 2855, 2856, 2857, 2858, 2859, 2860, 2861, 2862, 2863, 2865, 2866, 2867, 2868, 2869, 2870, 2871, 2872, 2873, 2874, 2875, 2877, 2878, 2880, 2883, 2884, 2886, 2887, 2888, 2889, 2890, 2891, 2892, 2893, 2894, 2895, 2896, 2897, 2898, 2899, 2900, 2901, 2902, 2903, 2904, 2905, 2906, 2907, 2908, 2909, 2910, 2911, 2912, 2914, 2915, 2916, 2917, 2918, 2919, 2920, 2921, 2923, 2924, 2925, 2926, 2927, 2930, 2931, 2932, 2933, 2934, 2935, 2937, 2938, 2939, 2940, 2941, 2942, 2943, 2944, 2945, 2946, 2947, 2949, 2950, 2951, 2952, 2953, 2955, 2956, 2957, 2959, 2960, 2961, 2962, 2963, 2965, 2966, 2967, 2968, 2969, 2970, 2971, 2972, 2973, 2974, 2975, 2976, 2977, 2978, 2979, 2980, 2981, 2982, 2983, 2984, 2985, 2986, 2987, 2988, 2989, 2990, 2991, 2992, 2993, 2994, 2995, 2996, 2997, 2998, 2999, 3000, 3001, 3002, 3003, 3004, 3005, 3006, 3007, 3008, 3009, 3010, 3011, 3012, 3014, 3015, 3016, 3017, 3018, 3019, 3020, 3022, 3023, 3024, 3025, 3026, 3027, 3028, 3029, 3030, 3031, 3032, 3033, 3034, 3035, 3036, 3037, 3038, 3039, 3040, 3042, 3043, 3044, 3045, 3046, 3047, 3048, 3049, 3050, 3051, 3052, 3053, 3054, 3055, 3057, 3058, 3059, 3060, 3061, 3062, 3063, 3064, 3065, 3066, 3067, 3068, 3070, 3071, 3072, 3073, 3074, 3075, 3076, 3077, 3079, 3080, 3081, 3082, 3083, 3084, 3086, 3087, 3088, 3089, 3090, 3091, 3093, 3094, 3095, 3096, 3097, 3098, 3099, 3100, 3102, 3103, 3104, 3105, 3106, 3107, 3108, 3109, 3110, 3111, 3112, 3113, 3114, 3115, 3116, 3118, 3119, 3120, 3121, 3122, 3123, 3124, 3125, 3126, 3127, 3128, 3131, 3132, 3134, 3135, 3136, 3137, 3138, 3141, 3143, 3144, 3146, 3147, 3149, 3150, 3151, 3152, 3153, 3155, 3156, 3157, 3158, 3159, 3160, 3162, 3163, 3164, 3165, 3166, 3167, 3169, 3170, 3171, 3172, 3173, 3174, 3175, 3176, 3177, 3178, 3179, 3180, 3181, 3182, 3183, 3184, 3185, 3186, 3187, 3188, 3189, 3190, 3191, 3192, 3193, 3194, 3195, 3196, 3197, 3198, 3199, 3200, 3201, 3202, 3204, 3205, 3206, 3208, 3209, 3210, 3211, 3212, 3213, 3214, 3215, 3216, 3217, 3218, 3219, 3223, 3224, 3225, 3228, 3229, 3234, 3236, 3240, 3241, 3242, 3244, 3245, 3248, 3249, 3250, 3252, 3253, 3254, 3255, 3258, 3260, 3261, 3262, 3265, 3269, 3270, 3271, 3272, 3273, 3276, 3279, 3280, 3281, 3282, 3283, 3285, 3287, 3288, 3289, 3291, 3294, 3295, 3296, 3300, 3301, 3302, 3303, 3304, 3305, 3306, 3307, 3311, 3313, 3314, 3316, 3318, 3321, 3323, 3325, 3326, 3327, 3328, 3330, 3331, 3334, 3337, 3342, 3343, 3345, 3346, 3347, 3352, 3353, 3354, 3355, 3356, 3357, 3358, 3368, 3369, 3374, 3377, 3378, 3380, 3387, 3388, 3389, 3390, 3391, 3392, 3393, 3394, 3397, 3398, 3400, 3401, 3404, 3405, 3407, 3410, 3413, 3415, 3416, 3417, 3418, 3421, 3422, 3423, 3424, 3427, 3428, 3429, 3430, 3431, 3432, 3433, 3434, 3435, 3436, 3437, 3438, 3439, 3440, 3441, 3442, 3443, 3444, 3445, 3446, 3447, 3448, 3449, 3450, 3451, 3452, 3453, 3454, 3455, 3456, 3457, 3459, 3460, 3461, 3462, 3465, 3466, 3467, 3468, 3469, 3470, 3471, 3472, 3473, 3474, 3476, 3477, 3480, 3481, 3482, 3483, 3484, 3485, 3486, 3487, 3488, 3489, 3490, 3491, 3492, 3493, 3494, 3495, 3497, 3498, 3499, 3500, 3501, 3502, 3503, 3504, 3505, 3506, 3507, 3509, 3510, 3511, 3512, 3513, 3514, 3515, 3516, 3519, 3520, 3521, 3522, 3523, 3525, 3526, 3527, 3528, 3529, 3530, 3531, 3532, 3533, 3534, 3535, 3536, 3538, 3539, 3540, 3541, 3542, 3543, 3544, 3545, 3546, 3547, 3548, 3549, 3551, 3552, 3553, 3554, 3556, 3557, 3558, 3559, 3562, 3563, 3564, 3565, 3566, 3567, 3568, 3569, 3570, 3571, 3572, 3573, 3574, 3575, 3576, 3577, 3578, 3580, 3581, 3582, 3583, 3584, 3585, 3586, 3588, 3589, 3591, 3592, 3593, 3594, 3595, 3596, 3598, 3599, 3600, 3601, 3602, 3603, 3604, 3605, 3606, 3607, 3608, 3609, 3610, 3611, 3612, 3613, 3614, 3615, 3616, 3617, 3618, 3620, 3621, 3622, 3623, 3624, 3625, 3626, 3627, 3628, 3629, 3630, 3631, 3632, 3633, 3634, 3635, 3636, 3637, 3638, 3639, 3640, 3642, 3644, 3645, 3646, 3647, 3648, 3649, 3650, 3652, 3653, 3655, 3656, 3657, 3658, 3660, 3661, 3662, 3663, 3665, 3666, 3667, 3669, 3670, 3671, 3672, 3673, 3674, 3675, 3676, 3677, 3678, 3679, 3680, 3681, 3682, 3683, 3684, 3685, 3686, 3687, 3688, 3689, 3690, 3691, 3692, 3694, 3696, 3697, 3698, 3699, 3701, 3702, 3703, 3705, 3706, 3707, 3708, 3709, 3711, 3712, 3713, 3716, 3718, 3719, 3721, 3722, 3724, 3728, 3730, 3731, 3732, 3733, 3734, 3735, 3737, 3739, 3740, 3743, 3744, 3748, 3749, 3750, 3751, 3752, 3753, 3754, 3756, 3757, 3758, 3759, 3760, 3761, 3762, 3763, 3765, 3766, 3767, 3769, 3770, 3772, 3773, 3774, 3775, 3777, 3781, 3782, 3784, 3786, 3787, 3788, 3791, 3793, 3795, 3796, 3797, 3798, 3799, 3800, 3802, 3804, 3805, 3806, 3807, 3808, 3810, 3811, 3813, 3815, 3817, 3818, 3819, 3820, 3821, 3822, 3823, 3826, 3830, 3831, 3832, 3834, 3835, 3837, 3838, 3839, 3840, 3843, 3844, 3845, 3846, 3850, 3852, 3853, 3856, 3859, 3870, 3871, 3873, 3875, 3877, 3878, 3880, 3884, 3894, 3895, 3898, 3899, 3902, 3903, 3904, 3906, 3907, 3910, 3912, 3913, 3918, 3919, 3920, 3921, 3922, 3923, 3924, 3925, 3927, 3929, 3932, 3933, 3934, 3935, 3936, 3937, 3938, 3939, 3940, 3941, 3944, 3945, 3948, 3949, 3952, 3955, 3957, 3958, 3960, 3962, 3964, 3965, 3967, 3969, 3972, 3973, 3974, 3975, 3976, 3977, 3978, 3979, 3982, 3983, 3984, 3985, 3986, 3987, 3988, 3989, 3990, 3991, 3993, 3994, 3995, 3996, 3998, 3999, 4000, 4001, 4002, 4003, 4004, 4005, 4007, 4008, 4009, 4010, 4011, 4012, 4013, 4014, 4016, 4017, 4018, 4019, 4020, 4021, 4022, 4023, 4024, 4025, 4026, 4027, 4028, 4029, 4030, 4031, 4032, 4033, 4034, 4037, 4038, 4039, 4040, 4041, 4042, 4043, 4044, 4045, 4046, 4047, 4049, 4050, 4053, 4054, 4055, 4056, 4057, 4058, 4059, 4060, 4061, 4062, 4063, 4067, 4068, 4069, 4070, 4071, 4072, 4073, 4074, 4075, 4076, 4077, 4078, 4079, 4080, 4081, 4082, 4083, 4084, 4085, 4086, 4087, 4088, 4089, 4090, 4091, 4092, 4093, 4094, 4095, 4096, 4097, 4098, 4099, 4100, 4101, 4102, 4103, 4104, 4105, 4106, 4107, 4108, 4109, 4111, 4112, 4113, 4114, 4115, 4116, 4117, 4118, 4119, 4120, 4121, 4122, 4123, 4124, 4125, 4126, 4127, 4128, 4129, 4131, 4132, 4133, 4134, 4135, 4136, 4137, 4138, 4139, 4140, 4141, 4142, 4143, 4144, 4145, 4147, 4148, 4149, 4150, 4151, 4152, 4153, 4154, 4155, 4156, 4157, 4158, 4159, 4160, 4161, 4163, 4164, 4165, 4166, 4167, 4168, 4169, 4170, 4171, 4172, 4173, 4174, 4175, 4176, 4177, 4178, 4179, 4181, 4182, 4183, 4184, 4185, 4186, 4187, 4188, 4189, 4190, 4191, 4192, 4193, 4194, 4195, 4196, 4197, 4198, 4200, 4201, 4202, 4203, 4204, 4205, 4206, 4207, 4208, 4209, 4210, 4211, 4212, 4213, 4214, 4215, 4216, 4217, 4218, 4219, 4221, 4222, 4223, 4224, 4225, 4226, 4227, 4228, 4229, 4230, 4231, 4232, 4233, 4234, 4235, 4237, 4238, 4239, 4240, 4242, 4243, 4244, 4245, 4246, 4247, 4248, 4249, 4250, 4251, 4252, 4253, 4254, 4255, 4256, 4257, 4258, 4259, 4260, 4261, 4262, 4263, 4264, 4265, 4266, 4267, 4269, 4270, 4271, 4272, 4273, 4275, 4276, 4277, 4278, 4279, 4280, 4281, 4282, 4283, 4284, 4286, 4287, 4288, 4289, 4290, 4292, 4293, 4294, 4295, 4297, 4298, 4299, 4300, 4301, 4302, 4303, 4304, 4305, 4306, 4307, 4308, 4309, 4310, 4311, 4312, 4313, 4314, 4315, 4316, 4317, 4318, 4319, 4320, 4321, 4322, 4323, 4325, 4326, 4327, 4328, 4329, 4330, 4331, 4332, 4333, 4334, 4335, 4336, 4337, 4339, 4340, 4341, 4342, 4343, 4344, 4345, 4346, 4347, 4348, 4349, 4350, 4351, 4352, 4353, 4354, 4356, 4357, 4359, 4361, 4362, 4363, 4364, 4365, 4366, 4367, 4368, 4369, 4370, 4371, 4372, 4373, 4374, 4375, 4376, 4377, 4378, 4379, 4380, 4381, 4382, 4383, 4384, 4385, 4386, 4387, 4388, 4389, 4390, 4391, 4392, 4393, 4394, 4395, 4396, 4397, 4398, 4399, 4400, 4401, 4402, 4403, 4404, 4405, 4406, 4407, 4408, 4409, 4410, 4411, 4412, 4413, 4414, 4415, 4416, 4417, 4418, 4419, 4420, 4421, 4423, 4424, 4425, 4426, 4427, 4428, 4429, 4430, 4432, 4433, 4434, 4435, 4436, 4437, 4438, 4439, 4440, 4441, 4442, 4443, 4444, 4445, 4447, 4448, 4449, 4450, 4451, 4452, 4453, 4455, 4456, 4457, 4458, 4459, 4460, 4461, 4463, 4465, 4466, 4467, 4468, 4469, 4471, 4472, 4473, 4474, 4477, 4478, 4479, 4480, 4481, 4482, 4483, 4484, 4485, 4486, 4487, 4488, 4489, 4490, 4491, 4494, 4495, 4496, 4497, 4498, 4499, 4500, 4501, 4502, 4503, 4504, 4505, 4506, 4507, 4508, 4509, 4510, 4511, 4512, 4513, 4514, 4515, 4516, 4517, 4518, 4519, 4520, 4521, 4522, 4523, 4524, 4525, 4526, 4527, 4528, 4529, 4530, 4531, 4532, 4533, 4534, 4535, 4536, 4538, 4539, 4540, 4541, 4542, 4543, 4544, 4545, 4546, 4547, 4548, 4549, 4551, 4552, 4553, 4554, 4555, 4556, 4557, 4558, 4559, 4560, 4561, 4562, 4563, 4564, 4565, 4566, 4567, 4568, 4569, 4570, 4571, 4572, 4573, 4574, 4575, 4576, 4577, 4578, 4579, 4580, 4581, 4582, 4583, 4584, 4585, 4586, 4587, 4588, 4589, 4590, 4591, 4593, 4594, 4595, 4596, 4597, 4598, 4599, 4600, 4601, 4602, 4603, 4604, 4605, 4606, 4607, 4608, 4610, 4611, 4612, 4613, 4614, 4615, 4616, 4618, 4619, 4620, 4622, 4623, 4624, 4625, 4627, 4628, 4629, 4630, 4632, 4633, 4634, 4635, 4636, 4639, 4640, 4641, 4642, 4643, 4644, 4645, 4646, 4647, 4648, 4650, 4651, 4652, 4653, 4654, 4655, 4656, 4657, 4658, 4659, 4660, 4661, 4662, 4663, 4664, 4665, 4666, 4668, 4670, 4671, 4672, 4673, 4674, 4675, 4676, 4678, 4679, 4680, 4681, 4682, 4683, 4684, 4685, 4686, 4687, 4688, 4689, 4691, 4692, 4693, 4694, 4696, 4697, 4709, 4720, 4722, 4723, 4724, 4725, 4726, 4729, 4730, 4731, 4736, 4737, 4738, 4739, 4740, 4741, 4742, 4744, 4745, 4746, 4747, 4748, 4749, 4751, 4755, 4756, 4757, 4758, 4759, 4761, 4763, 4764, 4767, 4771, 4772, 4773, 4774, 4775, 4776, 4779, 4780, 4781, 4783, 4784, 4785, 4788, 4789, 4790, 4795, 4796, 4797, 4798, 4799, 4801, 4803, 4804, 4805, 4806, 4807, 4813, 4814, 4815, 4816, 4822, 4827, 4828, 4829, 4832, 4833, 4834, 4835, 4836, 4837, 4839, 4840, 4842, 4843, 4844, 4846, 4847, 4848, 4849, 4850, 4852, 4853, 4854, 4855, 4856, 4857, 4858, 4859, 4860, 4862, 4863, 4864, 4865, 4866, 4867, 4872, 4875, 4876, 4877, 4878, 4879, 4880, 4882, 4883, 4885, 4887, 4888, 4889, 4890, 4891, 4892, 4893, 4894, 4895, 4897, 4898, 4899, 4900, 4901, 4902, 4903, 4907, 4908, 4909, 4910, 4912, 4914, 4915, 4916, 4917, 4918, 4920, 4921, 4922, 4923, 4926, 4927, 4929, 4930, 4931, 4932, 4936, 4940, 4942, 4943, 4944, 4945, 4946, 4947, 4948, 4949, 4950, 4951, 4952, 4956, 4957, 4958, 4959, 4960, 4963, 4964, 4965, 4969, 4971, 4972, 4973, 4974, 4975, 4977, 4978, 4979, 4981, 4983, 4984, 4986, 4987, 4988, 4989, 4990, 4991, 4993, 4995, 4996, 4997, 5000, 5001, 5003, 5004, 5005, 5006, 5009, 5014, 5015, 5017, 5018, 5019, 5020, 5021, 5023, 5024, 5026, 5027, 5029, 5031, 5032, 5033, 5034, 5035, 5036, 5038, 5043, 5044, 5045, 5046, 5048, 5049, 5053, 5056, 5057, 5059, 5062, 5070, 5071, 5075, 5086, 5087, 5090, 5103, 5104, 5106, 5111, 5112, 5113, 5114, 5116, 5118, 5120, 5124, 5125, 5126, 5127, 5128, 5129, 5130, 5131, 5132, 5133, 5134, 5135, 5136, 5137, 5138, 5139, 5140, 5141, 5142, 5143, 5144, 5145, 5149, 5150, 5151, 5153, 5155, 5156, 5158, 5159, 5160, 5161, 5162, 5163, 5165, 5166, 5167, 5168, 5169, 5170, 5174, 5175, 5178, 5179, 5182, 5183, 5185, 5186, 5187, 5190, 5192, 5193, 5195, 5196, 5197, 5198, 5199, 5200, 5201, 5202, 5203, 5204, 5205, 5206, 5207, 5208, 5209, 5210, 5213, 5214, 5215, 5217, 5218, 5219, 5220, 5225, 5229, 5230, 5231, 5232, 5233, 5237, 5238, 5239, 5240, 5242, 5246, 5248, 5249, 5251, 5252, 5254, 5256, 5257, 5259, 5260, 5262, 5264, 5266, 5269, 5270, 5272, 5273, 5274, 5275, 5278, 5279, 5283, 5285, 5286, 5287, 5288, 5290, 5292, 5295, 5297, 5298, 5299, 5304, 5309, 5312, 5313, 5317, 5320, 5321, 5327, 5328, 5329, 5333, 5334, 5338, 5339, 5340, 5342, 5350, 5351, 5352, 5354, 5358, 5359, 5364, 5366, 5371, 5372, 5375, 5376, 5377, 5381, 5383, 5384, 5385, 5386, 5387, 5388, 5389, 5390, 5391, 5393, 5394, 5397, 5398, 5401, 5402, 5404, 5406, 5407, 5408, 5409, 5411, 5414, 5417, 5425, 5428, 5429, 5430, 5432, 5434, 5435, 5437, 5439, 5442, 5443, 5444, 5445, 5446, 5448, 5449, 5450, 5451, 5452, 5454, 5455, 5456, 5462, 5463, 5466, 5468, 5470, 5471, 5473, 5474, 5475, 5476, 5477, 5479, 5484, 5485, 5486, 5487, 5488, 5489, 5490, 5491, 5492, 5493, 5494, 5495, 5497, 5500, 5502, 5503, 5504, 5506, 5507, 5513, 5517, 5518, 5519, 5521, 5522, 5523, 5524, 5529, 5530, 5531, 5533, 5534, 5535, 5536, 5537, 5538, 5539, 5541, 5543, 5547, 5548, 5549, 5552, 5554, 5555, 5557, 5559, 5561, 5562, 5563, 5564, 5565, 5566, 5567, 5569, 5571, 5573, 5575, 5576, 5577, 5580, 5583, 5584, 5588, 5590, 5595, 5596, 5597, 5600, 5601, 5606, 5607, 5612, 5615, 5617, 5618, 5623, 5625, 5626, 5628, 5629, 5633, 5634, 5635, 5636, 5637, 5639, 5640, 5642, 5645, 5647, 5648, 5649, 5650, 5651, 5653, 5654, 5655, 5657, 5660, 5671, 5672, 5673, 5679, 5682, 5683, 5684, 5685, 5689, 5690, 5692, 5694, 5695, 5696, 5698, 5699, 5700, 5701, 5702, 5705, 5707, 5709, 5711, 5712, 5713, 5716, 5717, 5720, 5721, 5723, 5724, 5726, 5728, 5729, 5730, 5731, 5732, 5733, 5734, 5735, 5736, 5737, 5740, 5741, 5742, 5743, 5744, 5745, 5746, 5747, 5748, 5753, 5755, 5756, 5757, 5758, 5760, 5761, 5762, 5764, 5765, 5766, 5767, 5771, 5772, 5774, 5775, 5777, 5778, 5779, 5780, 5782, 5785, 5786, 5788, 5789, 5791, 5792, 5794, 5795, 5796, 5797, 5799, 5800, 5801, 5804, 5805, 5806, 5808, 5809, 5810, 5822, 5823, 5826, 5827, 5829, 5831, 5832, 5835, 5836, 5837, 5839, 5840, 5843, 5853, 5854, 5856, 5857, 5858, 5859, 5860, 5861, 5862, 5863, 5864, 5865, 5866, 5869, 5870, 5871, 5872, 5874, 5875, 5876, 5878, 5880, 5881, 5882, 5884, 5886, 5888, 5889, 5890, 5891, 5892, 5893, 5894, 5896, 5897, 5898, 5899, 5900, 5901, 5902, 5903, 5904, 5905, 5906, 5907, 5908, 5909, 5910, 5912, 5913, 5914, 5915, 5916, 5917, 5918, 5919, 5920, 5921, 5922, 5924, 5926, 5927, 5928, 5929, 5932, 5933, 5934, 5935, 5936, 5937, 5938, 5939, 5940, 5942, 5943, 5944, 5945, 5946, 5947, 5948, 5949, 5950, 5952, 5953, 5954, 5955, 5956, 5957, 5960, 5962, 5963, 5965, 5966, 5967, 5968, 5969, 5970, 5971, 5972, 5973, 5974, 5975, 5976, 5977, 5978, 5979, 5980, 5981, 5983, 5984, 5985, 5986, 5987, 5988, 5989, 5990, 5991, 5992, 5993, 5994, 5995, 5996, 5997, 5998, 5999, 6000, 6001, 6002, 6003, 6005, 6006, 6007, 6008, 6009, 6010, 6011, 6012, 6013, 6015, 6016, 6017, 6018, 6019, 6021, 6023, 6025, 6027, 6028, 6029, 6030, 6031, 6034, 6037, 6040, 6041, 6044, 6045, 6046, 6047, 6048, 6049, 6051, 6052, 6055, 6058, 6059, 6060, 6061, 6063, 6064, 6065, 6067, 6068, 6069, 6070, 6071, 6072, 6073, 6074, 6075, 6076, 6077, 6078, 6079, 6081, 6083, 6084, 6085, 6086, 6087, 6088, 6091, 6092, 6093, 6094, 6095, 6096, 6097, 6101, 6102, 6103, 6104, 6106, 6107, 6108, 6109, 6111, 6112, 6113, 6116, 6118, 6119, 6121, 6122, 6123, 6124, 6126, 6127, 6128, 6129, 6130, 6133, 6134, 6135, 6137, 6139, 6140, 6141, 6142, 6143, 6144, 6145, 6146, 6147, 6148, 6149, 6150, 6151, 6152, 6153, 6154, 6155, 6156, 6157, 6159, 6160, 6161, 6162, 6163, 6165, 6166, 6168, 6169, 6170, 6171, 6172, 6173, 6174, 6175, 6176, 6178, 6180, 6181, 6182, 6183, 6184, 6185, 6189, 6192, 6193, 6195, 6198, 6200, 6201, 6203, 6204, 6205, 6206, 6208, 6209, 6211, 6212, 6213, 6214, 6215, 6216, 6217, 6218, 6219, 6220, 6221, 6222, 6223, 6225, 6227, 6228, 6229, 6230, 6234, 6235, 6236, 6237, 6238, 6239, 6240, 6241, 6242, 6243, 6244, 6245, 6246, 6247, 6249, 6250, 6253, 6254, 6256, 6257, 6258, 6259, 6261, 6262, 6263, 6264, 6265, 6266, 6267, 6272, 6273, 6274, 6275, 6279, 6281, 6284, 6286, 6287, 6288, 6290, 6291, 6292, 6294, 6298, 6301, 6303, 6305, 6308, 6309, 6310, 6313, 6322, 6324, 6330, 6339, 6353, 6376, 6420, 6423, 6427, 6446, 6455, 6457, 6464, 6466, 6479, 6482, 6486, 6501, 6508, 6512, 6513, 6516, 6561, 6564, 6616, 6617, 6625, 6633, 6639, 6640, 6641, 6643, 6646, 6647, 6653, 6654, 6655, 6660, 6661, 6665, 6667, 6668, 6675, 6676, 6677, 6684, 6690, 6691, 6692, 6695, 6700, 6701, 6703, 6704, 6705, 6706, 6707, 6709, 6710, 6711, 6712, 6714, 6715, 6716, 6717, 6718, 6719, 6720, 6721, 6722, 6723, 6724, 6725, 6726, 6727, 6728, 6729, 6730, 6731, 6732, 6733, 6735, 6736, 6737, 6738, 6739, 6740, 6741, 6742, 6743, 6744, 6745, 6747, 6748, 6750, 6751, 6752, 6753, 6754, 6755, 6756, 6757, 6758, 6759, 6760, 6762, 6764, 6765, 6766, 6767, 6768, 6769, 6770, 6771, 6772, 6773, 6774, 6775, 6776, 6777, 6778, 6779, 6780, 6781, 6782, 6783, 6784, 6785, 6786, 6787, 6788, 6789, 6790, 6791, 6792, 6793}",4764
6,"(('enter', ('Request For Payment SUBMITTED by EMPLOYEE', 'Request For Payment APPROVED by ADMINISTRATION')), ('enter', ('Request For Payment APPROVED by ADMINISTRATION', 'Request For Payment FINAL_APPROVED by SUPERVISOR')))",2,16,"{989, 1078, 1085, 1088, 1089, 1090, 1092, 1093, 1094, 1095, 1096, 1097, 1098, 1099, 1100, 1101, 1103, 1104, 1105, 1106, 1107, 1108, 1109, 1112, 1114, 1115, 1116, 1117, 1118, 1120, 1121, 1122, 1123, 1124, 1125, 1126, 1127, 1128, 1129, 1130, 1131, 1134, 1135, 1136, 1137, 1138, 1140, 1142, 1145, 1147, 1148, 1149, 1150, 1151, 1152, 1153, 1155, 1156, 1158, 1160, 1161, 1162, 1163, 1165, 1167, 1169, 1170, 1171, 1172, 1176, 1177, 1179, 1180, 1181, 1182, 1183, 1184, 1185, 1186, 1187, 1188, 1190, 1196, 1197, 1198, 1199, 1200, 1201, 1203, 1204, 1205, 1207, 1208, 1209, 1210, 1213, 1214, 1215, 1216, 1218, 1219, 1221, 1222, 1223, 1225, 1228, 1229, 1230, 1231, 1233, 1234, 1237, 1238, 1239, 1240, 1241, 1242, 1244, 1246, 1247, 1250, 1254, 1255, 1263, 1265, 1268, 1272, 1273, 1274, 1275, 1276, 1277, 1280, 1281, 1282, 1284, 1285, 1287, 1290, 1291, 1294, 1300, 1301, 1302, 1304, 1305, 1307, 1308, 1309, 1310, 1311, 1313, 1314, 1315, 1318, 1320, 1321, 1323, 1324, 1325, 1327, 1328, 1329, 1330, 1331, 1332, 1334, 1335, 1336, 1338, 1342, 1345, 1346, 1347, 1349, 1353, 1357, 1360, 1365, 1367, 1368, 1369, 1370, 1373, 1374, 1377, 1378, 1379, 1380, 1382, 1385, 1386, 1387, 1388, 1389, 1390, 1391, 1392, 1393, 1395, 1396, 1397, 1400, 1401, 1402, 1404, 1405, 1406, 1409, 1410, 1413, 1414, 1415, 1420, 1421, 1423, 1424, 1429, 1430, 1431, 1432, 1434, 1435, 1439, 1440, 1441, 1442, 1443, 1446, 1448, 1450, 1452, 1453, 1454, 1455, 1456, 1457, 1458, 1459, 1460, 1461, 1462, 1464, 1467, 1468, 1469, 1470, 1471, 1472, 1473, 1476, 1477, 1478, 1483, 1484, 1485, 1487, 1489, 1491, 1493, 1495, 1496, 1499, 1501, 1502, 1503, 1504, 1505, 1507, 1508, 1509, 1510, 1511, 1512, 1513, 1514, 1515, 1516, 1518, 1520, 1521, 1522, 1523, 1524, 1526, 1528, 1530, 1531, 1532, 1533, 1536, 1538, 1540, 1542, 1543, 1544, 1545, 1546, 1549, 1551, 1552, 1553, 1554, 1556, 1558, 1560, 1562, 1563, 1565, 1566, 1567, 1568, 1569, 1573, 1574, 1578, 1579, 1580, 1581, 1582, 1583, 1584, 1587, 1588, 1589, 1591, 1592, 1593, 1594, 1595, 1596, 1597, 1598, 1601, 1602, 1604, 1605, 1606, 1607, 1610, 1612, 1614, 1619, 1620, 1621, 1622, 1624, 1625, 1627, 1628, 1629, 1630, 1633, 1637, 1639, 1640, 1642, 1643, 1644, 1645, 1646, 1647, 1648, 1655, 1658, 1661, 1662, 1663, 1665, 1666, 1667, 1669, 1670, 1671, 1674, 1678, 1681, 1682, 1683, 1687, 1691, 1693, 1694, 1699, 1700, 1701, 1702, 1704, 1706, 1707, 1708, 1709, 1710, 1712, 1713, 1714, 1715, 1716, 1717, 1718, 1726, 1727, 1728, 1730, 1731, 1732, 1736, 1737, 1739, 1743, 1744, 1745, 1746, 1748, 1752, 1753, 1754, 1756, 1757, 1758, 1760, 1761, 1764, 1769, 1771, 1772, 1773, 1774, 1775, 1776, 1778, 1779, 1780, 1786, 1790, 1796, 1799, 1801, 1802, 1803, 1804, 1805, 1808, 1810, 1811, 1812, 1814, 1817, 1818, 1819, 1821, 1822, 1825, 1827, 1828, 1829, 1830, 1831, 1834, 1835, 1836, 1837, 1840, 1841, 1842, 1843, 1847, 1848, 1849, 1850, 1859, 1863, 1865, 1867, 1869, 1870, 1871, 1874, 1875, 1878, 1880, 1881, 1883, 1885, 1886, 1888, 1892, 1893, 1895, 1896, 1897, 1898, 1900, 1901, 1902, 1903, 1905, 1907, 1909, 1910, 1911, 1912, 1915, 1918, 1919, 1920, 1921, 1922, 1923, 1924, 1928, 1929, 1931, 1934, 1937, 1940, 1941, 1944, 1945, 1946, 1947, 1948, 1951, 1955, 1956, 1957, 1958, 1960, 1962, 1964, 1965, 1967, 1968, 1969, 1971, 1972, 1976, 1978, 1979, 1981, 1983, 1986, 1987, 1992, 1993, 1994, 1996, 1997, 1999, 2000, 2001, 2002, 2004, 2005, 2006, 2007, 2010, 2011, 2017, 2019, 2020, 2023, 2024, 2025, 2026, 2031, 2032, 2033, 2034, 2039, 2040, 2041, 2043, 2044, 2047, 2049, 2050, 2051, 2052, 2053, 2056, 2063, 2064, 2065, 2071, 2073, 2074, 2075, 2077, 2079, 2080, 2082, 2083, 2084, 2085, 2087, 2091, 2094, 2100, 2103, 2109, 2111, 2113, 2114, 2115, 2116, 2117, 2119, 2121, 2122, 2124, 2125, 2126, 2128, 2129, 2130, 2131, 2133, 2134, 2135, 2137, 2138, 2141, 2143, 2144, 2148, 2150, 2151, 2154, 2155, 2157, 2158, 2159, 2164, 2166, 2167, 2168, 2169, 2172, 2173, 2174, 2175, 2176, 2177, 2178, 2180, 2181, 2182, 2183, 2186, 2188, 2189, 2191, 2194, 2195, 2196, 2197, 2200, 2201, 2202, 2203, 2204, 2205, 2209, 2210, 2211, 2213, 2214, 2216, 2218, 2219, 2222, 2223, 2226, 2230, 2232, 2234, 2235, 2237, 2239, 2241, 2242, 2244, 2246, 2247, 2248, 2251, 2252, 2253, 2254, 2255, 2259, 2260, 2261, 2262, 2263, 2264, 2265, 2268, 2269, 2272, 2277, 2280, 2284, 2285, 2287, 2288, 2289, 2291, 2292, 2293, 2294, 2295, 2296, 2297, 2299, 2302, 2303, 2304, 2305, 2306, 2310, 2313, 2315, 2320, 2321, 2324, 2327, 2328, 2329, 2331, 2336, 2337, 2338, 2341, 2342, 2345, 2346, 2348, 2349, 2350, 2351, 2352, 2353, 2354, 2357, 2358, 2359, 2360, 2363, 2364, 2365, 2366, 2370, 2373, 2374, 2375, 2377, 2380, 2383, 2385, 2386, 2387, 2388, 2389, 2390, 2391, 2392, 2393, 2396, 2397, 2398, 2401, 2403, 2404, 2405, 2407, 2408, 2409, 2410, 2411, 2412, 2416, 2420, 2421, 2422, 2423, 2425, 2426, 2427, 2428, 2429, 2430, 2437, 2440, 2443, 2448, 2450, 2452, 2453, 2454, 2455, 2459, 2460, 2466, 2470, 2471, 2472, 2473, 2475, 2476, 2477, 2478, 2480, 2481, 2482, 2484, 2485, 2486, 2487, 2488, 2489, 2490, 2491, 2492, 2494, 2495, 2496, 2497, 2501, 2503, 2504, 2508, 2510, 2511, 2515, 2516, 2517, 2518, 2519, 2520, 2522, 2523, 2524, 2525, 2526, 2527, 2528, 2529, 2530, 2531, 2535, 2540, 2543, 2544, 2551, 2552, 2553, 2554, 2557, 2559, 2561, 2562, 2564, 2569, 2570, 2574, 2579, 2580, 2584, 2586, 2591, 2592, 2593, 2595, 2596, 2597, 2599, 2603, 2604, 2606, 2607, 2608, 2614, 2615, 2616, 2620, 2622, 2623, 2624, 2625, 2627, 2628, 2629, 2633, 2635, 2636, 2637, 2640, 2643, 2648, 2650, 2652, 2653, 2656, 2660, 2662, 2666, 2667, 2669, 2672, 2673, 2677, 2679, 2680, 2681, 2683, 2685, 2686, 2687, 2688, 2690, 2692, 2693, 2694, 2696, 2697, 2698, 2699, 2700, 2701, 2703, 2704, 2705, 2707, 2708, 2710, 2712, 2713, 2717, 2718, 2720, 2724, 2725, 2727, 2732, 2733, 2734, 2735, 2736, 2738, 2739, 2740, 2745, 2746, 2747, 2748, 2753, 2754, 2755, 2756, 2757, 2758, 2759, 2760, 2763, 2765, 2768, 2770, 2771, 2772, 2773, 2774, 2777, 2779, 2782, 2783, 2784, 2787, 2789, 2790, 2792, 2793, 2794, 2795, 2800, 2802, 2804, 2808, 2811, 2813, 2817, 2819, 2820, 2821, 2828, 2830, 2831, 2832, 2833, 2835, 2836, 2837, 2838, 2841, 2842, 2843, 2845, 2846, 2847, 2850, 2851, 2855, 2856, 2857, 2858, 2859, 2860, 2861, 2862, 2863, 2865, 2866, 2867, 2868, 2869, 2870, 2872, 2873, 2877, 2878, 2883, 2887, 2888, 2891, 2897, 2898, 2899, 2900, 2901, 2904, 2908, 2909, 2910, 2911, 2912, 2914, 2916, 2917, 2918, 2921, 2923, 2924, 2926, 2930, 2931, 2932, 2934, 2938, 2941, 2942, 2943, 2944, 2945, 2946, 2947, 2949, 2950, 2952, 2953, 2959, 2962, 2963, 2965, 2967, 2969, 2970, 2971, 2974, 2975, 2976, 2977, 2979, 2980, 2982, 2983, 2984, 2985, 2986, 2987, 2989, 2991, 2992, 2993, 2995, 2997, 2998, 2999, 3001, 3004, 3005, 3006, 3008, 3010, 3012, 3015, 3016, 3018, 3020, 3022, 3023, 3024, 3025, 3026, 3027, 3028, 3029, 3030, 3031, 3034, 3036, 3038, 3039, 3040, 3042, 3043, 3046, 3047, 3048, 3049, 3050, 3052, 3053, 3057, 3058, 3059, 3060, 3061, 3062, 3063, 3066, 3067, 3070, 3071, 3072, 3073, 3075, 3076, 3077, 3079, 3080, 3081, 3082, 3084, 3086, 3087, 3088, 3089, 3091, 3093, 3094, 3097, 3098, 3100, 3101, 3103, 3104, 3107, 3108, 3109, 3111, 3112, 3113, 3114, 3115, 3116, 3119, 3121, 3122, 3123, 3124, 3125, 3126, 3128, 3131, 3132, 3134, 3135, 3136, 3137, 3142, 3144, 3146, 3147, 3151, 3152, 3155, 3156, 3157, 3159, 3160, 3163, 3164, 3165, 3166, 3170, 3171, 3172, 3174, 3175, 3176, 3178, 3179, 3180, 3181, 3182, 3184, 3187, 3188, 3192, 3195, 3196, 3197, 3198, 3199, 3200, 3202, 3205, 3206, 3210, 3212, 3213, 3215, 3216, 3217, 3218, 3219, 3224, 3226, 3227, 3228, 3231, 3232, 3234, 3236, 3240, 3241, 3242, 3243, 3244, 3247, 3248, 3249, 3252, 3253, 3254, 3255, 3256, 3260, 3262, 3263, 3265, 3269, 3271, 3273, 3276, 3277, 3279, 3283, 3284, 3285, 3287, 3288, 3289, 3291, 3292, 3293, 3294, 3295, 3296, 3298, 3300, 3302, 3304, 3305, 3306, 3307, 3318, 3319, 3320, 3323, 3325, 3326, 3328, 3330, 3331, 3335, 3338, 3341, 3343, 3345, 3346, 3349, 3350, 3351, 3355, 3357, 3358, 3359, 3363, 3364, 3366, 3368, 3369, 3370, 3371, 3372, 3373, 3375, 3377, 3378, 3380, 3381, 3382, 3383, 3387, 3390, 3391, 3393, 3394, 3396, 3397, 3398, 3399, 3400, 3402, 3403, 3404, 3405, 3406, 3407, 3410, 3411, 3413, 3414, 3416, 3417, 3418, 3422, 3423, 3426, 3428, 3429, 3435, 3437, 3438, 3439, 3440, 3442, 3444, 3446, 3447, 3449, 3452, 3453, 3454, 3456, 3459, 3460, 3462, 3463, 3465, 3466, 3467, 3468, 3469, 3470, 3471, 3474, 3476, 3480, 3481, 3482, 3483, 3485, 3487, 3490, 3493, 3494, 3495, 3497, 3498, 3499, 3502, 3503, 3504, 3505, 3506, 3507, 3509, 3514, 3515, 3516, 3520, 3522, 3523, 3525, 3526, 3527, 3529, 3531, 3532, 3536, 3538, 3541, 3542, 3544, 3546, 3547, 3548, 3549, 3550, 3551, 3552, 3553, 3556, 3557, 3563, 3564, 3565, 3566, 3568, 3569, 3576, 3577, 3578, 3580, 3581, 3582, 3583, 3584, 3586, 3589, 3591, 3592, 3593, 3594, 3595, 3596, 3598, 3599, 3600, 3601, 3602, 3604, 3605, 3608, 3610, 3611, 3612, 3613, 3614, 3615, 3620, 3621, 3622, 3625, 3627, 3629, 3632, 3633, 3635, 3640, 3642, 3644, 3645, 3646, 3650, 3651, 3652, 3653, 3658, 3660, 3664, 3665, 3667, 3669, 3672, 3674, 3676, 3677, 3680, 3681, 3682, 3683, 3684, 3686, 3688, 3689, 3692, 3694, 3696, 3697, 3699, 3707, 3708, 3710, 3711, 3712, 3713, 3716, 3717, 3718, 3721, 3722, 3728, 3729, 3731, 3733, 3735, 3737, 3740, 3743, 3744, 3749, 3751, 3752, 3753, 3754, 3757, 3758, 3759, 3760, 3762, 3765, 3767, 3768, 3770, 3773, 3775, 3776, 3778, 3779, 3782, 3783, 3785, 3787, 3788, 3791, 3792, 3793, 3795, 3796, 3798, 3800, 3802, 3803, 3805, 3806, 3807, 3808, 3809, 3810, 3811, 3812, 3814, 3815, 3817, 3822, 3826, 3828, 3834, 3835, 3836, 3839, 3840, 3841, 3845, 3846, 3847, 3848, 3849, 3850, 3851, 3852, 3853, 3854, 3855, 3859, 3860, 3861, 3862, 3863, 3864, 3866, 3867, 3869, 3871, 3872, 3874, 3877, 3878, 3879, 3880, 3884, 3886, 3887, 3888, 3889, 3890, 3891, 3892, 3893, 3898, 3900, 3901, 3902, 3904, 3905, 3906, 3908, 3912, 3913, 3915, 3917, 3918, 3919, 3921, 3922, 3924, 3926, 3928, 3929, 3930, 3932, 3933, 3934, 3937, 3941, 3943, 3944, 3945, 3946, 3949, 3951, 3952, 3954, 3955, 3956, 3959, 3963, 3964, 3966, 3972, 3974, 3979, 3980, 3981, 3982, 3983, 3984, 3987, 3988, 3989, 3992, 3993, 3995, 3999, 4001, 4003, 4010, 4011, 4012, 4013, 4014, 4016, 4017, 4018, 4020, 4021, 4022, 4023, 4024, 4025, 4028, 4032, 4033, 4037, 4038, 4039, 4040, 4041, 4042, 4043, 4044, 4045, 4053, 4056, 4057, 4058, 4059, 4060, 4067, 4068, 4069, 4070, 4071, 4072, 4073, 4074, 4075, 4077, 4078, 4081, 4083, 4084, 4085, 4086, 4088, 4090, 4091, 4092, 4093, 4094, 4095, 4097, 4098, 4099, 4104, 4106, 4107, 4108, 4109, 4111, 4112, 4113, 4114, 4115, 4118, 4120, 4121, 4124, 4127, 4128, 4129, 4130, 4132, 4133, 4134, 4135, 4136, 4137, 4139, 4142, 4144, 4145, 4147, 4148, 4149, 4150, 4151, 4152, 4153, 4156, 4157, 4160, 4164, 4165, 4168, 4170, 4171, 4172, 4173, 4174, 4175, 4176, 4177, 4178, 4179, 4181, 4182, 4185, 4186, 4187, 4189, 4190, 4192, 4193, 4195, 4198, 4201, 4202, 4203, 4204, 4205, 4207, 4209, 4210, 4211, 4213, 4217, 4218, 4219, 4221, 4222, 4225, 4227, 4229, 4230, 4231, 4232, 4234, 4235, 4237, 4239, 4240, 4243, 4245, 4247, 4248, 4251, 4252, 4254, 4255, 4257, 4259, 4260, 4261, 4264, 4265, 4266, 4267, 4269, 4271, 4272, 4276, 4281, 4283, 4284, 4287, 4288, 4292, 4294, 4295, 4298, 4300, 4301, 4302, 4303, 4305, 4306, 4307, 4310, 4311, 4312, 4313, 4322, 4323, 4326, 4328, 4329, 4332, 4334, 4337, 4339, 4340, 4341, 4343, 4344, 4346, 4347, 4348, 4350, 4351, 4353, 4354, 4356, 4357, 4359, 4361, 4362, 4365, 4366, 4367, 4369, 4373, 4374, 4376, 4378, 4380, 4383, 4384, 4385, 4387, 4389, 4390, 4391, 4393, 4394, 4395, 4396, 4397, 4400, 4402, 4403, 4404, 4405, 4406, 4408, 4410, 4412, 4414, 4415, 4416, 4418, 4419, 4421, 4423, 4424, 4428, 4429, 4434, 4436, 4437, 4439, 4442, 4443, 4444, 4446, 4448, 4449, 4450, 4451, 4452, 4453, 4455, 4456, 4457, 4458, 4459, 4465, 4466, 4467, 4473, 4474, 4477, 4479, 4480, 4481, 4482, 4483, 4484, 4485, 4486, 4487, 4488, 4489, 4490, 4491, 4495, 4496, 4498, 4499, 4500, 4501, 4502, 4503, 4504, 4505, 4506, 4507, 4511, 4512, 4513, 4514, 4515, 4516, 4517, 4519, 4520, 4521, 4522, 4523, 4525, 4526, 4528, 4529, 4530, 4531, 4532, 4533, 4534, 4535, 4537, 4538, 4539, 4541, 4542, 4545, 4546, 4547, 4548, 4549, 4551, 4552, 4555, 4556, 4557, 4558, 4559, 4560, 4561, 4562, 4566, 4567, 4568, 4569, 4570, 4575, 4577, 4579, 4581, 4583, 4584, 4588, 4593, 4595, 4598, 4599, 4600, 4601, 4604, 4605, 4611, 4612, 4615, 4622, 4623, 4624, 4625, 4628, 4630, 4635, 4636, 4637, 4639, 4640, 4641, 4642, 4645, 4646, 4647, 4648, 4651, 4652, 4654, 4657, 4658, 4659, 4660, 4661, 4663, 4664, 4666, 4668, 4670, 4671, 4672, 4674, 4675, 4676, 4678, 4679, 4680, 4681, 4685, 4686, 4687, 4688, 4689, 4690, 4691, 4693, 4695, 4696, 4697, 4698, 4699, 4700, 4701, 4703, 4704, 4705, 4706, 4707, 4708, 4709, 4710, 4711, 4712, 4713, 4715, 4716, 4717, 4718, 4719, 4720, 4722, 4724, 4727, 4728, 4729, 4730, 4731, 4736, 4739, 4740, 4742, 4743, 4744, 4745, 4746, 4747, 4748, 4749, 4750, 4751, 4752, 4753, 4755, 4757, 4761, 4762, 4764, 4765, 4767, 4773, 4774, 4777, 4779, 4781, 4784, 4785, 4788, 4790, 4791, 4792, 4793, 4794, 4795, 4796, 4797, 4798, 4799, 4800, 4802, 4805, 4807, 4808, 4809, 4810, 4811, 4814, 4815, 4821, 4823, 4827, 4828, 4829, 4832, 4833, 4834, 4835, 4836, 4837, 4842, 4843, 4844, 4845, 4846, 4848, 4849, 4850, 4851, 4854, 4855, 4856, 4857, 4859, 4860, 4861, 4862, 4863, 4868, 4869, 4871, 4872, 4873, 4874, 4876, 4877, 4879, 4880, 4882, 4885, 4888, 4889, 4891, 4892, 4893, 4894, 4898, 4901, 4903, 4904, 4905, 4906, 4907, 4908, 4909, 4910, 4911, 4912, 4914, 4915, 4919, 4920, 4921, 4923, 4926, 4927, 4929, 4930, 4931, 4935, 4937, 4940, 4942, 4948, 4949, 4950, 4951, 4954, 4955, 4958, 4959, 4962, 4963, 4964, 4968, 4969, 4970, 4971, 4972, 4973, 4974, 4975, 4980, 4981, 4982, 4983, 4984, 4987, 4995, 4998, 5000, 5002, 5003, 5004, 5005, 5006, 5007, 5009, 5011, 5012, 5014, 5015, 5017, 5018, 5019, 5020, 5021, 5023, 5024, 5025, 5027, 5029, 5032, 5033, 5036, 5037, 5038, 5039, 5040, 5041, 5042, 5043, 5044, 5045, 5047, 5051, 5052, 5055, 5056, 5057, 5058, 5059, 5060, 5063, 5066, 5067, 5068, 5070, 5072, 5075, 5076, 5077, 5080, 5081, 5082, 5083, 5084, 5085, 5086, 5087, 5090, 5091, 5092, 5093, 5095, 5096, 5097, 5105, 5107, 5108, 5109, 5110, 5114, 5115, 5117, 5118, 5119, 5120, 5121, 5122, 5123, 5124, 5125, 5126, 5127, 5128, 5129, 5130, 5132, 5133, 5134, 5135, 5136, 5137, 5140, 5141, 5142, 5143, 5145, 5147, 5149, 5150, 5155, 5157, 5158, 5160, 5161, 5162, 5163, 5164, 5166, 5167, 5169, 5170, 5171, 5174, 5176, 5178, 5182, 5183, 5185, 5187, 5190, 5191, 5194, 5195, 5196, 5197, 5198, 5199, 5201, 5202, 5203, 5205, 5209, 5210, 5211, 5212, 5214, 5215, 5217, 5220, 5221, 5224, 5225, 5226, 5229, 5230, 5231, 5232, 5236, 5237, 5238, 5239, 5242, 5243, 5246, 5248, 5253, 5257, 5258, 5259, 5260, 5262, 5263, 5264, 5265, 5267, 5268, 5269, 5270, 5273, 5274, 5275, 5278, 5279, 5281, 5283, 5284, 5287, 5288, 5291, 5292, 5296, 5297, 5300, 5301, 5302, 5303, 5304, 5305, 5307, 5308, 5312, 5314, 5315, 5316, 5319, 5320, 5321, 5323, 5327, 5328, 5329, 5330, 5333, 5334, 5336, 5337, 5339, 5340, 5342, 5343, 5344, 5345, 5346, 5347, 5353, 5354, 5357, 5361, 5362, 5364, 5365, 5368, 5369, 5370, 5371, 5372, 5373, 5375, 5376, 5377, 5378, 5379, 5380, 5383, 5384, 5385, 5387, 5388, 5389, 5390, 5391, 5392, 5394, 5397, 5399, 5402, 5403, 5404, 5406, 5407, 5408, 5409, 5411, 5412, 5413, 5414, 5416, 5418, 5419, 5420, 5422, 5423, 5425, 5426, 5427, 5428, 5429, 5430, 5437, 5438, 5440, 5441, 5442, 5443, 5444, 5445, 5446, 5447, 5448, 5449, 5450, 5452, 5453, 5454, 5457, 5458, 5459, 5460, 5461, 5462, 5463, 5464, 5466, 5468, 5469, 5471, 5474, 5476, 5477, 5480, 5481, 5482, 5483, 5484, 5485, 5486, 5487, 5489, 5490, 5491, 5493, 5496, 5501, 5502, 5504, 5505, 5506, 5511, 5512, 5513, 5514, 5515, 5516, 5518, 5520, 5521, 5522, 5523, 5529, 5530, 5534, 5535, 5536, 5537, 5538, 5539, 5540, 5541, 5543, 5544, 5545, 5548, 5549, 5551, 5557, 5558, 5561, 5562, 5571, 5573, 5575, 5576, 5577, 5579, 5581, 5582, 5583, 5584, 5585, 5587, 5589, 5590, 5591, 5592, 5593, 5594, 5595, 5598, 5600, 5601, 5602, 5603, 5606, 5607, 5608, 5609, 5610, 5614, 5615, 5617, 5618, 5622, 5628, 5630, 5631, 5637, 5639, 5640, 5642, 5645, 5647, 5648, 5650, 5651, 5652, 5653, 5654, 5655, 5656, 5657, 5659, 5660, 5662, 5663, 5664, 5665, 5666, 5667, 5668, 5669, 5670, 5671, 5672, 5673, 5677, 5678, 5679, 5680, 5681, 5683, 5686, 5689, 5690, 5691, 5692, 5693, 5694, 5696, 5698, 5699, 5700, 5701, 5703, 5705, 5707, 5709, 5712, 5714, 5716, 5720, 5721, 5722, 5723, 5724, 5726, 5728, 5729, 5730, 5736, 5737, 5739, 5741, 5742, 5743, 5744, 5745, 5746, 5747, 5748, 5749, 5751, 5752, 5754, 5755, 5756, 5758, 5759, 5761, 5762, 5763, 5766, 5768, 5772, 5773, 5774, 5776, 5778, 5779, 5781, 5784, 5785, 5786, 5788, 5789, 5791, 5792, 5793, 5794, 5795, 5796, 5797, 5798, 5802, 5803, 5808, 5809, 5811, 5813, 5814, 5815, 5816, 5817, 5819, 5823, 5828, 5830, 5832, 5834, 5837, 5838, 5844, 5848, 5849, 5851, 5853, 5854, 5855, 5860, 5861, 5862, 5864, 5865, 5866, 5868, 5874, 5881, 5882, 5886, 5887, 5888, 5892, 5897, 5898, 5899, 5900, 5902, 5903, 5905, 5907, 5909, 5910, 5912, 5913, 5915, 5916, 5918, 5920, 5921, 5922, 5925, 5927, 5928, 5932, 5933, 5934, 5935, 5936, 5939, 5940, 5942, 5943, 5944, 5945, 5947, 5948, 5949, 5950, 5952, 5953, 5954, 5955, 5956, 5957, 5960, 5962, 5963, 5965, 5966, 5967, 5968, 5970, 5971, 5979, 5980, 5983, 5984, 5985, 5987, 5988, 5989, 5992, 5993, 5994, 5995, 5996, 5997, 5998, 6000, 6002, 6003, 6004, 6006, 6007, 6008, 6010, 6011, 6012, 6013, 6017, 6021, 6023, 6025, 6027, 6028, 6029, 6032, 6034, 6039, 6040, 6042, 6043, 6044, 6045, 6046, 6049, 6051, 6052, 6053, 6055, 6058, 6064, 6066, 6069, 6071, 6072, 6073, 6078, 6079, 6081, 6083, 6084, 6086, 6088, 6089, 6091, 6093, 6094, 6096, 6097, 6099, 6100, 6103, 6105, 6106, 6107, 6108, 6109, 6112, 6113, 6115, 6117, 6122, 6123, 6127, 6130, 6132, 6133, 6134, 6139, 6142, 6143, 6144, 6147, 6148, 6149, 6150, 6151, 6152, 6153, 6154, 6155, 6156, 6157, 6158, 6159, 6160, 6161, 6162, 6163, 6166, 6167, 6168, 6169, 6170, 6171, 6172, 6173, 6174, 6180, 6181, 6182, 6183, 6184, 6185, 6186, 6187, 6190, 6191, 6192, 6193, 6195, 6197, 6198, 6201, 6202, 6207, 6223, 6224, 6230, 6233, 6234, 6235, 6236, 6237, 6238, 6239, 6240, 6241, 6242, 6243, 6244, 6245, 6246, 6247, 6249, 6251, 6253, 6254, 6255, 6256, 6258, 6259, 6260, 6261, 6263, 6264, 6265, 6266, 6267, 6269, 6270, 6271, 6275, 6276, 6277, 6281, 6282, 6283, 6284, 6285, 6287, 6288, 6290, 6291, 6293, 6294, 6297, 6300, 6301, 6303, 6304, 6305, 6306, 6307, 6308, 6309, 6310, 6313, 6315, 6318, 6320, 6321, 6322, 6323, 6324, 6326, 6327, 6329, 6330, 6331, 6332, 6333, 6335, 6339, 6341, 6342, 6344, 6345, 6346, 6347, 6348, 6349, 6351, 6352, 6354, 6355, 6356, 6357, 6359, 6361, 6364, 6369, 6370, 6371, 6372, 6375, 6376, 6377, 6386, 6388, 6393, 6394, 6399, 6401, 6404, 6405, 6407, 6408, 6410, 6411, 6412, 6413, 6414, 6415, 6416, 6417, 6418, 6422, 6423, 6424, 6426, 6428, 6430, 6431, 6433, 6434, 6436, 6438, 6440, 6441, 6443, 6444, 6445, 6447, 6449, 6452, 6454, 6458, 6460, 6461, 6462, 6463, 6464, 6467, 6470, 6471, 6472, 6473, 6474, 6475, 6477, 6478, 6479, 6483, 6484, 6485, 6486, 6487, 6488, 6491, 6492, 6494, 6495, 6496, 6498, 6499, 6502, 6504, 6506, 6507, 6508, 6509, 6510, 6514, 6516, 6517, 6526, 6527, 6528, 6529, 6531, 6532, 6533, 6534, 6535, 6543, 6545, 6547, 6548, 6552, 6553, 6557, 6559, 6560, 6561, 6566, 6571, 6572, 6577, 6578, 6579, 6580, 6581, 6582, 6583, 6585, 6586, 6587, 6589, 6590, 6593, 6598, 6602, 6604, 6605, 6609, 6611, 6613, 6614, 6618, 6619, 6621, 6622, 6626, 6627, 6628, 6629, 6632, 6633, 6635, 6637, 6643, 6644, 6645, 6647, 6648, 6649, 6651, 6652, 6653, 6654, 6655, 6656, 6657, 6659, 6660, 6661, 6663, 6664, 6666, 6669, 6671, 6672, 6677, 6680, 6681, 6682, 6686, 6687, 6688, 6689, 6690, 6693, 6694, 6696, 6697, 6698, 6699, 6701, 6702, 6703, 6704, 6705, 6707, 6708, 6710, 6713, 6714, 6715, 6717, 6718, 6719, 6724, 6725, 6728, 6733, 6738, 6739, 6740, 6741, 6742, 6743, 6745, 6748, 6750, 6751, 6753, 6755, 6756, 6759, 6760, 6764, 6765, 6766, 6767, 6769, 6770, 6773, 6775, 6776, 6777, 6778, 6779, 6780, 6781, 6783, 6784, 6785, 6788, 6789, 6790, 6791}",3310,"{5120, 5121, 5122, 5123, 6144, 6147, 6148, 6149, 6150, 6151, 6152, 6153, 6154, 6155, 6156, 6157, 6159, 6160, 6161, 6162, 6163, 6166, 6167, 6168, 6169, 6170, 6171, 6185, 1078, 1088, 1089, 1090, 1092, 1093, 1095, 1096, 1097, 1098, 1099, 1100, 1101, 1103, 1104, 1105, 1106, 1107, 1108, 1109, 1112, 5209, 5210, 6233, 1114, 1115, 1116, 1118, 1120, 5217, 1121, 1122, 5220, 5221, 1123, 1124, 5224, 5225, 5226, 1125, 1126, 5229, 5230, 5231, 5232, 1128, 1129, 1130, 5236, 5237, 5238, 5239, 6255, 6256, 5242, 5243, 6259, 6260, 5246, 6263, 5248, 6264, 6265, 6266, 6267, 5253, 6269, 6270, 6271, 6275, 6276, 6277, 6281, 6282, 5118, 5119, 1213, 1214, 1215, 1216, 6335, 1218, 1219, 6339, 1221, 1222, 1223, 6341, 1225, 6342, 6344, 1228, 1229, 1230, 6345, 6346, 6347, 1234, 6348, 6349, 1237, 1238, 1239, 1240, 1241, 1242, 6351, 6352, 6356, 6357, 6359, 6361, 6354, 6364, 6355, 6399, 6401, 6404, 6405, 6407, 6408, 6410, 6411, 6412, 6413, 6414, 6415, 6416, 6417, 6418, 6422, 6423, 6424, 6426, 6428, 6430, 6431, 6433, 6434, 6436, 6438, 6464, 1347, 5443, 6473, 6474, 6475, 6477, 6478, 6479, 6483, 6484, 6486, 1367, 1368, 1369, 1370, 6487, 6488, 1373, 1374, 6491, 6492, 1377, 6494, 1379, 5476, 1380, 6495, 6496, 6498, 6499, 1385, 1386, 1387, 1388, 1389, 1390, 1391, 1392, 1393, 6508, 6516, 1395, 1396, 5505, 5506, 5511, 5512, 5513, 5514, 5515, 5516, 5518, 5520, 5521, 5522, 5523, 5529, 5530, 5534, 5535, 5536, 5537, 5538, 1443, 1458, 1459, 6580, 1460, 1461, 1462, 1464, 1467, 1469, 1470, 1471, 1472, 1473, 1476, 1477, 1478, 1483, 1484, 1485, 1487, 1489, 1491, 1493, 1495, 1499, 1501, 1502, 1503, 1504, 1505, 1507, 6628, 1508, 1509, 1510, 1511, 1512, 1513, 1515, 1516, 1518, 1520, 1521, 1522, 1523, 1524, 6643, 1526, 6644, 1528, 6645, 1530, 1531, 6648, 6649, 6651, 6652, 6656, 6657, 6653, 6659, 6660, 6661, 6655, 6663, 6664, 6666, 6669, 6671, 6672, 6677, 6680, 6681, 6682, 6686, 6687, 6688, 6689, 6690, 6693, 6694, 1127, 6696, 6697, 6698, 6699, 6701, 6702, 6703, 6704, 6705, 1131, 6245, 6249, 6251, 6253, 6254, 4861, 6258, 6261, 5948, 5949, 5950, 5952, 5953, 5954, 5955, 5956, 5957, 5960, 5962, 5963, 5965, 5968, 5970, 5971, 5979, 5980, 5983, 5984, 5985, 5987, 5988, 6017, 5084, 5090, 5091, 5092, 5093, 5095, 5096, 5097, 5105, 5107, 5108, 5109, 5110, 6132, 5114, 6139, 5117, 6142, 6143}",377,"{989, 1085, 1094, 1117, 1134, 1135, 1136, 1137, 1138, 1140, 1142, 1145, 1147, 1148, 1149, 1150, 1151, 1152, 1153, 1155, 1156, 1158, 1160, 1161, 1162, 1163, 1165, 1167, 1169, 1170, 1171, 1172, 1176, 1177, 1179, 1180, 1181, 1182, 1183, 1184, 1185, 1186, 1187, 1188, 1190, 1196, 1197, 1198, 1199, 1200, 1201, 1203, 1204, 1205, 1207, 1208, 1209, 1210, 1231, 1233, 1244, 1246, 1247, 1250, 1254, 1255, 1263, 1265, 1268, 1272, 1273, 1274, 1275, 1276, 1277, 1280, 1281, 1282, 1284, 1285, 1287, 1290, 1291, 1294, 1300, 1301, 1302, 1304, 1305, 1307, 1308, 1309, 1310, 1311, 1313, 1314, 1315, 1318, 1320, 1321, 1323, 1324, 1325, 1327, 1328, 1329, 1330, 1331, 1332, 1334, 1335, 1336, 1338, 1342, 1345, 1346, 1349, 1353, 1357, 1360, 1365, 1378, 1382, 1397, 1400, 1401, 1402, 1404, 1405, 1406, 1409, 1410, 1413, 1414, 1415, 1420, 1421, 1423, 1424, 1429, 1430, 1431, 1432, 1434, 1435, 1439, 1440, 1441, 1442, 1446, 1448, 1450, 1452, 1453, 1454, 1455, 1456, 1457, 1468, 1496, 1514, 1532, 1533, 1536, 1538, 1540, 1542, 1543, 1544, 1545, 1546, 1549, 1551, 1552, 1553, 1554, 1556, 1558, 1560, 1562, 1563, 1565, 1566, 1567, 1568, 1569, 1573, 1574, 1578, 1579, 1580, 1581, 1582, 1583, 1584, 1587, 1588, 1589, 1591, 1592, 1593, 1594, 1595, 1596, 1597, 1598, 1601, 1602, 1604, 1605, 1606, 1607, 1610, 1612, 1614, 1619, 1620, 1621, 1622, 1624, 1625, 1627, 1628, 1629, 1630, 1633, 1637, 1639, 1640, 1642, 1643, 1644, 1645, 1646, 1647, 1648, 1655, 1658, 1661, 1662, 1663, 1665, 1666, 1667, 1669, 1670, 1671, 1674, 1678, 1681, 1682, 1683, 1687, 1691, 1693, 1694, 1699, 1700, 1701, 1702, 1704, 1706, 1707, 1708, 1709, 1710, 1712, 1713, 1714, 1715, 1716, 1717, 1718, 1726, 1727, 1728, 1730, 1731, 1732, 1736, 1737, 1739, 1743, 1744, 1745, 1746, 1748, 1752, 1753, 1754, 1756, 1757, 1758, 1760, 1761, 1764, 1769, 1771, 1772, 1773, 1774, 1775, 1776, 1778, 1779, 1780, 1786, 1790, 1796, 1799, 1801, 1802, 1803, 1804, 1805, 1808, 1810, 1811, 1812, 1814, 1817, 1818, 1819, 1821, 1822, 1825, 1827, 1828, 1829, 1830, 1831, 1834, 1835, 1836, 1837, 1840, 1841, 1842, 1843, 1847, 1848, 1849, 1850, 1859, 1863, 1865, 1867, 1869, 1870, 1871, 1874, 1875, 1878, 1880, 1881, 1883, 1885, 1886, 1888, 1892, 1893, 1895, 1896, 1897, 1898, 1900, 1901, 1902, 1903, 1905, 1907, 1909, 1910, 1911, 1912, 1915, 1918, 1919, 1920, 1921, 1922, 1923, 1924, 1928, 1929, 1931, 1934, 1937, 1940, 1941, 1944, 1945, 1946, 1947, 1948, 1951, 1955, 1956, 1957, 1958, 1960, 1962, 1964, 1965, 1967, 1968, 1969, 1971, 1972, 1976, 1978, 1979, 1981, 1983, 1986, 1987, 1992, 1993, 1994, 1996, 1997, 1999, 2000, 2001, 2002, 2004, 2005, 2006, 2007, 2010, 2011, 2017, 2019, 2020, 2023, 2024, 2025, 2026, 2031, 2032, 2033, 2034, 2039, 2040, 2041, 2043, 2044, 2047, 2049, 2050, 2051, 2052, 2053, 2056, 2063, 2064, 2065, 2071, 2073, 2074, 2075, 2077, 2079, 2080, 2082, 2083, 2084, 2085, 2087, 2091, 2094, 2100, 2103, 2109, 2111, 2113, 2114, 2115, 2116, 2117, 2119, 2121, 2122, 2124, 2125, 2126, 2128, 2129, 2130, 2131, 2133, 2134, 2135, 2137, 2138, 2141, 2143, 2144, 2148, 2150, 2151, 2154, 2155, 2157, 2158, 2159, 2164, 2166, 2167, 2168, 2169, 2172, 2173, 2174, 2175, 2176, 2177, 2178, 2180, 2181, 2182, 2183, 2186, 2188, 2189, 2191, 2194, 2195, 2196, 2197, 2200, 2201, 2202, 2203, 2204, 2205, 2209, 2210, 2211, 2213, 2214, 2216, 2218, 2219, 2222, 2223, 2226, 2230, 2232, 2234, 2235, 2237, 2239, 2241, 2242, 2244, 2246, 2247, 2248, 2251, 2252, 2253, 2254, 2255, 2259, 2260, 2261, 2262, 2263, 2264, 2265, 2268, 2269, 2272, 2277, 2280, 2284, 2285, 2287, 2288, 2289, 2291, 2292, 2293, 2294, 2295, 2296, 2297, 2299, 2302, 2303, 2304, 2305, 2306, 2310, 2313, 2315, 2320, 2321, 2324, 2327, 2328, 2329, 2331, 2336, 2337, 2338, 2341, 2342, 2345, 2346, 2348, 2349, 2350, 2351, 2352, 2353, 2354, 2357, 2358, 2359, 2360, 2363, 2364, 2365, 2366, 2370, 2373, 2374, 2375, 2377, 2380, 2383, 2385, 2386, 2387, 2388, 2389, 2390, 2391, 2392, 2393, 2396, 2397, 2398, 2401, 2403, 2404, 2405, 2407, 2408, 2409, 2410, 2411, 2412, 2416, 2420, 2421, 2422, 2423, 2425, 2426, 2427, 2428, 2429, 2430, 2437, 2440, 2443, 2448, 2450, 2452, 2453, 2454, 2455, 2459, 2460, 2466, 2470, 2471, 2472, 2473, 2475, 2476, 2477, 2478, 2480, 2481, 2482, 2484, 2485, 2486, 2487, 2488, 2489, 2490, 2491, 2492, 2494, 2495, 2496, 2497, 2501, 2503, 2504, 2508, 2510, 2511, 2515, 2516, 2517, 2518, 2519, 2520, 2522, 2523, 2524, 2525, 2526, 2527, 2528, 2529, 2530, 2531, 2535, 2540, 2543, 2544, 2551, 2552, 2553, 2554, 2557, 2559, 2561, 2562, 2564, 2569, 2570, 2574, 2579, 2580, 2584, 2586, 2591, 2592, 2593, 2595, 2596, 2597, 2599, 2603, 2604, 2606, 2607, 2608, 2614, 2615, 2616, 2620, 2622, 2623, 2624, 2625, 2627, 2628, 2629, 2633, 2635, 2636, 2637, 2640, 2643, 2648, 2650, 2652, 2653, 2656, 2660, 2662, 2666, 2667, 2669, 2672, 2673, 2677, 2679, 2680, 2681, 2683, 2685, 2686, 2687, 2688, 2690, 2692, 2693, 2694, 2696, 2697, 2698, 2699, 2700, 2701, 2703, 2704, 2705, 2707, 2708, 2710, 2712, 2713, 2717, 2718, 2720, 2724, 2725, 2727, 2732, 2733, 2734, 2735, 2736, 2738, 2739, 2740, 2745, 2746, 2747, 2748, 2753, 2754, 2755, 2756, 2757, 2758, 2759, 2760, 2763, 2765, 2768, 2770, 2771, 2772, 2773, 2774, 2777, 2779, 2782, 2783, 2784, 2787, 2789, 2790, 2792, 2793, 2794, 2795, 2800, 2802, 2804, 2808, 2811, 2813, 2817, 2819, 2820, 2821, 2828, 2830, 2831, 2832, 2833, 2835, 2836, 2837, 2838, 2841, 2842, 2843, 2845, 2846, 2847, 2850, 2851, 2855, 2856, 2857, 2858, 2859, 2860, 2861, 2862, 2863, 2865, 2866, 2867, 2868, 2869, 2870, 2872, 2873, 2877, 2878, 2883, 2887, 2888, 2891, 2897, 2898, 2899, 2900, 2901, 2904, 2908, 2909, 2910, 2911, 2912, 2914, 2916, 2917, 2918, 2921, 2923, 2924, 2926, 2930, 2931, 2932, 2934, 2938, 2941, 2942, 2943, 2944, 2945, 2946, 2947, 2949, 2950, 2952, 2953, 2959, 2962, 2963, 2965, 2967, 2969, 2970, 2971, 2974, 2975, 2976, 2977, 2979, 2980, 2982, 2983, 2984, 2985, 2986, 2987, 2989, 2991, 2992, 2993, 2995, 2997, 2998, 2999, 3001, 3004, 3005, 3006, 3008, 3010, 3012, 3015, 3016, 3018, 3020, 3022, 3023, 3024, 3025, 3026, 3027, 3028, 3029, 3030, 3031, 3034, 3036, 3038, 3039, 3040, 3042, 3043, 3046, 3047, 3048, 3049, 3050, 3052, 3053, 3057, 3058, 3059, 3060, 3061, 3062, 3063, 3066, 3067, 3070, 3071, 3072, 3073, 3075, 3076, 3077, 3079, 3080, 3081, 3082, 3084, 3086, 3087, 3088, 3089, 3091, 3093, 3094, 3097, 3098, 3100, 3101, 3103, 3104, 3107, 3108, 3109, 3111, 3112, 3113, 3114, 3115, 3116, 3119, 3121, 3122, 3123, 3124, 3125, 3126, 3128, 3131, 3132, 3134, 3135, 3136, 3137, 3142, 3144, 3146, 3147, 3151, 3152, 3155, 3156, 3157, 3159, 3160, 3163, 3164, 3165, 3166, 3170, 3171, 3172, 3174, 3175, 3176, 3178, 3179, 3180, 3181, 3182, 3184, 3187, 3188, 3192, 3195, 3196, 3197, 3198, 3199, 3200, 3202, 3205, 3206, 3210, 3212, 3213, 3215, 3216, 3217, 3218, 3219, 3224, 3226, 3227, 3228, 3231, 3232, 3234, 3236, 3240, 3241, 3242, 3243, 3244, 3247, 3248, 3249, 3252, 3253, 3254, 3255, 3256, 3260, 3262, 3263, 3265, 3269, 3271, 3273, 3276, 3277, 3279, 3283, 3284, 3285, 3287, 3288, 3289, 3291, 3292, 3293, 3294, 3295, 3296, 3298, 3300, 3302, 3304, 3305, 3306, 3307, 3318, 3319, 3320, 3323, 3325, 3326, 3328, 3330, 3331, 3335, 3338, 3341, 3343, 3345, 3346, 3349, 3350, 3351, 3355, 3357, 3358, 3359, 3363, 3364, 3366, 3368, 3369, 3370, 3371, 3372, 3373, 3375, 3377, 3378, 3380, 3381, 3382, 3383, 3387, 3390, 3391, 3393, 3394, 3396, 3397, 3398, 3399, 3400, 3402, 3403, 3404, 3405, 3406, 3407, 3410, 3411, 3413, 3414, 3416, 3417, 3418, 3422, 3423, 3426, 3428, 3429, 3435, 3437, 3438, 3439, 3440, 3442, 3444, 3446, 3447, 3449, 3452, 3453, 3454, 3456, 3459, 3460, 3462, 3463, 3465, 3466, 3467, 3468, 3469, 3470, 3471, 3474, 3476, 3480, 3481, 3482, 3483, 3485, 3487, 3490, 3493, 3494, 3495, 3497, 3498, 3499, 3502, 3503, 3504, 3505, 3506, 3507, 3509, 3514, 3515, 3516, 3520, 3522, 3523, 3525, 3526, 3527, 3529, 3531, 3532, 3536, 3538, 3541, 3542, 3544, 3546, 3547, 3548, 3549, 3550, 3551, 3552, 3553, 3556, 3557, 3563, 3564, 3565, 3566, 3568, 3569, 3576, 3577, 3578, 3580, 3581, 3582, 3583, 3584, 3586, 3589, 3591, 3592, 3593, 3594, 3595, 3596, 3598, 3599, 3600, 3601, 3602, 3604, 3605, 3608, 3610, 3611, 3612, 3613, 3614, 3615, 3620, 3621, 3622, 3625, 3627, 3629, 3632, 3633, 3635, 3640, 3642, 3644, 3645, 3646, 3650, 3651, 3652, 3653, 3658, 3660, 3664, 3665, 3667, 3669, 3672, 3674, 3676, 3677, 3680, 3681, 3682, 3683, 3684, 3686, 3688, 3689, 3692, 3694, 3696, 3697, 3699, 3707, 3708, 3710, 3711, 3712, 3713, 3716, 3717, 3718, 3721, 3722, 3728, 3729, 3731, 3733, 3735, 3737, 3740, 3743, 3744, 3749, 3751, 3752, 3753, 3754, 3757, 3758, 3759, 3760, 3762, 3765, 3767, 3768, 3770, 3773, 3775, 3776, 3778, 3779, 3782, 3783, 3785, 3787, 3788, 3791, 3792, 3793, 3795, 3796, 3798, 3800, 3802, 3803, 3805, 3806, 3807, 3808, 3809, 3810, 3811, 3812, 3814, 3815, 3817, 3822, 3826, 3828, 3834, 3835, 3836, 3839, 3840, 3841, 3845, 3846, 3847, 3848, 3849, 3850, 3851, 3852, 3853, 3854, 3855, 3859, 3860, 3861, 3862, 3863, 3864, 3866, 3867, 3869, 3871, 3872, 3874, 3877, 3878, 3879, 3880, 3884, 3886, 3887, 3888, 3889, 3890, 3891, 3892, 3893, 3898, 3900, 3901, 3902, 3904, 3905, 3906, 3908, 3912, 3913, 3915, 3917, 3918, 3919, 3921, 3922, 3924, 3926, 3928, 3929, 3930, 3932, 3933, 3934, 3937, 3941, 3943, 3944, 3945, 3946, 3949, 3951, 3952, 3954, 3955, 3956, 3959, 3963, 3964, 3966, 3972, 3974, 3979, 3980, 3981, 3982, 3983, 3984, 3987, 3988, 3989, 3992, 3993, 3995, 3999, 4001, 4003, 4010, 4011, 4012, 4013, 4014, 4016, 4017, 4018, 4020, 4021, 4022, 4023, 4024, 4025, 4028, 4032, 4033, 4037, 4038, 4039, 4040, 4041, 4042, 4043, 4044, 4045, 4053, 4056, 4057, 4058, 4059, 4060, 4067, 4068, 4069, 4070, 4071, 4072, 4073, 4074, 4075, 4077, 4078, 4081, 4083, 4084, 4085, 4086, 4088, 4090, 4091, 4092, 4093, 4094, 4095, 4097, 4098, 4099, 4104, 4106, 4107, 4108, 4109, 4111, 4112, 4113, 4114, 4115, 4118, 4120, 4121, 4124, 4127, 4128, 4129, 4130, 4132, 4133, 4134, 4135, 4136, 4137, 4139, 4142, 4144, 4145, 4147, 4148, 4149, 4150, 4151, 4152, 4153, 4156, 4157, 4160, 4164, 4165, 4168, 4170, 4171, 4172, 4173, 4174, 4175, 4176, 4177, 4178, 4179, 4181, 4182, 4185, 4186, 4187, 4189, 4190, 4192, 4193, 4195, 4198, 4201, 4202, 4203, 4204, 4205, 4207, 4209, 4210, 4211, 4213, 4217, 4218, 4219, 4221, 4222, 4225, 4227, 4229, 4230, 4231, 4232, 4234, 4235, 4237, 4239, 4240, 4243, 4245, 4247, 4248, 4251, 4252, 4254, 4255, 4257, 4259, 4260, 4261, 4264, 4265, 4266, 4267, 4269, 4271, 4272, 4276, 4281, 4283, 4284, 4287, 4288, 4292, 4294, 4295, 4298, 4300, 4301, 4302, 4303, 4305, 4306, 4307, 4310, 4311, 4312, 4313, 4322, 4323, 4326, 4328, 4329, 4332, 4334, 4337, 4339, 4340, 4341, 4343, 4344, 4346, 4347, 4348, 4350, 4351, 4353, 4354, 4356, 4357, 4359, 4361, 4362, 4365, 4366, 4367, 4369, 4373, 4374, 4376, 4378, 4380, 4383, 4384, 4385, 4387, 4389, 4390, 4391, 4393, 4394, 4395, 4396, 4397, 4400, 4402, 4403, 4404, 4405, 4406, 4408, 4410, 4412, 4414, 4415, 4416, 4418, 4419, 4421, 4423, 4424, 4428, 4429, 4434, 4436, 4437, 4439, 4442, 4443, 4444, 4446, 4448, 4449, 4450, 4451, 4452, 4453, 4455, 4456, 4457, 4458, 4459, 4465, 4466, 4467, 4473, 4474, 4477, 4479, 4480, 4481, 4482, 4483, 4484, 4485, 4486, 4487, 4488, 4489, 4490, 4491, 4495, 4496, 4498, 4499, 4500, 4501, 4502, 4503, 4504, 4505, 4506, 4507, 4511, 4512, 4513, 4514, 4515, 4516, 4517, 4519, 4520, 4521, 4522, 4523, 4525, 4526, 4528, 4529, 4530, 4531, 4532, 4533, 4534, 4535, 4537, 4538, 4539, 4541, 4542, 4545, 4546, 4547, 4548, 4549, 4551, 4552, 4555, 4556, 4557, 4558, 4559, 4560, 4561, 4562, 4566, 4567, 4568, 4569, 4570, 4575, 4577, 4579, 4581, 4583, 4584, 4588, 4593, 4595, 4598, 4599, 4600, 4601, 4604, 4605, 4611, 4612, 4615, 4622, 4623, 4624, 4625, 4628, 4630, 4635, 4636, 4637, 4639, 4640, 4641, 4642, 4645, 4646, 4647, 4648, 4651, 4652, 4654, 4657, 4658, 4659, 4660, 4661, 4663, 4664, 4666, 4668, 4670, 4671, 4672, 4674, 4675, 4676, 4678, 4679, 4680, 4681, 4685, 4686, 4687, 4688, 4689, 4690, 4691, 4693, 4695, 4696, 4697, 4698, 4699, 4700, 4701, 4703, 4704, 4705, 4706, 4707, 4708, 4709, 4710, 4711, 4712, 4713, 4715, 4716, 4717, 4718, 4719, 4720, 4722, 4724, 4727, 4728, 4729, 4730, 4731, 4736, 4739, 4740, 4742, 4743, 4744, 4745, 4746, 4747, 4748, 4749, 4750, 4751, 4752, 4753, 4755, 4757, 4761, 4762, 4764, 4765, 4767, 4773, 4774, 4777, 4779, 4781, 4784, 4785, 4788, 4790, 4791, 4792, 4793, 4794, 4795, 4796, 4797, 4798, 4799, 4800, 4802, 4805, 4807, 4808, 4809, 4810, 4811, 4814, 4815, 4821, 4823, 4827, 4828, 4829, 4832, 4833, 4834, 4835, 4836, 4837, 4842, 4843, 4844, 4845, 4846, 4848, 4849, 4850, 4851, 4854, 4855, 4856, 4857, 4859, 4860, 4862, 4863, 4868, 4869, 4871, 4872, 4873, 4874, 4876, 4877, 4879, 4880, 4882, 4885, 4888, 4889, 4891, 4892, 4893, 4894, 4898, 4901, 4903, 4904, 4905, 4906, 4907, 4908, 4909, 4910, 4911, 4912, 4914, 4915, 4919, 4920, 4921, 4923, 4926, 4927, 4929, 4930, 4931, 4935, 4937, 4940, 4942, 4948, 4949, 4950, 4951, 4954, 4955, 4958, 4959, 4962, 4963, 4964, 4968, 4969, 4970, 4971, 4972, 4973, 4974, 4975, 4980, 4981, 4982, 4983, 4984, 4987, 4995, 4998, 5000, 5002, 5003, 5004, 5005, 5006, 5007, 5009, 5011, 5012, 5014, 5015, 5017, 5018, 5019, 5020, 5021, 5023, 5024, 5025, 5027, 5029, 5032, 5033, 5036, 5037, 5038, 5039, 5040, 5041, 5042, 5043, 5044, 5045, 5047, 5051, 5052, 5055, 5056, 5057, 5058, 5059, 5060, 5063, 5066, 5067, 5068, 5070, 5072, 5075, 5076, 5077, 5080, 5081, 5082, 5083, 5085, 5086, 5087, 5115, 5124, 5125, 5126, 5127, 5128, 5129, 5130, 5132, 5133, 5134, 5135, 5136, 5137, 5140, 5141, 5142, 5143, 5145, 5147, 5149, 5150, 5155, 5157, 5158, 5160, 5161, 5162, 5163, 5164, 5166, 5167, 5169, 5170, 5171, 5174, 5176, 5178, 5182, 5183, 5185, 5187, 5190, 5191, 5194, 5195, 5196, 5197, 5198, 5199, 5201, 5202, 5203, 5205, 5211, 5212, 5214, 5215, 5257, 5258, 5259, 5260, 5262, 5263, 5264, 5265, 5267, 5268, 5269, 5270, 5273, 5274, 5275, 5278, 5279, 5281, 5283, 5284, 5287, 5288, 5291, 5292, 5296, 5297, 5300, 5301, 5302, 5303, 5304, 5305, 5307, 5308, 5312, 5314, 5315, 5316, 5319, 5320, 5321, 5323, 5327, 5328, 5329, 5330, 5333, 5334, 5336, 5337, 5339, 5340, 5342, 5343, 5344, 5345, 5346, 5347, 5353, 5354, 5357, 5361, 5362, 5364, 5365, 5368, 5369, 5370, 5371, 5372, 5373, 5375, 5376, 5377, 5378, 5379, 5380, 5383, 5384, 5385, 5387, 5388, 5389, 5390, 5391, 5392, 5394, 5397, 5399, 5402, 5403, 5404, 5406, 5407, 5408, 5409, 5411, 5412, 5413, 5414, 5416, 5418, 5419, 5420, 5422, 5423, 5425, 5426, 5427, 5428, 5429, 5430, 5437, 5438, 5440, 5441, 5442, 5444, 5445, 5446, 5447, 5448, 5449, 5450, 5452, 5453, 5454, 5457, 5458, 5459, 5460, 5461, 5462, 5463, 5464, 5466, 5468, 5469, 5471, 5474, 5477, 5480, 5481, 5482, 5483, 5484, 5485, 5486, 5487, 5489, 5490, 5491, 5493, 5496, 5501, 5502, 5504, 5539, 5540, 5541, 5543, 5544, 5545, 5548, 5549, 5551, 5557, 5558, 5561, 5562, 5571, 5573, 5575, 5576, 5577, 5579, 5581, 5582, 5583, 5584, 5585, 5587, 5589, 5590, 5591, 5592, 5593, 5594, 5595, 5598, 5600, 5601, 5602, 5603, 5606, 5607, 5608, 5609, 5610, 5614, 5615, 5617, 5618, 5622, 5628, 5630, 5631, 5637, 5639, 5640, 5642, 5645, 5647, 5648, 5650, 5651, 5652, 5653, 5654, 5655, 5656, 5657, 5659, 5660, 5662, 5663, 5664, 5665, 5666, 5667, 5668, 5669, 5670, 5671, 5672, 5673, 5677, 5678, 5679, 5680, 5681, 5683, 5686, 5689, 5690, 5691, 5692, 5693, 5694, 5696, 5698, 5699, 5700, 5701, 5703, 5705, 5707, 5709, 5712, 5714, 5716, 5720, 5721, 5722, 5723, 5724, 5726, 5728, 5729, 5730, 5736, 5737, 5739, 5741, 5742, 5743, 5744, 5745, 5746, 5747, 5748, 5749, 5751, 5752, 5754, 5755, 5756, 5758, 5759, 5761, 5762, 5763, 5766, 5768, 5772, 5773, 5774, 5776, 5778, 5779, 5781, 5784, 5785, 5786, 5788, 5789, 5791, 5792, 5793, 5794, 5795, 5796, 5797, 5798, 5802, 5803, 5808, 5809, 5811, 5813, 5814, 5815, 5816, 5817, 5819, 5823, 5828, 5830, 5832, 5834, 5837, 5838, 5844, 5848, 5849, 5851, 5853, 5854, 5855, 5860, 5861, 5862, 5864, 5865, 5866, 5868, 5874, 5881, 5882, 5886, 5887, 5888, 5892, 5897, 5898, 5899, 5900, 5902, 5903, 5905, 5907, 5909, 5910, 5912, 5913, 5915, 5916, 5918, 5920, 5921, 5922, 5925, 5927, 5928, 5932, 5933, 5934, 5935, 5936, 5939, 5940, 5942, 5943, 5944, 5945, 5947, 5966, 5967, 5989, 5992, 5993, 5994, 5995, 5996, 5997, 5998, 6000, 6002, 6003, 6004, 6006, 6007, 6008, 6010, 6011, 6012, 6013, 6021, 6023, 6025, 6027, 6028, 6029, 6032, 6034, 6039, 6040, 6042, 6043, 6044, 6045, 6046, 6049, 6051, 6052, 6053, 6055, 6058, 6064, 6066, 6069, 6071, 6072, 6073, 6078, 6079, 6081, 6083, 6084, 6086, 6088, 6089, 6091, 6093, 6094, 6096, 6097, 6099, 6100, 6103, 6105, 6106, 6107, 6108, 6109, 6112, 6113, 6115, 6117, 6122, 6123, 6127, 6130, 6133, 6134, 6158, 6172, 6173, 6174, 6180, 6181, 6182, 6183, 6184, 6186, 6187, 6190, 6191, 6192, 6193, 6195, 6197, 6198, 6201, 6202, 6207, 6223, 6224, 6230, 6234, 6235, 6236, 6237, 6238, 6239, 6240, 6241, 6242, 6243, 6244, 6246, 6247, 6283, 6284, 6285, 6287, 6288, 6290, 6291, 6293, 6294, 6297, 6300, 6301, 6303, 6304, 6305, 6306, 6307, 6308, 6309, 6310, 6313, 6315, 6318, 6320, 6321, 6322, 6323, 6324, 6326, 6327, 6329, 6330, 6331, 6332, 6333, 6369, 6370, 6371, 6372, 6375, 6376, 6377, 6386, 6388, 6393, 6394, 6440, 6441, 6443, 6444, 6445, 6447, 6449, 6452, 6454, 6458, 6460, 6461, 6462, 6463, 6467, 6470, 6471, 6472, 6485, 6502, 6504, 6506, 6507, 6509, 6510, 6514, 6517, 6526, 6527, 6528, 6529, 6531, 6532, 6533, 6534, 6535, 6543, 6545, 6547, 6548, 6552, 6553, 6557, 6559, 6560, 6561, 6566, 6571, 6572, 6577, 6578, 6579, 6581, 6582, 6583, 6585, 6586, 6587, 6589, 6590, 6593, 6598, 6602, 6604, 6605, 6609, 6611, 6613, 6614, 6618, 6619, 6621, 6622, 6626, 6627, 6629, 6632, 6633, 6635, 6637, 6647, 6654, 6707, 6708, 6710, 6713, 6714, 6715, 6717, 6718, 6719, 6724, 6725, 6728, 6733, 6738, 6739, 6740, 6741, 6742, 6743, 6745, 6748, 6750, 6751, 6753, 6755, 6756, 6759, 6760, 6764, 6765, 6766, 6767, 6769, 6770, 6773, 6775, 6776, 6777, 6778, 6779, 6780, 6781, 6783, 6784, 6785, 6788, 6789, 6790, 6791}",2933
7,"(('enter', ('Request For Payment APPROVED by ADMINISTRATION', 'Request For Payment FINAL_APPROVED by SUPERVISOR')),)",1,28,"{989, 1078, 1085, 1088, 1089, 1090, 1092, 1093, 1094, 1095, 1096, 1097, 1098, 1099, 1100, 1101, 1103, 1104, 1105, 1106, 1107, 1108, 1109, 1112, 1114, 1115, 1116, 1117, 1118, 1120, 1121, 1122, 1123, 1124, 1125, 1126, 1127, 1128, 1129, 1130, 1131, 1134, 1135, 1136, 1137, 1138, 1140, 1142, 1145, 1147, 1148, 1149, 1150, 1151, 1152, 1153, 1155, 1156, 1158, 1160, 1161, 1162, 1163, 1165, 1167, 1169, 1170, 1171, 1172, 1176, 1177, 1179, 1180, 1181, 1182, 1183, 1184, 1185, 1186, 1187, 1188, 1190, 1196, 1197, 1198, 1199, 1200, 1201, 1203, 1204, 1205, 1207, 1208, 1209, 1210, 1213, 1214, 1215, 1216, 1218, 1219, 1221, 1222, 1223, 1225, 1228, 1229, 1230, 1231, 1233, 1234, 1237, 1238, 1239, 1240, 1241, 1242, 1244, 1246, 1247, 1250, 1254, 1255, 1263, 1265, 1268, 1272, 1273, 1274, 1275, 1276, 1277, 1280, 1281, 1282, 1284, 1285, 1287, 1290, 1291, 1294, 1300, 1301, 1302, 1304, 1305, 1307, 1308, 1309, 1310, 1311, 1313, 1314, 1315, 1318, 1320, 1321, 1323, 1324, 1325, 1327, 1328, 1329, 1330, 1331, 1332, 1334, 1335, 1336, 1338, 1342, 1345, 1346, 1347, 1349, 1353, 1357, 1360, 1365, 1367, 1368, 1369, 1370, 1373, 1374, 1377, 1378, 1379, 1380, 1382, 1385, 1386, 1387, 1388, 1389, 1390, 1391, 1392, 1393, 1395, 1396, 1397, 1400, 1401, 1402, 1404, 1405, 1406, 1409, 1410, 1413, 1414, 1415, 1420, 1421, 1423, 1424, 1429, 1430, 1431, 1432, 1434, 1435, 1439, 1440, 1441, 1442, 1443, 1446, 1448, 1450, 1452, 1453, 1454, 1455, 1456, 1457, 1458, 1459, 1460, 1461, 1462, 1464, 1467, 1468, 1469, 1470, 1471, 1472, 1473, 1476, 1477, 1478, 1483, 1484, 1485, 1487, 1489, 1491, 1493, 1495, 1496, 1499, 1501, 1502, 1503, 1504, 1505, 1507, 1508, 1509, 1510, 1511, 1512, 1513, 1514, 1515, 1516, 1518, 1520, 1521, 1522, 1523, 1524, 1526, 1528, 1530, 1531, 1532, 1533, 1536, 1538, 1540, 1542, 1543, 1544, 1545, 1546, 1549, 1551, 1552, 1553, 1554, 1556, 1558, 1560, 1562, 1563, 1565, 1566, 1567, 1568, 1569, 1573, 1574, 1578, 1579, 1580, 1581, 1582, 1583, 1584, 1587, 1588, 1589, 1591, 1592, 1593, 1594, 1595, 1596, 1597, 1598, 1601, 1602, 1604, 1605, 1606, 1607, 1610, 1612, 1614, 1619, 1620, 1621, 1622, 1624, 1625, 1627, 1628, 1629, 1630, 1633, 1637, 1639, 1640, 1642, 1643, 1644, 1645, 1646, 1647, 1648, 1655, 1658, 1661, 1662, 1663, 1665, 1666, 1667, 1669, 1670, 1671, 1674, 1678, 1681, 1682, 1683, 1687, 1691, 1693, 1694, 1699, 1700, 1701, 1702, 1704, 1706, 1707, 1708, 1709, 1710, 1712, 1713, 1714, 1715, 1716, 1717, 1718, 1726, 1727, 1728, 1730, 1731, 1732, 1736, 1737, 1739, 1743, 1744, 1745, 1746, 1748, 1752, 1753, 1754, 1756, 1757, 1758, 1760, 1761, 1764, 1769, 1771, 1772, 1773, 1774, 1775, 1776, 1778, 1779, 1780, 1786, 1790, 1796, 1799, 1801, 1802, 1803, 1804, 1805, 1808, 1810, 1811, 1812, 1814, 1817, 1818, 1819, 1821, 1822, 1825, 1827, 1828, 1829, 1830, 1831, 1834, 1835, 1836, 1837, 1840, 1841, 1842, 1843, 1847, 1848, 1849, 1850, 1859, 1863, 1865, 1867, 1869, 1870, 1871, 1874, 1875, 1878, 1880, 1881, 1883, 1885, 1886, 1888, 1892, 1893, 1895, 1896, 1897, 1898, 1900, 1901, 1902, 1903, 1905, 1907, 1909, 1910, 1911, 1912, 1915, 1918, 1919, 1920, 1921, 1922, 1923, 1924, 1928, 1929, 1931, 1934, 1937, 1940, 1941, 1944, 1945, 1946, 1947, 1948, 1951, 1955, 1956, 1957, 1958, 1960, 1962, 1964, 1965, 1967, 1968, 1969, 1971, 1972, 1976, 1978, 1979, 1981, 1983, 1986, 1987, 1992, 1993, 1994, 1996, 1997, 1999, 2000, 2001, 2002, 2004, 2005, 2006, 2007, 2010, 2011, 2017, 2019, 2020, 2023, 2024, 2025, 2026, 2031, 2032, 2033, 2034, 2039, 2040, 2041, 2043, 2044, 2047, 2049, 2050, 2051, 2052, 2053, 2056, 2063, 2064, 2065, 2071, 2073, 2074, 2075, 2077, 2079, 2080, 2082, 2083, 2084, 2085, 2087, 2091, 2094, 2100, 2103, 2109, 2111, 2113, 2114, 2115, 2116, 2117, 2119, 2121, 2122, 2124, 2125, 2126, 2128, 2129, 2130, 2131, 2133, 2134, 2135, 2137, 2138, 2141, 2143, 2144, 2148, 2150, 2151, 2154, 2155, 2157, 2158, 2159, 2164, 2166, 2167, 2168, 2169, 2172, 2173, 2174, 2175, 2176, 2177, 2178, 2180, 2181, 2182, 2183, 2186, 2188, 2189, 2191, 2194, 2195, 2196, 2197, 2200, 2201, 2202, 2203, 2204, 2205, 2209, 2210, 2211, 2213, 2214, 2216, 2218, 2219, 2222, 2223, 2226, 2230, 2232, 2234, 2235, 2237, 2239, 2241, 2242, 2244, 2246, 2247, 2248, 2251, 2252, 2253, 2254, 2255, 2259, 2260, 2261, 2262, 2263, 2264, 2265, 2268, 2269, 2272, 2277, 2280, 2284, 2285, 2287, 2288, 2289, 2291, 2292, 2293, 2294, 2295, 2296, 2297, 2299, 2302, 2303, 2304, 2305, 2306, 2310, 2313, 2315, 2320, 2321, 2324, 2327, 2328, 2329, 2331, 2336, 2337, 2338, 2341, 2342, 2345, 2346, 2348, 2349, 2350, 2351, 2352, 2353, 2354, 2357, 2358, 2359, 2360, 2363, 2364, 2365, 2366, 2370, 2373, 2374, 2375, 2377, 2380, 2383, 2385, 2386, 2387, 2388, 2389, 2390, 2391, 2392, 2393, 2396, 2397, 2398, 2401, 2403, 2404, 2405, 2407, 2408, 2409, 2410, 2411, 2412, 2416, 2420, 2421, 2422, 2423, 2425, 2426, 2427, 2428, 2429, 2430, 2437, 2440, 2443, 2448, 2450, 2452, 2453, 2454, 2455, 2459, 2460, 2466, 2470, 2471, 2472, 2473, 2475, 2476, 2477, 2478, 2480, 2481, 2482, 2484, 2485, 2486, 2487, 2488, 2489, 2490, 2491, 2492, 2494, 2495, 2496, 2497, 2501, 2503, 2504, 2508, 2510, 2511, 2515, 2516, 2517, 2518, 2519, 2520, 2522, 2523, 2524, 2525, 2526, 2527, 2528, 2529, 2530, 2531, 2535, 2540, 2543, 2544, 2551, 2552, 2553, 2554, 2557, 2559, 2561, 2562, 2564, 2569, 2570, 2574, 2579, 2580, 2584, 2586, 2591, 2592, 2593, 2595, 2596, 2597, 2599, 2603, 2604, 2606, 2607, 2608, 2614, 2615, 2616, 2620, 2622, 2623, 2624, 2625, 2627, 2628, 2629, 2633, 2635, 2636, 2637, 2640, 2643, 2648, 2650, 2652, 2653, 2656, 2660, 2662, 2666, 2667, 2669, 2672, 2673, 2677, 2679, 2680, 2681, 2683, 2685, 2686, 2687, 2688, 2690, 2692, 2693, 2694, 2696, 2697, 2698, 2699, 2700, 2701, 2703, 2704, 2705, 2707, 2708, 2710, 2712, 2713, 2717, 2718, 2720, 2724, 2725, 2727, 2732, 2733, 2734, 2735, 2736, 2738, 2739, 2740, 2745, 2746, 2747, 2748, 2753, 2754, 2755, 2756, 2757, 2758, 2759, 2760, 2763, 2765, 2768, 2770, 2771, 2772, 2773, 2774, 2777, 2779, 2782, 2783, 2784, 2787, 2789, 2790, 2792, 2793, 2794, 2795, 2800, 2802, 2804, 2808, 2811, 2813, 2817, 2819, 2820, 2821, 2828, 2830, 2831, 2832, 2833, 2835, 2836, 2837, 2838, 2841, 2842, 2843, 2845, 2846, 2847, 2850, 2851, 2855, 2856, 2857, 2858, 2859, 2860, 2861, 2862, 2863, 2865, 2866, 2867, 2868, 2869, 2870, 2872, 2873, 2877, 2878, 2883, 2887, 2888, 2891, 2897, 2898, 2899, 2900, 2901, 2904, 2908, 2909, 2910, 2911, 2912, 2914, 2916, 2917, 2918, 2921, 2923, 2924, 2926, 2930, 2931, 2932, 2934, 2938, 2941, 2942, 2943, 2944, 2945, 2946, 2947, 2949, 2950, 2952, 2953, 2959, 2962, 2963, 2965, 2967, 2969, 2970, 2971, 2974, 2975, 2976, 2977, 2979, 2980, 2982, 2983, 2984, 2985, 2986, 2987, 2989, 2991, 2992, 2993, 2995, 2997, 2998, 2999, 3001, 3004, 3005, 3006, 3008, 3010, 3012, 3015, 3016, 3018, 3020, 3022, 3023, 3024, 3025, 3026, 3027, 3028, 3029, 3030, 3031, 3034, 3036, 3038, 3039, 3040, 3042, 3043, 3046, 3047, 3048, 3049, 3050, 3052, 3053, 3057, 3058, 3059, 3060, 3061, 3062, 3063, 3066, 3067, 3070, 3071, 3072, 3073, 3075, 3076, 3077, 3079, 3080, 3081, 3082, 3084, 3086, 3087, 3088, 3089, 3091, 3093, 3094, 3097, 3098, 3100, 3101, 3103, 3104, 3107, 3108, 3109, 3111, 3112, 3113, 3114, 3115, 3116, 3119, 3121, 3122, 3123, 3124, 3125, 3126, 3128, 3131, 3132, 3134, 3135, 3136, 3137, 3142, 3144, 3146, 3147, 3151, 3152, 3155, 3156, 3157, 3159, 3160, 3163, 3164, 3165, 3166, 3170, 3171, 3172, 3174, 3175, 3176, 3178, 3179, 3180, 3181, 3182, 3184, 3187, 3188, 3192, 3195, 3196, 3197, 3198, 3199, 3200, 3202, 3205, 3206, 3210, 3212, 3213, 3215, 3216, 3217, 3218, 3219, 3224, 3226, 3227, 3228, 3231, 3232, 3234, 3236, 3240, 3241, 3242, 3243, 3244, 3247, 3248, 3249, 3252, 3253, 3254, 3255, 3256, 3260, 3262, 3263, 3265, 3269, 3271, 3273, 3276, 3277, 3279, 3283, 3284, 3285, 3287, 3288, 3289, 3291, 3292, 3293, 3294, 3295, 3296, 3298, 3300, 3302, 3304, 3305, 3306, 3307, 3318, 3319, 3320, 3323, 3325, 3326, 3328, 3330, 3331, 3335, 3338, 3341, 3343, 3345, 3346, 3349, 3350, 3351, 3355, 3357, 3358, 3359, 3363, 3364, 3366, 3368, 3369, 3370, 3371, 3372, 3373, 3375, 3377, 3378, 3380, 3381, 3382, 3383, 3387, 3390, 3391, 3393, 3394, 3396, 3397, 3398, 3399, 3400, 3402, 3403, 3404, 3405, 3406, 3407, 3410, 3411, 3413, 3414, 3416, 3417, 3418, 3422, 3423, 3426, 3428, 3429, 3435, 3437, 3438, 3439, 3440, 3442, 3444, 3446, 3447, 3449, 3452, 3453, 3454, 3456, 3459, 3460, 3462, 3463, 3465, 3466, 3467, 3468, 3469, 3470, 3471, 3474, 3476, 3480, 3481, 3482, 3483, 3485, 3487, 3490, 3493, 3494, 3495, 3497, 3498, 3499, 3502, 3503, 3504, 3505, 3506, 3507, 3509, 3514, 3515, 3516, 3520, 3522, 3523, 3525, 3526, 3527, 3529, 3531, 3532, 3536, 3538, 3541, 3542, 3544, 3546, 3547, 3548, 3549, 3550, 3551, 3552, 3553, 3556, 3557, 3563, 3564, 3565, 3566, 3568, 3569, 3576, 3577, 3578, 3580, 3581, 3582, 3583, 3584, 3586, 3589, 3591, 3592, 3593, 3594, 3595, 3596, 3598, 3599, 3600, 3601, 3602, 3604, 3605, 3608, 3610, 3611, 3612, 3613, 3614, 3615, 3620, 3621, 3622, 3625, 3627, 3629, 3632, 3633, 3635, 3640, 3642, 3644, 3645, 3646, 3650, 3651, 3652, 3653, 3658, 3660, 3664, 3665, 3667, 3669, 3672, 3674, 3676, 3677, 3680, 3681, 3682, 3683, 3684, 3686, 3688, 3689, 3692, 3694, 3696, 3697, 3699, 3707, 3708, 3710, 3711, 3712, 3713, 3716, 3717, 3718, 3721, 3722, 3728, 3729, 3731, 3733, 3735, 3737, 3740, 3743, 3744, 3749, 3751, 3752, 3753, 3754, 3757, 3758, 3759, 3760, 3762, 3765, 3767, 3768, 3770, 3773, 3775, 3776, 3778, 3779, 3782, 3783, 3785, 3787, 3788, 3791, 3792, 3793, 3795, 3796, 3798, 3800, 3802, 3803, 3805, 3806, 3807, 3808, 3809, 3810, 3811, 3812, 3814, 3815, 3817, 3822, 3826, 3828, 3834, 3835, 3836, 3839, 3840, 3841, 3845, 3846, 3847, 3848, 3849, 3850, 3851, 3852, 3853, 3854, 3855, 3859, 3860, 3861, 3862, 3863, 3864, 3866, 3867, 3869, 3871, 3872, 3874, 3877, 3878, 3879, 3880, 3884, 3886, 3887, 3888, 3889, 3890, 3891, 3892, 3893, 3898, 3900, 3901, 3902, 3904, 3905, 3906, 3908, 3912, 3913, 3915, 3917, 3918, 3919, 3921, 3922, 3924, 3926, 3928, 3929, 3930, 3932, 3933, 3934, 3937, 3941, 3943, 3944, 3945, 3946, 3949, 3951, 3952, 3954, 3955, 3956, 3959, 3963, 3964, 3966, 3972, 3974, 3979, 3980, 3981, 3982, 3983, 3984, 3987, 3988, 3989, 3992, 3993, 3995, 3999, 4001, 4003, 4010, 4011, 4012, 4013, 4014, 4016, 4017, 4018, 4020, 4021, 4022, 4023, 4024, 4025, 4028, 4032, 4033, 4037, 4038, 4039, 4040, 4041, 4042, 4043, 4044, 4045, 4053, 4056, 4057, 4058, 4059, 4060, 4067, 4068, 4069, 4070, 4071, 4072, 4073, 4074, 4075, 4077, 4078, 4081, 4083, 4084, 4085, 4086, 4088, 4090, 4091, 4092, 4093, 4094, 4095, 4097, 4098, 4099, 4104, 4106, 4107, 4108, 4109, 4111, 4112, 4113, 4114, 4115, 4118, 4120, 4121, 4124, 4127, 4128, 4129, 4130, 4132, 4133, 4134, 4135, 4136, 4137, 4139, 4142, 4144, 4145, 4147, 4148, 4149, 4150, 4151, 4152, 4153, 4156, 4157, 4160, 4164, 4165, 4168, 4170, 4171, 4172, 4173, 4174, 4175, 4176, 4177, 4178, 4179, 4181, 4182, 4185, 4186, 4187, 4189, 4190, 4192, 4193, 4195, 4198, 4201, 4202, 4203, 4204, 4205, 4207, 4209, 4210, 4211, 4213, 4217, 4218, 4219, 4221, 4222, 4225, 4227, 4229, 4230, 4231, 4232, 4234, 4235, 4237, 4239, 4240, 4243, 4245, 4247, 4248, 4251, 4252, 4254, 4255, 4257, 4259, 4260, 4261, 4264, 4265, 4266, 4267, 4269, 4271, 4272, 4276, 4281, 4283, 4284, 4287, 4288, 4292, 4294, 4295, 4298, 4300, 4301, 4302, 4303, 4305, 4306, 4307, 4310, 4311, 4312, 4313, 4322, 4323, 4326, 4328, 4329, 4332, 4334, 4337, 4339, 4340, 4341, 4343, 4344, 4346, 4347, 4348, 4350, 4351, 4353, 4354, 4356, 4357, 4359, 4361, 4362, 4365, 4366, 4367, 4369, 4373, 4374, 4376, 4378, 4380, 4383, 4384, 4385, 4387, 4389, 4390, 4391, 4393, 4394, 4395, 4396, 4397, 4400, 4402, 4403, 4404, 4405, 4406, 4408, 4410, 4412, 4414, 4415, 4416, 4418, 4419, 4421, 4423, 4424, 4428, 4429, 4434, 4436, 4437, 4439, 4442, 4443, 4444, 4446, 4448, 4449, 4450, 4451, 4452, 4453, 4455, 4456, 4457, 4458, 4459, 4465, 4466, 4467, 4473, 4474, 4477, 4479, 4480, 4481, 4482, 4483, 4484, 4485, 4486, 4487, 4488, 4489, 4490, 4491, 4495, 4496, 4498, 4499, 4500, 4501, 4502, 4503, 4504, 4505, 4506, 4507, 4511, 4512, 4513, 4514, 4515, 4516, 4517, 4519, 4520, 4521, 4522, 4523, 4525, 4526, 4528, 4529, 4530, 4531, 4532, 4533, 4534, 4535, 4537, 4538, 4539, 4541, 4542, 4545, 4546, 4547, 4548, 4549, 4551, 4552, 4555, 4556, 4557, 4558, 4559, 4560, 4561, 4562, 4566, 4567, 4568, 4569, 4570, 4575, 4577, 4579, 4581, 4583, 4584, 4588, 4593, 4595, 4598, 4599, 4600, 4601, 4604, 4605, 4611, 4612, 4615, 4622, 4623, 4624, 4625, 4628, 4630, 4635, 4636, 4637, 4639, 4640, 4641, 4642, 4645, 4646, 4647, 4648, 4651, 4652, 4654, 4657, 4658, 4659, 4660, 4661, 4663, 4664, 4666, 4668, 4670, 4671, 4672, 4674, 4675, 4676, 4678, 4679, 4680, 4681, 4685, 4686, 4687, 4688, 4689, 4690, 4691, 4693, 4695, 4696, 4697, 4698, 4699, 4700, 4701, 4703, 4704, 4705, 4706, 4707, 4708, 4709, 4710, 4711, 4712, 4713, 4715, 4716, 4717, 4718, 4719, 4720, 4722, 4724, 4727, 4728, 4729, 4730, 4731, 4736, 4739, 4740, 4742, 4743, 4744, 4745, 4746, 4747, 4748, 4749, 4750, 4751, 4752, 4753, 4755, 4757, 4761, 4762, 4764, 4765, 4767, 4773, 4774, 4777, 4779, 4781, 4784, 4785, 4788, 4790, 4791, 4792, 4793, 4794, 4795, 4796, 4797, 4798, 4799, 4800, 4802, 4805, 4807, 4808, 4809, 4810, 4811, 4814, 4815, 4821, 4823, 4827, 4828, 4829, 4832, 4833, 4834, 4835, 4836, 4837, 4842, 4843, 4844, 4845, 4846, 4848, 4849, 4850, 4851, 4854, 4855, 4856, 4857, 4859, 4860, 4861, 4862, 4863, 4868, 4869, 4871, 4872, 4873, 4874, 4876, 4877, 4879, 4880, 4882, 4885, 4888, 4889, 4891, 4892, 4893, 4894, 4898, 4901, 4903, 4904, 4905, 4906, 4907, 4908, 4909, 4910, 4911, 4912, 4914, 4915, 4919, 4920, 4921, 4923, 4926, 4927, 4929, 4930, 4931, 4935, 4937, 4940, 4942, 4948, 4949, 4950, 4951, 4954, 4955, 4958, 4959, 4962, 4963, 4964, 4968, 4969, 4970, 4971, 4972, 4973, 4974, 4975, 4980, 4981, 4982, 4983, 4984, 4987, 4995, 4998, 5000, 5002, 5003, 5004, 5005, 5006, 5007, 5009, 5011, 5012, 5014, 5015, 5017, 5018, 5019, 5020, 5021, 5023, 5024, 5025, 5027, 5029, 5032, 5033, 5036, 5037, 5038, 5039, 5040, 5041, 5042, 5043, 5044, 5045, 5047, 5051, 5052, 5055, 5056, 5057, 5058, 5059, 5060, 5063, 5066, 5067, 5068, 5070, 5072, 5075, 5076, 5077, 5080, 5081, 5082, 5083, 5084, 5085, 5086, 5087, 5090, 5091, 5092, 5093, 5095, 5096, 5097, 5105, 5107, 5108, 5109, 5110, 5114, 5115, 5117, 5118, 5119, 5120, 5121, 5122, 5123, 5124, 5125, 5126, 5127, 5128, 5129, 5130, 5132, 5133, 5134, 5135, 5136, 5137, 5140, 5141, 5142, 5143, 5145, 5147, 5149, 5150, 5155, 5157, 5158, 5160, 5161, 5162, 5163, 5164, 5166, 5167, 5169, 5170, 5171, 5174, 5176, 5178, 5182, 5183, 5185, 5187, 5190, 5191, 5194, 5195, 5196, 5197, 5198, 5199, 5201, 5202, 5203, 5205, 5209, 5210, 5211, 5212, 5214, 5215, 5217, 5220, 5221, 5224, 5225, 5226, 5229, 5230, 5231, 5232, 5236, 5237, 5238, 5239, 5242, 5243, 5246, 5248, 5253, 5257, 5258, 5259, 5260, 5262, 5263, 5264, 5265, 5267, 5268, 5269, 5270, 5273, 5274, 5275, 5278, 5279, 5281, 5283, 5284, 5287, 5288, 5291, 5292, 5296, 5297, 5300, 5301, 5302, 5303, 5304, 5305, 5307, 5308, 5312, 5314, 5315, 5316, 5319, 5320, 5321, 5323, 5327, 5328, 5329, 5330, 5333, 5334, 5336, 5337, 5339, 5340, 5342, 5343, 5344, 5345, 5346, 5347, 5353, 5354, 5357, 5361, 5362, 5364, 5365, 5368, 5369, 5370, 5371, 5372, 5373, 5375, 5376, 5377, 5378, 5379, 5380, 5383, 5384, 5385, 5387, 5388, 5389, 5390, 5391, 5392, 5394, 5397, 5399, 5402, 5403, 5404, 5406, 5407, 5408, 5409, 5411, 5412, 5413, 5414, 5416, 5418, 5419, 5420, 5422, 5423, 5425, 5426, 5427, 5428, 5429, 5430, 5437, 5438, 5440, 5441, 5442, 5443, 5444, 5445, 5446, 5447, 5448, 5449, 5450, 5452, 5453, 5454, 5457, 5458, 5459, 5460, 5461, 5462, 5463, 5464, 5466, 5468, 5469, 5471, 5474, 5476, 5477, 5480, 5481, 5482, 5483, 5484, 5485, 5486, 5487, 5489, 5490, 5491, 5493, 5496, 5501, 5502, 5504, 5505, 5506, 5511, 5512, 5513, 5514, 5515, 5516, 5518, 5520, 5521, 5522, 5523, 5529, 5530, 5534, 5535, 5536, 5537, 5538, 5539, 5540, 5541, 5543, 5544, 5545, 5548, 5549, 5551, 5557, 5558, 5561, 5562, 5571, 5573, 5575, 5576, 5577, 5579, 5581, 5582, 5583, 5584, 5585, 5587, 5589, 5590, 5591, 5592, 5593, 5594, 5595, 5598, 5600, 5601, 5602, 5603, 5606, 5607, 5608, 5609, 5610, 5614, 5615, 5617, 5618, 5622, 5628, 5630, 5631, 5637, 5639, 5640, 5642, 5645, 5647, 5648, 5650, 5651, 5652, 5653, 5654, 5655, 5656, 5657, 5659, 5660, 5662, 5663, 5664, 5665, 5666, 5667, 5668, 5669, 5670, 5671, 5672, 5673, 5677, 5678, 5679, 5680, 5681, 5683, 5686, 5689, 5690, 5691, 5692, 5693, 5694, 5696, 5698, 5699, 5700, 5701, 5703, 5705, 5707, 5709, 5712, 5714, 5716, 5720, 5721, 5722, 5723, 5724, 5726, 5728, 5729, 5730, 5736, 5737, 5739, 5741, 5742, 5743, 5744, 5745, 5746, 5747, 5748, 5749, 5751, 5752, 5754, 5755, 5756, 5758, 5759, 5761, 5762, 5763, 5766, 5768, 5772, 5773, 5774, 5776, 5778, 5779, 5781, 5784, 5785, 5786, 5788, 5789, 5791, 5792, 5793, 5794, 5795, 5796, 5797, 5798, 5802, 5803, 5808, 5809, 5811, 5813, 5814, 5815, 5816, 5817, 5819, 5823, 5828, 5830, 5832, 5834, 5837, 5838, 5844, 5848, 5849, 5851, 5853, 5854, 5855, 5860, 5861, 5862, 5864, 5865, 5866, 5868, 5874, 5881, 5882, 5886, 5887, 5888, 5892, 5897, 5898, 5899, 5900, 5902, 5903, 5905, 5907, 5909, 5910, 5912, 5913, 5915, 5916, 5918, 5920, 5921, 5922, 5925, 5927, 5928, 5932, 5933, 5934, 5935, 5936, 5939, 5940, 5942, 5943, 5944, 5945, 5947, 5948, 5949, 5950, 5952, 5953, 5954, 5955, 5956, 5957, 5960, 5962, 5963, 5965, 5966, 5967, 5968, 5970, 5971, 5979, 5980, 5983, 5984, 5985, 5987, 5988, 5989, 5992, 5993, 5994, 5995, 5996, 5997, 5998, 6000, 6002, 6003, 6004, 6006, 6007, 6008, 6010, 6011, 6012, 6013, 6017, 6021, 6023, 6025, 6027, 6028, 6029, 6032, 6034, 6039, 6040, 6042, 6043, 6044, 6045, 6046, 6049, 6051, 6052, 6053, 6055, 6058, 6064, 6066, 6069, 6071, 6072, 6073, 6078, 6079, 6081, 6083, 6084, 6086, 6088, 6089, 6091, 6093, 6094, 6096, 6097, 6099, 6100, 6103, 6105, 6106, 6107, 6108, 6109, 6112, 6113, 6115, 6117, 6122, 6123, 6127, 6130, 6132, 6133, 6134, 6139, 6142, 6143, 6144, 6147, 6148, 6149, 6150, 6151, 6152, 6153, 6154, 6155, 6156, 6157, 6158, 6159, 6160, 6161, 6162, 6163, 6166, 6167, 6168, 6169, 6170, 6171, 6172, 6173, 6174, 6180, 6181, 6182, 6183, 6184, 6185, 6186, 6187, 6190, 6191, 6192, 6193, 6195, 6197, 6198, 6201, 6202, 6207, 6223, 6224, 6230, 6233, 6234, 6235, 6236, 6237, 6238, 6239, 6240, 6241, 6242, 6243, 6244, 6245, 6246, 6247, 6249, 6251, 6253, 6254, 6255, 6256, 6258, 6259, 6260, 6261, 6263, 6264, 6265, 6266, 6267, 6269, 6270, 6271, 6275, 6276, 6277, 6281, 6282, 6283, 6284, 6285, 6287, 6288, 6290, 6291, 6293, 6294, 6297, 6300, 6301, 6303, 6304, 6305, 6306, 6307, 6308, 6309, 6310, 6313, 6315, 6318, 6320, 6321, 6322, 6323, 6324, 6326, 6327, 6329, 6330, 6331, 6332, 6333, 6335, 6339, 6341, 6342, 6344, 6345, 6346, 6347, 6348, 6349, 6351, 6352, 6354, 6355, 6356, 6357, 6359, 6361, 6364, 6369, 6370, 6371, 6372, 6375, 6376, 6377, 6386, 6388, 6393, 6394, 6399, 6401, 6404, 6405, 6407, 6408, 6410, 6411, 6412, 6413, 6414, 6415, 6416, 6417, 6418, 6422, 6423, 6424, 6426, 6428, 6430, 6431, 6433, 6434, 6436, 6438, 6440, 6441, 6443, 6444, 6445, 6447, 6449, 6452, 6454, 6458, 6460, 6461, 6462, 6463, 6464, 6467, 6470, 6471, 6472, 6473, 6474, 6475, 6477, 6478, 6479, 6483, 6484, 6485, 6486, 6487, 6488, 6491, 6492, 6494, 6495, 6496, 6498, 6499, 6502, 6504, 6506, 6507, 6508, 6509, 6510, 6514, 6516, 6517, 6526, 6527, 6528, 6529, 6531, 6532, 6533, 6534, 6535, 6543, 6545, 6547, 6548, 6552, 6553, 6557, 6559, 6560, 6561, 6566, 6571, 6572, 6577, 6578, 6579, 6580, 6581, 6582, 6583, 6585, 6586, 6587, 6589, 6590, 6593, 6598, 6602, 6604, 6605, 6609, 6611, 6613, 6614, 6618, 6619, 6621, 6622, 6626, 6627, 6628, 6629, 6632, 6633, 6635, 6637, 6643, 6644, 6645, 6647, 6648, 6649, 6651, 6652, 6653, 6654, 6655, 6656, 6657, 6659, 6660, 6661, 6663, 6664, 6666, 6669, 6671, 6672, 6677, 6680, 6681, 6682, 6686, 6687, 6688, 6689, 6690, 6693, 6694, 6696, 6697, 6698, 6699, 6701, 6702, 6703, 6704, 6705, 6707, 6708, 6710, 6713, 6714, 6715, 6717, 6718, 6719, 6724, 6725, 6728, 6733, 6738, 6739, 6740, 6741, 6742, 6743, 6745, 6748, 6750, 6751, 6753, 6755, 6756, 6759, 6760, 6764, 6765, 6766, 6767, 6769, 6770, 6773, 6775, 6776, 6777, 6778, 6779, 6780, 6781, 6783, 6784, 6785, 6788, 6789, 6790, 6791}",3310,"{6144, 6147, 6148, 6149, 6150, 6151, 6152, 6153, 6154, 6155, 6156, 6157, 6159, 6160, 6161, 6162, 6163, 6166, 6167, 6168, 6169, 6170, 6171, 6185, 6207, 6230, 6233, 6531, 6532, 6245, 6533, 6249, 6251, 6253, 6254, 6255, 6256, 6258, 6259, 6260, 6261, 6263, 6264, 6265, 6266, 6267, 6269, 6270, 6271, 6275, 6276, 6277, 6281, 6282, 6283, 6284, 6285, 6287, 6288, 6290, 6291, 6293, 6294, 6297, 6300, 6301, 6303, 6304, 6305, 6306, 6307, 6308, 6309, 6310, 6318, 6323, 6335, 6339, 6341, 6342, 6344, 6345, 6346, 6347, 6348, 6349, 6351, 6352, 6354, 6355, 6356, 6357, 6359, 6361, 6364, 6399, 6401, 6404, 6405, 6407, 6408, 6410, 6411, 6412, 6413, 6414, 6415, 6416, 6417, 6418, 6422, 6423, 6424, 6426, 6428, 6430, 6431, 6433, 6434, 6436, 6438, 6440, 6441, 6443, 6444, 6445, 6447, 6449, 6452, 6454, 6458, 6460, 6461, 6462, 6463, 6464, 6467, 6470, 6471, 6472, 6473, 6474, 6475, 4429, 6477, 6479, 6478, 6483, 4436, 6484, 6486, 6487, 6488, 6491, 6492, 6494, 6495, 6496, 6498, 6499, 6502, 6504, 6506, 6507, 6508, 6509, 6510, 6514, 6516, 6517, 6526, 6527, 6528, 6529, 4479, 4480, 4481, 4482, 6534, 6535, 4483, 4484, 4485, 4486, 4487, 4488, 4489, 4490, 4491, 4495, 4496, 6543, 4498, 4499, 4500, 4501, 4502, 4503, 6545, 6547, 6548, 6552, 4529, 4530, 4531, 6580, 4532, 4533, 4534, 4535, 4537, 4538, 4539, 4541, 4542, 4546, 4547, 4548, 4549, 4551, 4552, 6628, 6629, 6633, 6643, 6644, 6645, 6648, 6649, 6651, 6652, 6653, 6655, 6656, 6657, 6659, 6660, 6661, 6663, 6664, 6666, 6669, 6671, 6672, 6677, 6680, 6681, 6682, 2584, 6686, 6687, 6688, 6689, 6690, 6693, 6694, 6696, 6697, 6698, 6699, 6701, 6702, 6703, 6704, 6705, 2616, 2620, 2669, 2683, 2685, 2686, 2687, 2688, 2690, 2692, 2693, 2694, 2696, 2697, 2698, 2699, 2700, 2701, 4843, 4861, 2828, 4931, 4935, 4950, 4951, 5000, 5012, 5014, 5015, 5017, 5018, 5019, 5020, 5021, 5023, 5024, 5025, 5027, 5029, 5032, 5033, 5036, 5037, 5038, 5039, 5040, 5042, 5043, 5044, 5045, 5047, 5051, 5052, 5055, 5056, 5057, 5058, 5059, 5060, 5084, 5090, 5091, 5092, 5093, 5095, 5096, 5097, 5105, 5107, 5108, 5109, 5110, 5114, 5117, 5118, 5119, 5120, 5121, 5122, 5123, 1078, 1088, 1089, 1090, 1092, 1093, 1095, 1096, 1097, 1098, 1099, 1100, 1101, 1103, 1104, 1105, 1106, 1107, 1108, 1109, 1112, 5209, 5210, 5211, 5212, 1114, 1115, 1116, 1117, 5217, 1118, 1120, 5220, 5221, 1121, 1122, 5224, 5225, 5226, 1123, 1124, 5229, 5230, 5231, 5232, 1128, 1129, 1130, 5236, 5237, 5238, 5239, 5242, 5243, 5246, 5248, 5253, 1187, 1213, 1214, 1215, 1216, 1218, 1219, 1221, 1222, 1223, 1225, 1228, 1229, 1230, 1234, 1237, 1238, 1239, 1240, 1241, 1242, 5375, 5376, 5377, 5378, 5379, 5380, 5384, 5385, 5387, 5388, 5389, 5390, 5391, 5392, 5394, 5397, 5399, 1347, 5443, 1367, 1368, 1369, 1370, 1373, 1374, 1377, 1378, 1379, 5476, 1380, 1385, 1386, 1387, 1388, 1389, 1390, 1391, 1392, 1393, 1395, 1396, 5505, 5506, 1413, 5511, 5512, 5513, 5514, 5515, 5516, 5518, 5520, 5521, 5522, 5523, 5529, 5530, 5534, 5535, 5536, 5537, 5538, 1443, 1457, 1458, 1459, 1460, 1461, 1462, 1464, 1467, 1469, 1470, 1471, 1472, 1473, 1476, 1477, 1478, 1483, 1484, 1485, 1487, 1489, 1491, 1493, 1495, 1499, 1501, 1502, 1503, 1504, 1505, 1507, 1508, 1509, 1510, 1511, 1512, 1513, 1515, 1516, 1518, 1520, 1521, 1522, 1523, 1524, 1526, 1528, 1530, 1531, 5657, 5659, 5660, 1125, 5662, 5663, 5664, 5665, 5666, 5667, 5668, 5669, 5670, 1126, 5672, 5673, 1127, 5677, 5678, 5679, 5680, 5681, 1131, 5699, 5701, 5892, 1799, 1801, 1802, 1803, 1804, 1805, 1808, 1810, 1811, 1814, 1817, 1825, 5934, 1849, 1850, 5948, 5949, 5950, 5952, 5953, 5954, 1859, 5955, 5956, 5957, 1863, 5960, 1865, 5962, 1867, 5963, 1869, 1870, 1871, 5965, 5966, 1874, 1875, 5968, 5970, 1878, 5971, 1880, 1881, 5979, 5980, 5983, 5984, 5985, 5987, 5988, 5989, 5992, 5993, 5994, 5995, 5996, 5997, 5998, 6000, 6002, 6003, 6004, 6006, 6007, 6008, 6010, 6011, 6012, 6017, 6132, 6139, 6142, 6143}",635,"{989, 1085, 1094, 1134, 1135, 1136, 1137, 1138, 1140, 1142, 1145, 1147, 1148, 1149, 1150, 1151, 1152, 1153, 1155, 1156, 1158, 1160, 1161, 1162, 1163, 1165, 1167, 1169, 1170, 1171, 1172, 1176, 1177, 1179, 1180, 1181, 1182, 1183, 1184, 1185, 1186, 1188, 1190, 1196, 1197, 1198, 1199, 1200, 1201, 1203, 1204, 1205, 1207, 1208, 1209, 1210, 1231, 1233, 1244, 1246, 1247, 1250, 1254, 1255, 1263, 1265, 1268, 1272, 1273, 1274, 1275, 1276, 1277, 1280, 1281, 1282, 1284, 1285, 1287, 1290, 1291, 1294, 1300, 1301, 1302, 1304, 1305, 1307, 1308, 1309, 1310, 1311, 1313, 1314, 1315, 1318, 1320, 1321, 1323, 1324, 1325, 1327, 1328, 1329, 1330, 1331, 1332, 1334, 1335, 1336, 1338, 1342, 1345, 1346, 1349, 1353, 1357, 1360, 1365, 1382, 1397, 1400, 1401, 1402, 1404, 1405, 1406, 1409, 1410, 1414, 1415, 1420, 1421, 1423, 1424, 1429, 1430, 1431, 1432, 1434, 1435, 1439, 1440, 1441, 1442, 1446, 1448, 1450, 1452, 1453, 1454, 1455, 1456, 1468, 1496, 1514, 1532, 1533, 1536, 1538, 1540, 1542, 1543, 1544, 1545, 1546, 1549, 1551, 1552, 1553, 1554, 1556, 1558, 1560, 1562, 1563, 1565, 1566, 1567, 1568, 1569, 1573, 1574, 1578, 1579, 1580, 1581, 1582, 1583, 1584, 1587, 1588, 1589, 1591, 1592, 1593, 1594, 1595, 1596, 1597, 1598, 1601, 1602, 1604, 1605, 1606, 1607, 1610, 1612, 1614, 1619, 1620, 1621, 1622, 1624, 1625, 1627, 1628, 1629, 1630, 1633, 1637, 1639, 1640, 1642, 1643, 1644, 1645, 1646, 1647, 1648, 1655, 1658, 1661, 1662, 1663, 1665, 1666, 1667, 1669, 1670, 1671, 1674, 1678, 1681, 1682, 1683, 1687, 1691, 1693, 1694, 1699, 1700, 1701, 1702, 1704, 1706, 1707, 1708, 1709, 1710, 1712, 1713, 1714, 1715, 1716, 1717, 1718, 1726, 1727, 1728, 1730, 1731, 1732, 1736, 1737, 1739, 1743, 1744, 1745, 1746, 1748, 1752, 1753, 1754, 1756, 1757, 1758, 1760, 1761, 1764, 1769, 1771, 1772, 1773, 1774, 1775, 1776, 1778, 1779, 1780, 1786, 1790, 1796, 1812, 1818, 1819, 1821, 1822, 1827, 1828, 1829, 1830, 1831, 1834, 1835, 1836, 1837, 1840, 1841, 1842, 1843, 1847, 1848, 1883, 1885, 1886, 1888, 1892, 1893, 1895, 1896, 1897, 1898, 1900, 1901, 1902, 1903, 1905, 1907, 1909, 1910, 1911, 1912, 1915, 1918, 1919, 1920, 1921, 1922, 1923, 1924, 1928, 1929, 1931, 1934, 1937, 1940, 1941, 1944, 1945, 1946, 1947, 1948, 1951, 1955, 1956, 1957, 1958, 1960, 1962, 1964, 1965, 1967, 1968, 1969, 1971, 1972, 1976, 1978, 1979, 1981, 1983, 1986, 1987, 1992, 1993, 1994, 1996, 1997, 1999, 2000, 2001, 2002, 2004, 2005, 2006, 2007, 2010, 2011, 2017, 2019, 2020, 2023, 2024, 2025, 2026, 2031, 2032, 2033, 2034, 2039, 2040, 2041, 2043, 2044, 2047, 2049, 2050, 2051, 2052, 2053, 2056, 2063, 2064, 2065, 2071, 2073, 2074, 2075, 2077, 2079, 2080, 2082, 2083, 2084, 2085, 2087, 2091, 2094, 2100, 2103, 2109, 2111, 2113, 2114, 2115, 2116, 2117, 2119, 2121, 2122, 2124, 2125, 2126, 2128, 2129, 2130, 2131, 2133, 2134, 2135, 2137, 2138, 2141, 2143, 2144, 2148, 2150, 2151, 2154, 2155, 2157, 2158, 2159, 2164, 2166, 2167, 2168, 2169, 2172, 2173, 2174, 2175, 2176, 2177, 2178, 2180, 2181, 2182, 2183, 2186, 2188, 2189, 2191, 2194, 2195, 2196, 2197, 2200, 2201, 2202, 2203, 2204, 2205, 2209, 2210, 2211, 2213, 2214, 2216, 2218, 2219, 2222, 2223, 2226, 2230, 2232, 2234, 2235, 2237, 2239, 2241, 2242, 2244, 2246, 2247, 2248, 2251, 2252, 2253, 2254, 2255, 2259, 2260, 2261, 2262, 2263, 2264, 2265, 2268, 2269, 2272, 2277, 2280, 2284, 2285, 2287, 2288, 2289, 2291, 2292, 2293, 2294, 2295, 2296, 2297, 2299, 2302, 2303, 2304, 2305, 2306, 2310, 2313, 2315, 2320, 2321, 2324, 2327, 2328, 2329, 2331, 2336, 2337, 2338, 2341, 2342, 2345, 2346, 2348, 2349, 2350, 2351, 2352, 2353, 2354, 2357, 2358, 2359, 2360, 2363, 2364, 2365, 2366, 2370, 2373, 2374, 2375, 2377, 2380, 2383, 2385, 2386, 2387, 2388, 2389, 2390, 2391, 2392, 2393, 2396, 2397, 2398, 2401, 2403, 2404, 2405, 2407, 2408, 2409, 2410, 2411, 2412, 2416, 2420, 2421, 2422, 2423, 2425, 2426, 2427, 2428, 2429, 2430, 2437, 2440, 2443, 2448, 2450, 2452, 2453, 2454, 2455, 2459, 2460, 2466, 2470, 2471, 2472, 2473, 2475, 2476, 2477, 2478, 2480, 2481, 2482, 2484, 2485, 2486, 2487, 2488, 2489, 2490, 2491, 2492, 2494, 2495, 2496, 2497, 2501, 2503, 2504, 2508, 2510, 2511, 2515, 2516, 2517, 2518, 2519, 2520, 2522, 2523, 2524, 2525, 2526, 2527, 2528, 2529, 2530, 2531, 2535, 2540, 2543, 2544, 2551, 2552, 2553, 2554, 2557, 2559, 2561, 2562, 2564, 2569, 2570, 2574, 2579, 2580, 2586, 2591, 2592, 2593, 2595, 2596, 2597, 2599, 2603, 2604, 2606, 2607, 2608, 2614, 2615, 2622, 2623, 2624, 2625, 2627, 2628, 2629, 2633, 2635, 2636, 2637, 2640, 2643, 2648, 2650, 2652, 2653, 2656, 2660, 2662, 2666, 2667, 2672, 2673, 2677, 2679, 2680, 2681, 2703, 2704, 2705, 2707, 2708, 2710, 2712, 2713, 2717, 2718, 2720, 2724, 2725, 2727, 2732, 2733, 2734, 2735, 2736, 2738, 2739, 2740, 2745, 2746, 2747, 2748, 2753, 2754, 2755, 2756, 2757, 2758, 2759, 2760, 2763, 2765, 2768, 2770, 2771, 2772, 2773, 2774, 2777, 2779, 2782, 2783, 2784, 2787, 2789, 2790, 2792, 2793, 2794, 2795, 2800, 2802, 2804, 2808, 2811, 2813, 2817, 2819, 2820, 2821, 2830, 2831, 2832, 2833, 2835, 2836, 2837, 2838, 2841, 2842, 2843, 2845, 2846, 2847, 2850, 2851, 2855, 2856, 2857, 2858, 2859, 2860, 2861, 2862, 2863, 2865, 2866, 2867, 2868, 2869, 2870, 2872, 2873, 2877, 2878, 2883, 2887, 2888, 2891, 2897, 2898, 2899, 2900, 2901, 2904, 2908, 2909, 2910, 2911, 2912, 2914, 2916, 2917, 2918, 2921, 2923, 2924, 2926, 2930, 2931, 2932, 2934, 2938, 2941, 2942, 2943, 2944, 2945, 2946, 2947, 2949, 2950, 2952, 2953, 2959, 2962, 2963, 2965, 2967, 2969, 2970, 2971, 2974, 2975, 2976, 2977, 2979, 2980, 2982, 2983, 2984, 2985, 2986, 2987, 2989, 2991, 2992, 2993, 2995, 2997, 2998, 2999, 3001, 3004, 3005, 3006, 3008, 3010, 3012, 3015, 3016, 3018, 3020, 3022, 3023, 3024, 3025, 3026, 3027, 3028, 3029, 3030, 3031, 3034, 3036, 3038, 3039, 3040, 3042, 3043, 3046, 3047, 3048, 3049, 3050, 3052, 3053, 3057, 3058, 3059, 3060, 3061, 3062, 3063, 3066, 3067, 3070, 3071, 3072, 3073, 3075, 3076, 3077, 3079, 3080, 3081, 3082, 3084, 3086, 3087, 3088, 3089, 3091, 3093, 3094, 3097, 3098, 3100, 3101, 3103, 3104, 3107, 3108, 3109, 3111, 3112, 3113, 3114, 3115, 3116, 3119, 3121, 3122, 3123, 3124, 3125, 3126, 3128, 3131, 3132, 3134, 3135, 3136, 3137, 3142, 3144, 3146, 3147, 3151, 3152, 3155, 3156, 3157, 3159, 3160, 3163, 3164, 3165, 3166, 3170, 3171, 3172, 3174, 3175, 3176, 3178, 3179, 3180, 3181, 3182, 3184, 3187, 3188, 3192, 3195, 3196, 3197, 3198, 3199, 3200, 3202, 3205, 3206, 3210, 3212, 3213, 3215, 3216, 3217, 3218, 3219, 3224, 3226, 3227, 3228, 3231, 3232, 3234, 3236, 3240, 3241, 3242, 3243, 3244, 3247, 3248, 3249, 3252, 3253, 3254, 3255, 3256, 3260, 3262, 3263, 3265, 3269, 3271, 3273, 3276, 3277, 3279, 3283, 3284, 3285, 3287, 3288, 3289, 3291, 3292, 3293, 3294, 3295, 3296, 3298, 3300, 3302, 3304, 3305, 3306, 3307, 3318, 3319, 3320, 3323, 3325, 3326, 3328, 3330, 3331, 3335, 3338, 3341, 3343, 3345, 3346, 3349, 3350, 3351, 3355, 3357, 3358, 3359, 3363, 3364, 3366, 3368, 3369, 3370, 3371, 3372, 3373, 3375, 3377, 3378, 3380, 3381, 3382, 3383, 3387, 3390, 3391, 3393, 3394, 3396, 3397, 3398, 3399, 3400, 3402, 3403, 3404, 3405, 3406, 3407, 3410, 3411, 3413, 3414, 3416, 3417, 3418, 3422, 3423, 3426, 3428, 3429, 3435, 3437, 3438, 3439, 3440, 3442, 3444, 3446, 3447, 3449, 3452, 3453, 3454, 3456, 3459, 3460, 3462, 3463, 3465, 3466, 3467, 3468, 3469, 3470, 3471, 3474, 3476, 3480, 3481, 3482, 3483, 3485, 3487, 3490, 3493, 3494, 3495, 3497, 3498, 3499, 3502, 3503, 3504, 3505, 3506, 3507, 3509, 3514, 3515, 3516, 3520, 3522, 3523, 3525, 3526, 3527, 3529, 3531, 3532, 3536, 3538, 3541, 3542, 3544, 3546, 3547, 3548, 3549, 3550, 3551, 3552, 3553, 3556, 3557, 3563, 3564, 3565, 3566, 3568, 3569, 3576, 3577, 3578, 3580, 3581, 3582, 3583, 3584, 3586, 3589, 3591, 3592, 3593, 3594, 3595, 3596, 3598, 3599, 3600, 3601, 3602, 3604, 3605, 3608, 3610, 3611, 3612, 3613, 3614, 3615, 3620, 3621, 3622, 3625, 3627, 3629, 3632, 3633, 3635, 3640, 3642, 3644, 3645, 3646, 3650, 3651, 3652, 3653, 3658, 3660, 3664, 3665, 3667, 3669, 3672, 3674, 3676, 3677, 3680, 3681, 3682, 3683, 3684, 3686, 3688, 3689, 3692, 3694, 3696, 3697, 3699, 3707, 3708, 3710, 3711, 3712, 3713, 3716, 3717, 3718, 3721, 3722, 3728, 3729, 3731, 3733, 3735, 3737, 3740, 3743, 3744, 3749, 3751, 3752, 3753, 3754, 3757, 3758, 3759, 3760, 3762, 3765, 3767, 3768, 3770, 3773, 3775, 3776, 3778, 3779, 3782, 3783, 3785, 3787, 3788, 3791, 3792, 3793, 3795, 3796, 3798, 3800, 3802, 3803, 3805, 3806, 3807, 3808, 3809, 3810, 3811, 3812, 3814, 3815, 3817, 3822, 3826, 3828, 3834, 3835, 3836, 3839, 3840, 3841, 3845, 3846, 3847, 3848, 3849, 3850, 3851, 3852, 3853, 3854, 3855, 3859, 3860, 3861, 3862, 3863, 3864, 3866, 3867, 3869, 3871, 3872, 3874, 3877, 3878, 3879, 3880, 3884, 3886, 3887, 3888, 3889, 3890, 3891, 3892, 3893, 3898, 3900, 3901, 3902, 3904, 3905, 3906, 3908, 3912, 3913, 3915, 3917, 3918, 3919, 3921, 3922, 3924, 3926, 3928, 3929, 3930, 3932, 3933, 3934, 3937, 3941, 3943, 3944, 3945, 3946, 3949, 3951, 3952, 3954, 3955, 3956, 3959, 3963, 3964, 3966, 3972, 3974, 3979, 3980, 3981, 3982, 3983, 3984, 3987, 3988, 3989, 3992, 3993, 3995, 3999, 4001, 4003, 4010, 4011, 4012, 4013, 4014, 4016, 4017, 4018, 4020, 4021, 4022, 4023, 4024, 4025, 4028, 4032, 4033, 4037, 4038, 4039, 4040, 4041, 4042, 4043, 4044, 4045, 4053, 4056, 4057, 4058, 4059, 4060, 4067, 4068, 4069, 4070, 4071, 4072, 4073, 4074, 4075, 4077, 4078, 4081, 4083, 4084, 4085, 4086, 4088, 4090, 4091, 4092, 4093, 4094, 4095, 4097, 4098, 4099, 4104, 4106, 4107, 4108, 4109, 4111, 4112, 4113, 4114, 4115, 4118, 4120, 4121, 4124, 4127, 4128, 4129, 4130, 4132, 4133, 4134, 4135, 4136, 4137, 4139, 4142, 4144, 4145, 4147, 4148, 4149, 4150, 4151, 4152, 4153, 4156, 4157, 4160, 4164, 4165, 4168, 4170, 4171, 4172, 4173, 4174, 4175, 4176, 4177, 4178, 4179, 4181, 4182, 4185, 4186, 4187, 4189, 4190, 4192, 4193, 4195, 4198, 4201, 4202, 4203, 4204, 4205, 4207, 4209, 4210, 4211, 4213, 4217, 4218, 4219, 4221, 4222, 4225, 4227, 4229, 4230, 4231, 4232, 4234, 4235, 4237, 4239, 4240, 4243, 4245, 4247, 4248, 4251, 4252, 4254, 4255, 4257, 4259, 4260, 4261, 4264, 4265, 4266, 4267, 4269, 4271, 4272, 4276, 4281, 4283, 4284, 4287, 4288, 4292, 4294, 4295, 4298, 4300, 4301, 4302, 4303, 4305, 4306, 4307, 4310, 4311, 4312, 4313, 4322, 4323, 4326, 4328, 4329, 4332, 4334, 4337, 4339, 4340, 4341, 4343, 4344, 4346, 4347, 4348, 4350, 4351, 4353, 4354, 4356, 4357, 4359, 4361, 4362, 4365, 4366, 4367, 4369, 4373, 4374, 4376, 4378, 4380, 4383, 4384, 4385, 4387, 4389, 4390, 4391, 4393, 4394, 4395, 4396, 4397, 4400, 4402, 4403, 4404, 4405, 4406, 4408, 4410, 4412, 4414, 4415, 4416, 4418, 4419, 4421, 4423, 4424, 4428, 4434, 4437, 4439, 4442, 4443, 4444, 4446, 4448, 4449, 4450, 4451, 4452, 4453, 4455, 4456, 4457, 4458, 4459, 4465, 4466, 4467, 4473, 4474, 4477, 4504, 4505, 4506, 4507, 4511, 4512, 4513, 4514, 4515, 4516, 4517, 4519, 4520, 4521, 4522, 4523, 4525, 4526, 4528, 4545, 4555, 4556, 4557, 4558, 4559, 4560, 4561, 4562, 4566, 4567, 4568, 4569, 4570, 4575, 4577, 4579, 4581, 4583, 4584, 4588, 4593, 4595, 4598, 4599, 4600, 4601, 4604, 4605, 4611, 4612, 4615, 4622, 4623, 4624, 4625, 4628, 4630, 4635, 4636, 4637, 4639, 4640, 4641, 4642, 4645, 4646, 4647, 4648, 4651, 4652, 4654, 4657, 4658, 4659, 4660, 4661, 4663, 4664, 4666, 4668, 4670, 4671, 4672, 4674, 4675, 4676, 4678, 4679, 4680, 4681, 4685, 4686, 4687, 4688, 4689, 4690, 4691, 4693, 4695, 4696, 4697, 4698, 4699, 4700, 4701, 4703, 4704, 4705, 4706, 4707, 4708, 4709, 4710, 4711, 4712, 4713, 4715, 4716, 4717, 4718, 4719, 4720, 4722, 4724, 4727, 4728, 4729, 4730, 4731, 4736, 4739, 4740, 4742, 4743, 4744, 4745, 4746, 4747, 4748, 4749, 4750, 4751, 4752, 4753, 4755, 4757, 4761, 4762, 4764, 4765, 4767, 4773, 4774, 4777, 4779, 4781, 4784, 4785, 4788, 4790, 4791, 4792, 4793, 4794, 4795, 4796, 4797, 4798, 4799, 4800, 4802, 4805, 4807, 4808, 4809, 4810, 4811, 4814, 4815, 4821, 4823, 4827, 4828, 4829, 4832, 4833, 4834, 4835, 4836, 4837, 4842, 4844, 4845, 4846, 4848, 4849, 4850, 4851, 4854, 4855, 4856, 4857, 4859, 4860, 4862, 4863, 4868, 4869, 4871, 4872, 4873, 4874, 4876, 4877, 4879, 4880, 4882, 4885, 4888, 4889, 4891, 4892, 4893, 4894, 4898, 4901, 4903, 4904, 4905, 4906, 4907, 4908, 4909, 4910, 4911, 4912, 4914, 4915, 4919, 4920, 4921, 4923, 4926, 4927, 4929, 4930, 4937, 4940, 4942, 4948, 4949, 4954, 4955, 4958, 4959, 4962, 4963, 4964, 4968, 4969, 4970, 4971, 4972, 4973, 4974, 4975, 4980, 4981, 4982, 4983, 4984, 4987, 4995, 4998, 5002, 5003, 5004, 5005, 5006, 5007, 5009, 5011, 5041, 5063, 5066, 5067, 5068, 5070, 5072, 5075, 5076, 5077, 5080, 5081, 5082, 5083, 5085, 5086, 5087, 5115, 5124, 5125, 5126, 5127, 5128, 5129, 5130, 5132, 5133, 5134, 5135, 5136, 5137, 5140, 5141, 5142, 5143, 5145, 5147, 5149, 5150, 5155, 5157, 5158, 5160, 5161, 5162, 5163, 5164, 5166, 5167, 5169, 5170, 5171, 5174, 5176, 5178, 5182, 5183, 5185, 5187, 5190, 5191, 5194, 5195, 5196, 5197, 5198, 5199, 5201, 5202, 5203, 5205, 5214, 5215, 5257, 5258, 5259, 5260, 5262, 5263, 5264, 5265, 5267, 5268, 5269, 5270, 5273, 5274, 5275, 5278, 5279, 5281, 5283, 5284, 5287, 5288, 5291, 5292, 5296, 5297, 5300, 5301, 5302, 5303, 5304, 5305, 5307, 5308, 5312, 5314, 5315, 5316, 5319, 5320, 5321, 5323, 5327, 5328, 5329, 5330, 5333, 5334, 5336, 5337, 5339, 5340, 5342, 5343, 5344, 5345, 5346, 5347, 5353, 5354, 5357, 5361, 5362, 5364, 5365, 5368, 5369, 5370, 5371, 5372, 5373, 5383, 5402, 5403, 5404, 5406, 5407, 5408, 5409, 5411, 5412, 5413, 5414, 5416, 5418, 5419, 5420, 5422, 5423, 5425, 5426, 5427, 5428, 5429, 5430, 5437, 5438, 5440, 5441, 5442, 5444, 5445, 5446, 5447, 5448, 5449, 5450, 5452, 5453, 5454, 5457, 5458, 5459, 5460, 5461, 5462, 5463, 5464, 5466, 5468, 5469, 5471, 5474, 5477, 5480, 5481, 5482, 5483, 5484, 5485, 5486, 5487, 5489, 5490, 5491, 5493, 5496, 5501, 5502, 5504, 5539, 5540, 5541, 5543, 5544, 5545, 5548, 5549, 5551, 5557, 5558, 5561, 5562, 5571, 5573, 5575, 5576, 5577, 5579, 5581, 5582, 5583, 5584, 5585, 5587, 5589, 5590, 5591, 5592, 5593, 5594, 5595, 5598, 5600, 5601, 5602, 5603, 5606, 5607, 5608, 5609, 5610, 5614, 5615, 5617, 5618, 5622, 5628, 5630, 5631, 5637, 5639, 5640, 5642, 5645, 5647, 5648, 5650, 5651, 5652, 5653, 5654, 5655, 5656, 5671, 5683, 5686, 5689, 5690, 5691, 5692, 5693, 5694, 5696, 5698, 5700, 5703, 5705, 5707, 5709, 5712, 5714, 5716, 5720, 5721, 5722, 5723, 5724, 5726, 5728, 5729, 5730, 5736, 5737, 5739, 5741, 5742, 5743, 5744, 5745, 5746, 5747, 5748, 5749, 5751, 5752, 5754, 5755, 5756, 5758, 5759, 5761, 5762, 5763, 5766, 5768, 5772, 5773, 5774, 5776, 5778, 5779, 5781, 5784, 5785, 5786, 5788, 5789, 5791, 5792, 5793, 5794, 5795, 5796, 5797, 5798, 5802, 5803, 5808, 5809, 5811, 5813, 5814, 5815, 5816, 5817, 5819, 5823, 5828, 5830, 5832, 5834, 5837, 5838, 5844, 5848, 5849, 5851, 5853, 5854, 5855, 5860, 5861, 5862, 5864, 5865, 5866, 5868, 5874, 5881, 5882, 5886, 5887, 5888, 5897, 5898, 5899, 5900, 5902, 5903, 5905, 5907, 5909, 5910, 5912, 5913, 5915, 5916, 5918, 5920, 5921, 5922, 5925, 5927, 5928, 5932, 5933, 5935, 5936, 5939, 5940, 5942, 5943, 5944, 5945, 5947, 5967, 6013, 6021, 6023, 6025, 6027, 6028, 6029, 6032, 6034, 6039, 6040, 6042, 6043, 6044, 6045, 6046, 6049, 6051, 6052, 6053, 6055, 6058, 6064, 6066, 6069, 6071, 6072, 6073, 6078, 6079, 6081, 6083, 6084, 6086, 6088, 6089, 6091, 6093, 6094, 6096, 6097, 6099, 6100, 6103, 6105, 6106, 6107, 6108, 6109, 6112, 6113, 6115, 6117, 6122, 6123, 6127, 6130, 6133, 6134, 6158, 6172, 6173, 6174, 6180, 6181, 6182, 6183, 6184, 6186, 6187, 6190, 6191, 6192, 6193, 6195, 6197, 6198, 6201, 6202, 6223, 6224, 6234, 6235, 6236, 6237, 6238, 6239, 6240, 6241, 6242, 6243, 6244, 6246, 6247, 6313, 6315, 6320, 6321, 6322, 6324, 6326, 6327, 6329, 6330, 6331, 6332, 6333, 6369, 6370, 6371, 6372, 6375, 6376, 6377, 6386, 6388, 6393, 6394, 6485, 6553, 6557, 6559, 6560, 6561, 6566, 6571, 6572, 6577, 6578, 6579, 6581, 6582, 6583, 6585, 6586, 6587, 6589, 6590, 6593, 6598, 6602, 6604, 6605, 6609, 6611, 6613, 6614, 6618, 6619, 6621, 6622, 6626, 6627, 6632, 6635, 6637, 6647, 6654, 6707, 6708, 6710, 6713, 6714, 6715, 6717, 6718, 6719, 6724, 6725, 6728, 6733, 6738, 6739, 6740, 6741, 6742, 6743, 6745, 6748, 6750, 6751, 6753, 6755, 6756, 6759, 6760, 6764, 6765, 6766, 6767, 6769, 6770, 6773, 6775, 6776, 6777, 6778, 6779, 6780, 6781, 6783, 6784, 6785, 6788, 6789, 6790, 6791}",2675
8,"(('exit', ('Request For Payment SUBMITTED by EMPLOYEE', 'Request For Payment APPROVED by ADMINISTRATION')), ('enter', ('Request For Payment APPROVED by ADMINISTRATION', 'Request For Payment FINAL_APPROVED by SUPERVISOR')))",2,19,"{989, 1078, 1085, 1088, 1089, 1090, 1092, 1093, 1094, 1095, 1096, 1097, 1098, 1099, 1100, 1101, 1103, 1104, 1105, 1106, 1107, 1108, 1109, 1112, 1114, 1115, 1116, 1117, 1118, 1120, 1121, 1122, 1123, 1124, 1125, 1126, 1127, 1128, 1129, 1130, 1131, 1134, 1135, 1136, 1137, 1138, 1140, 1142, 1145, 1147, 1148, 1149, 1150, 1151, 1152, 1153, 1155, 1156, 1158, 1160, 1161, 1162, 1163, 1165, 1167, 1169, 1170, 1171, 1172, 1176, 1177, 1179, 1180, 1181, 1182, 1183, 1184, 1185, 1186, 1187, 1188, 1190, 1196, 1197, 1198, 1199, 1200, 1201, 1203, 1204, 1205, 1207, 1208, 1209, 1210, 1213, 1214, 1215, 1216, 1218, 1219, 1221, 1222, 1223, 1225, 1228, 1229, 1230, 1231, 1233, 1234, 1237, 1238, 1239, 1240, 1241, 1242, 1244, 1246, 1247, 1250, 1254, 1255, 1263, 1265, 1268, 1272, 1273, 1274, 1275, 1276, 1277, 1280, 1281, 1282, 1284, 1285, 1287, 1290, 1291, 1294, 1300, 1301, 1302, 1304, 1305, 1307, 1308, 1309, 1310, 1311, 1313, 1314, 1315, 1318, 1320, 1321, 1323, 1324, 1325, 1327, 1328, 1329, 1330, 1331, 1332, 1334, 1335, 1336, 1338, 1342, 1345, 1346, 1347, 1349, 1353, 1357, 1360, 1365, 1367, 1368, 1369, 1370, 1373, 1374, 1377, 1378, 1379, 1380, 1382, 1385, 1386, 1387, 1388, 1389, 1390, 1391, 1392, 1393, 1395, 1396, 1397, 1400, 1401, 1402, 1404, 1405, 1406, 1409, 1410, 1413, 1414, 1415, 1420, 1421, 1423, 1424, 1429, 1430, 1431, 1432, 1434, 1435, 1439, 1440, 1441, 1442, 1443, 1446, 1448, 1450, 1452, 1453, 1454, 1455, 1456, 1457, 1458, 1459, 1460, 1461, 1462, 1464, 1467, 1468, 1469, 1470, 1471, 1472, 1473, 1476, 1477, 1478, 1483, 1484, 1485, 1487, 1489, 1491, 1493, 1495, 1496, 1499, 1501, 1502, 1503, 1504, 1505, 1507, 1508, 1509, 1510, 1511, 1512, 1513, 1514, 1515, 1516, 1518, 1520, 1521, 1522, 1523, 1524, 1526, 1528, 1530, 1531, 1532, 1533, 1536, 1538, 1540, 1542, 1543, 1544, 1545, 1546, 1549, 1551, 1552, 1553, 1554, 1556, 1558, 1560, 1562, 1563, 1565, 1566, 1567, 1568, 1569, 1573, 1574, 1578, 1579, 1580, 1581, 1582, 1583, 1584, 1587, 1588, 1589, 1591, 1592, 1593, 1594, 1595, 1596, 1597, 1598, 1601, 1602, 1604, 1605, 1606, 1607, 1610, 1612, 1614, 1619, 1620, 1621, 1622, 1624, 1625, 1627, 1628, 1629, 1630, 1633, 1637, 1639, 1640, 1642, 1643, 1644, 1645, 1646, 1647, 1648, 1655, 1658, 1661, 1662, 1663, 1665, 1666, 1667, 1669, 1670, 1671, 1674, 1678, 1681, 1682, 1683, 1687, 1691, 1693, 1694, 1699, 1700, 1701, 1702, 1704, 1706, 1707, 1708, 1709, 1710, 1712, 1713, 1714, 1715, 1716, 1717, 1718, 1726, 1727, 1728, 1730, 1731, 1732, 1736, 1737, 1739, 1743, 1744, 1745, 1746, 1748, 1752, 1753, 1754, 1756, 1757, 1758, 1760, 1761, 1764, 1769, 1771, 1772, 1773, 1774, 1775, 1776, 1778, 1779, 1780, 1786, 1790, 1796, 1799, 1801, 1802, 1803, 1804, 1805, 1808, 1810, 1811, 1812, 1814, 1817, 1818, 1819, 1821, 1822, 1825, 1827, 1828, 1829, 1830, 1831, 1834, 1835, 1836, 1837, 1840, 1841, 1842, 1843, 1847, 1848, 1849, 1850, 1859, 1863, 1865, 1867, 1869, 1870, 1871, 1874, 1875, 1878, 1880, 1881, 1883, 1885, 1886, 1888, 1892, 1893, 1895, 1896, 1897, 1898, 1900, 1901, 1902, 1903, 1905, 1907, 1909, 1910, 1911, 1912, 1915, 1918, 1919, 1920, 1921, 1922, 1923, 1924, 1928, 1929, 1931, 1934, 1937, 1940, 1941, 1944, 1945, 1946, 1947, 1948, 1951, 1955, 1956, 1957, 1958, 1960, 1962, 1964, 1965, 1967, 1968, 1969, 1971, 1972, 1976, 1978, 1979, 1981, 1983, 1986, 1987, 1992, 1993, 1994, 1996, 1997, 1999, 2000, 2001, 2002, 2004, 2005, 2006, 2007, 2010, 2011, 2017, 2019, 2020, 2023, 2024, 2025, 2026, 2031, 2032, 2033, 2034, 2039, 2040, 2041, 2043, 2044, 2047, 2049, 2050, 2051, 2052, 2053, 2056, 2063, 2064, 2065, 2071, 2073, 2074, 2075, 2077, 2079, 2080, 2082, 2083, 2084, 2085, 2087, 2091, 2094, 2100, 2103, 2109, 2111, 2113, 2114, 2115, 2116, 2117, 2119, 2121, 2122, 2124, 2125, 2126, 2128, 2129, 2130, 2131, 2133, 2134, 2135, 2137, 2138, 2141, 2143, 2144, 2148, 2150, 2151, 2154, 2155, 2157, 2158, 2159, 2164, 2166, 2167, 2168, 2169, 2172, 2173, 2174, 2175, 2176, 2177, 2178, 2180, 2181, 2182, 2183, 2186, 2188, 2189, 2191, 2194, 2195, 2196, 2197, 2200, 2201, 2202, 2203, 2204, 2205, 2209, 2210, 2211, 2213, 2214, 2216, 2218, 2219, 2222, 2223, 2226, 2230, 2232, 2234, 2235, 2237, 2239, 2241, 2242, 2244, 2246, 2247, 2248, 2251, 2252, 2253, 2254, 2255, 2259, 2260, 2261, 2262, 2263, 2264, 2265, 2268, 2269, 2272, 2277, 2280, 2284, 2285, 2287, 2288, 2289, 2291, 2292, 2293, 2294, 2295, 2296, 2297, 2299, 2302, 2303, 2304, 2305, 2306, 2310, 2313, 2315, 2320, 2321, 2324, 2327, 2328, 2329, 2331, 2336, 2337, 2338, 2341, 2342, 2345, 2346, 2348, 2349, 2350, 2351, 2352, 2353, 2354, 2357, 2358, 2359, 2360, 2363, 2364, 2365, 2366, 2370, 2373, 2374, 2375, 2377, 2380, 2383, 2385, 2386, 2387, 2388, 2389, 2390, 2391, 2392, 2393, 2396, 2397, 2398, 2401, 2403, 2404, 2405, 2407, 2408, 2409, 2410, 2411, 2412, 2416, 2420, 2421, 2422, 2423, 2425, 2426, 2427, 2428, 2429, 2430, 2437, 2440, 2443, 2448, 2450, 2452, 2453, 2454, 2455, 2459, 2460, 2466, 2470, 2471, 2472, 2473, 2475, 2476, 2477, 2478, 2480, 2481, 2482, 2484, 2485, 2486, 2487, 2488, 2489, 2490, 2491, 2492, 2494, 2495, 2496, 2497, 2501, 2503, 2504, 2508, 2510, 2511, 2515, 2516, 2517, 2518, 2519, 2520, 2522, 2523, 2524, 2525, 2526, 2527, 2528, 2529, 2530, 2531, 2535, 2540, 2543, 2544, 2551, 2552, 2553, 2554, 2557, 2559, 2561, 2562, 2564, 2569, 2570, 2574, 2579, 2580, 2584, 2586, 2591, 2592, 2593, 2595, 2596, 2597, 2599, 2603, 2604, 2606, 2607, 2608, 2614, 2615, 2616, 2620, 2622, 2623, 2624, 2625, 2627, 2628, 2629, 2633, 2635, 2636, 2637, 2640, 2643, 2648, 2650, 2652, 2653, 2656, 2660, 2662, 2666, 2667, 2669, 2672, 2673, 2677, 2679, 2680, 2681, 2683, 2685, 2686, 2687, 2688, 2690, 2692, 2693, 2694, 2696, 2697, 2698, 2699, 2700, 2701, 2703, 2704, 2705, 2707, 2708, 2710, 2712, 2713, 2717, 2718, 2720, 2724, 2725, 2727, 2732, 2733, 2734, 2735, 2736, 2738, 2739, 2740, 2745, 2746, 2747, 2748, 2753, 2754, 2755, 2756, 2757, 2758, 2759, 2760, 2763, 2765, 2768, 2770, 2771, 2772, 2773, 2774, 2777, 2779, 2782, 2783, 2784, 2787, 2789, 2790, 2792, 2793, 2794, 2795, 2800, 2802, 2804, 2808, 2811, 2813, 2817, 2819, 2820, 2821, 2828, 2830, 2831, 2832, 2833, 2835, 2836, 2837, 2838, 2841, 2842, 2843, 2845, 2846, 2847, 2850, 2851, 2855, 2856, 2857, 2858, 2859, 2860, 2861, 2862, 2863, 2865, 2866, 2867, 2868, 2869, 2870, 2872, 2873, 2877, 2878, 2883, 2887, 2888, 2891, 2897, 2898, 2899, 2900, 2901, 2904, 2908, 2909, 2910, 2911, 2912, 2914, 2916, 2917, 2918, 2921, 2923, 2924, 2926, 2930, 2931, 2932, 2934, 2938, 2941, 2942, 2943, 2944, 2945, 2946, 2947, 2949, 2950, 2952, 2953, 2959, 2962, 2963, 2965, 2967, 2969, 2970, 2971, 2974, 2975, 2976, 2977, 2979, 2980, 2982, 2983, 2984, 2985, 2986, 2987, 2989, 2991, 2992, 2993, 2995, 2997, 2998, 2999, 3001, 3004, 3005, 3006, 3008, 3010, 3012, 3015, 3016, 3018, 3020, 3022, 3023, 3024, 3025, 3026, 3027, 3028, 3029, 3030, 3031, 3034, 3036, 3038, 3039, 3040, 3042, 3043, 3046, 3047, 3048, 3049, 3050, 3052, 3053, 3057, 3058, 3059, 3060, 3061, 3062, 3063, 3066, 3067, 3070, 3071, 3072, 3073, 3075, 3076, 3077, 3079, 3080, 3081, 3082, 3084, 3086, 3087, 3088, 3089, 3091, 3093, 3094, 3097, 3098, 3100, 3101, 3103, 3104, 3107, 3108, 3109, 3111, 3112, 3113, 3114, 3115, 3116, 3119, 3121, 3122, 3123, 3124, 3125, 3126, 3128, 3131, 3132, 3134, 3135, 3136, 3137, 3142, 3144, 3146, 3147, 3151, 3152, 3155, 3156, 3157, 3159, 3160, 3163, 3164, 3165, 3166, 3170, 3171, 3172, 3174, 3175, 3176, 3178, 3179, 3180, 3181, 3182, 3184, 3187, 3188, 3192, 3195, 3196, 3197, 3198, 3199, 3200, 3202, 3205, 3206, 3210, 3212, 3213, 3215, 3216, 3217, 3218, 3219, 3224, 3226, 3227, 3228, 3231, 3232, 3234, 3236, 3240, 3241, 3242, 3243, 3244, 3247, 3248, 3249, 3252, 3253, 3254, 3255, 3256, 3260, 3262, 3263, 3265, 3269, 3271, 3273, 3276, 3277, 3279, 3283, 3284, 3285, 3287, 3288, 3289, 3291, 3292, 3293, 3294, 3295, 3296, 3298, 3300, 3302, 3304, 3305, 3306, 3307, 3318, 3319, 3320, 3323, 3325, 3326, 3328, 3330, 3331, 3335, 3338, 3341, 3343, 3345, 3346, 3349, 3350, 3351, 3355, 3357, 3358, 3359, 3363, 3364, 3366, 3368, 3369, 3370, 3371, 3372, 3373, 3375, 3377, 3378, 3380, 3381, 3382, 3383, 3387, 3390, 3391, 3393, 3394, 3396, 3397, 3398, 3399, 3400, 3402, 3403, 3404, 3405, 3406, 3407, 3410, 3411, 3413, 3414, 3416, 3417, 3418, 3422, 3423, 3426, 3428, 3429, 3435, 3437, 3438, 3439, 3440, 3442, 3444, 3446, 3447, 3449, 3452, 3453, 3454, 3456, 3459, 3460, 3462, 3463, 3465, 3466, 3467, 3468, 3469, 3470, 3471, 3474, 3476, 3480, 3481, 3482, 3483, 3485, 3487, 3490, 3493, 3494, 3495, 3497, 3498, 3499, 3502, 3503, 3504, 3505, 3506, 3507, 3509, 3514, 3515, 3516, 3520, 3522, 3523, 3525, 3526, 3527, 3529, 3531, 3532, 3536, 3538, 3541, 3542, 3544, 3546, 3547, 3548, 3549, 3550, 3551, 3552, 3553, 3556, 3557, 3563, 3564, 3565, 3566, 3568, 3569, 3576, 3577, 3578, 3580, 3581, 3582, 3583, 3584, 3586, 3589, 3591, 3592, 3593, 3594, 3595, 3596, 3598, 3599, 3600, 3601, 3602, 3604, 3605, 3608, 3610, 3611, 3612, 3613, 3614, 3615, 3620, 3621, 3622, 3625, 3627, 3629, 3632, 3633, 3635, 3640, 3642, 3644, 3645, 3646, 3650, 3651, 3652, 3653, 3658, 3660, 3664, 3665, 3667, 3669, 3672, 3674, 3676, 3677, 3680, 3681, 3682, 3683, 3684, 3686, 3688, 3689, 3692, 3694, 3696, 3697, 3699, 3707, 3708, 3710, 3711, 3712, 3713, 3716, 3717, 3718, 3721, 3722, 3728, 3729, 3731, 3733, 3735, 3737, 3740, 3743, 3744, 3749, 3751, 3752, 3753, 3754, 3757, 3758, 3759, 3760, 3762, 3765, 3767, 3768, 3770, 3773, 3775, 3776, 3778, 3779, 3782, 3783, 3785, 3787, 3788, 3791, 3792, 3793, 3795, 3796, 3798, 3800, 3802, 3803, 3805, 3806, 3807, 3808, 3809, 3810, 3811, 3812, 3814, 3815, 3817, 3822, 3826, 3828, 3834, 3835, 3836, 3839, 3840, 3841, 3845, 3846, 3847, 3848, 3849, 3850, 3851, 3852, 3853, 3854, 3855, 3859, 3860, 3861, 3862, 3863, 3864, 3866, 3867, 3869, 3871, 3872, 3874, 3877, 3878, 3879, 3880, 3884, 3886, 3887, 3888, 3889, 3890, 3891, 3892, 3893, 3898, 3900, 3901, 3902, 3904, 3905, 3906, 3908, 3912, 3913, 3915, 3917, 3918, 3919, 3921, 3922, 3924, 3926, 3928, 3929, 3930, 3932, 3933, 3934, 3937, 3941, 3943, 3944, 3945, 3946, 3949, 3951, 3952, 3954, 3955, 3956, 3959, 3963, 3964, 3966, 3972, 3974, 3979, 3980, 3981, 3982, 3983, 3984, 3987, 3988, 3989, 3992, 3993, 3995, 3999, 4001, 4003, 4010, 4011, 4012, 4013, 4014, 4016, 4017, 4018, 4020, 4021, 4022, 4023, 4024, 4025, 4028, 4032, 4033, 4037, 4038, 4039, 4040, 4041, 4042, 4043, 4044, 4045, 4053, 4056, 4057, 4058, 4059, 4060, 4067, 4068, 4069, 4070, 4071, 4072, 4073, 4074, 4075, 4077, 4078, 4081, 4083, 4084, 4085, 4086, 4088, 4090, 4091, 4092, 4093, 4094, 4095, 4097, 4098, 4099, 4104, 4106, 4107, 4108, 4109, 4111, 4112, 4113, 4114, 4115, 4118, 4120, 4121, 4124, 4127, 4128, 4129, 4130, 4132, 4133, 4134, 4135, 4136, 4137, 4139, 4142, 4144, 4145, 4147, 4148, 4149, 4150, 4151, 4152, 4153, 4156, 4157, 4160, 4164, 4165, 4168, 4170, 4171, 4172, 4173, 4174, 4175, 4176, 4177, 4178, 4179, 4181, 4182, 4185, 4186, 4187, 4189, 4190, 4192, 4193, 4195, 4198, 4201, 4202, 4203, 4204, 4205, 4207, 4209, 4210, 4211, 4213, 4217, 4218, 4219, 4221, 4222, 4225, 4227, 4229, 4230, 4231, 4232, 4234, 4235, 4237, 4239, 4240, 4243, 4245, 4247, 4248, 4251, 4252, 4254, 4255, 4257, 4259, 4260, 4261, 4264, 4265, 4266, 4267, 4269, 4271, 4272, 4276, 4281, 4283, 4284, 4287, 4288, 4292, 4294, 4295, 4298, 4300, 4301, 4302, 4303, 4305, 4306, 4307, 4310, 4311, 4312, 4313, 4322, 4323, 4326, 4328, 4329, 4332, 4334, 4337, 4339, 4340, 4341, 4343, 4344, 4346, 4347, 4348, 4350, 4351, 4353, 4354, 4356, 4357, 4359, 4361, 4362, 4365, 4366, 4367, 4369, 4373, 4374, 4376, 4378, 4380, 4383, 4384, 4385, 4387, 4389, 4390, 4391, 4393, 4394, 4395, 4396, 4397, 4400, 4402, 4403, 4404, 4405, 4406, 4408, 4410, 4412, 4414, 4415, 4416, 4418, 4419, 4421, 4423, 4424, 4428, 4429, 4434, 4436, 4437, 4439, 4442, 4443, 4444, 4446, 4448, 4449, 4450, 4451, 4452, 4453, 4455, 4456, 4457, 4458, 4459, 4465, 4466, 4467, 4473, 4474, 4477, 4479, 4480, 4481, 4482, 4483, 4484, 4485, 4486, 4487, 4488, 4489, 4490, 4491, 4495, 4496, 4498, 4499, 4500, 4501, 4502, 4503, 4504, 4505, 4506, 4507, 4511, 4512, 4513, 4514, 4515, 4516, 4517, 4519, 4520, 4521, 4522, 4523, 4525, 4526, 4528, 4529, 4530, 4531, 4532, 4533, 4534, 4535, 4537, 4538, 4539, 4541, 4542, 4545, 4546, 4547, 4548, 4549, 4551, 4552, 4555, 4556, 4557, 4558, 4559, 4560, 4561, 4562, 4566, 4567, 4568, 4569, 4570, 4575, 4577, 4579, 4581, 4583, 4584, 4588, 4593, 4595, 4598, 4599, 4600, 4601, 4604, 4605, 4611, 4612, 4615, 4622, 4623, 4624, 4625, 4628, 4630, 4635, 4636, 4637, 4639, 4640, 4641, 4642, 4645, 4646, 4647, 4648, 4651, 4652, 4654, 4657, 4658, 4659, 4660, 4661, 4663, 4664, 4666, 4668, 4670, 4671, 4672, 4674, 4675, 4676, 4678, 4679, 4680, 4681, 4685, 4686, 4687, 4688, 4689, 4690, 4691, 4693, 4695, 4696, 4697, 4698, 4699, 4700, 4701, 4703, 4704, 4705, 4706, 4707, 4708, 4709, 4710, 4711, 4712, 4713, 4715, 4716, 4717, 4718, 4719, 4720, 4722, 4724, 4727, 4728, 4729, 4730, 4731, 4736, 4739, 4740, 4742, 4743, 4744, 4745, 4746, 4747, 4748, 4749, 4750, 4751, 4752, 4753, 4755, 4757, 4761, 4762, 4764, 4765, 4767, 4773, 4774, 4777, 4779, 4781, 4784, 4785, 4788, 4790, 4791, 4792, 4793, 4794, 4795, 4796, 4797, 4798, 4799, 4800, 4802, 4805, 4807, 4808, 4809, 4810, 4811, 4814, 4815, 4821, 4823, 4827, 4828, 4829, 4832, 4833, 4834, 4835, 4836, 4837, 4842, 4843, 4844, 4845, 4846, 4848, 4849, 4850, 4851, 4854, 4855, 4856, 4857, 4859, 4860, 4861, 4862, 4863, 4868, 4869, 4871, 4872, 4873, 4874, 4876, 4877, 4879, 4880, 4882, 4885, 4888, 4889, 4891, 4892, 4893, 4894, 4898, 4901, 4903, 4904, 4905, 4906, 4907, 4908, 4909, 4910, 4911, 4912, 4914, 4915, 4919, 4920, 4921, 4923, 4926, 4927, 4929, 4930, 4931, 4935, 4937, 4940, 4942, 4948, 4949, 4950, 4951, 4954, 4955, 4958, 4959, 4962, 4963, 4964, 4968, 4969, 4970, 4971, 4972, 4973, 4974, 4975, 4980, 4981, 4982, 4983, 4984, 4987, 4995, 4998, 5000, 5002, 5003, 5004, 5005, 5006, 5007, 5009, 5011, 5012, 5014, 5015, 5017, 5018, 5019, 5020, 5021, 5023, 5024, 5025, 5027, 5029, 5032, 5033, 5036, 5037, 5038, 5039, 5040, 5041, 5042, 5043, 5044, 5045, 5047, 5051, 5052, 5055, 5056, 5057, 5058, 5059, 5060, 5063, 5066, 5067, 5068, 5070, 5072, 5075, 5076, 5077, 5080, 5081, 5082, 5083, 5084, 5085, 5086, 5087, 5090, 5091, 5092, 5093, 5095, 5096, 5097, 5105, 5107, 5108, 5109, 5110, 5114, 5115, 5117, 5118, 5119, 5120, 5121, 5122, 5123, 5124, 5125, 5126, 5127, 5128, 5129, 5130, 5132, 5133, 5134, 5135, 5136, 5137, 5140, 5141, 5142, 5143, 5145, 5147, 5149, 5150, 5155, 5157, 5158, 5160, 5161, 5162, 5163, 5164, 5166, 5167, 5169, 5170, 5171, 5174, 5176, 5178, 5182, 5183, 5185, 5187, 5190, 5191, 5194, 5195, 5196, 5197, 5198, 5199, 5201, 5202, 5203, 5205, 5209, 5210, 5211, 5212, 5214, 5215, 5217, 5220, 5221, 5224, 5225, 5226, 5229, 5230, 5231, 5232, 5236, 5237, 5238, 5239, 5242, 5243, 5246, 5248, 5253, 5257, 5258, 5259, 5260, 5262, 5263, 5264, 5265, 5267, 5268, 5269, 5270, 5273, 5274, 5275, 5278, 5279, 5281, 5283, 5284, 5287, 5288, 5291, 5292, 5296, 5297, 5300, 5301, 5302, 5303, 5304, 5305, 5307, 5308, 5312, 5314, 5315, 5316, 5319, 5320, 5321, 5323, 5327, 5328, 5329, 5330, 5333, 5334, 5336, 5337, 5339, 5340, 5342, 5343, 5344, 5345, 5346, 5347, 5353, 5354, 5357, 5361, 5362, 5364, 5365, 5368, 5369, 5370, 5371, 5372, 5373, 5375, 5376, 5377, 5378, 5379, 5380, 5383, 5384, 5385, 5387, 5388, 5389, 5390, 5391, 5392, 5394, 5397, 5399, 5402, 5403, 5404, 5406, 5407, 5408, 5409, 5411, 5412, 5413, 5414, 5416, 5418, 5419, 5420, 5422, 5423, 5425, 5426, 5427, 5428, 5429, 5430, 5437, 5438, 5440, 5441, 5442, 5443, 5444, 5445, 5446, 5447, 5448, 5449, 5450, 5452, 5453, 5454, 5457, 5458, 5459, 5460, 5461, 5462, 5463, 5464, 5466, 5468, 5469, 5471, 5474, 5476, 5477, 5480, 5481, 5482, 5483, 5484, 5485, 5486, 5487, 5489, 5490, 5491, 5493, 5496, 5501, 5502, 5504, 5505, 5506, 5511, 5512, 5513, 5514, 5515, 5516, 5518, 5520, 5521, 5522, 5523, 5529, 5530, 5534, 5535, 5536, 5537, 5538, 5539, 5540, 5541, 5543, 5544, 5545, 5548, 5549, 5551, 5557, 5558, 5561, 5562, 5571, 5573, 5575, 5576, 5577, 5579, 5581, 5582, 5583, 5584, 5585, 5587, 5589, 5590, 5591, 5592, 5593, 5594, 5595, 5598, 5600, 5601, 5602, 5603, 5606, 5607, 5608, 5609, 5610, 5614, 5615, 5617, 5618, 5622, 5628, 5630, 5631, 5637, 5639, 5640, 5642, 5645, 5647, 5648, 5650, 5651, 5652, 5653, 5654, 5655, 5656, 5657, 5659, 5660, 5662, 5663, 5664, 5665, 5666, 5667, 5668, 5669, 5670, 5671, 5672, 5673, 5677, 5678, 5679, 5680, 5681, 5683, 5686, 5689, 5690, 5691, 5692, 5693, 5694, 5696, 5698, 5699, 5700, 5701, 5703, 5705, 5707, 5709, 5712, 5714, 5716, 5720, 5721, 5722, 5723, 5724, 5726, 5728, 5729, 5730, 5736, 5737, 5739, 5741, 5742, 5743, 5744, 5745, 5746, 5747, 5748, 5749, 5751, 5752, 5754, 5755, 5756, 5758, 5759, 5761, 5762, 5763, 5766, 5768, 5772, 5773, 5774, 5776, 5778, 5779, 5781, 5784, 5785, 5786, 5788, 5789, 5791, 5792, 5793, 5794, 5795, 5796, 5797, 5798, 5802, 5803, 5808, 5809, 5811, 5813, 5814, 5815, 5816, 5817, 5819, 5823, 5828, 5830, 5832, 5834, 5837, 5838, 5844, 5848, 5849, 5851, 5853, 5854, 5855, 5860, 5861, 5862, 5864, 5865, 5866, 5868, 5874, 5881, 5882, 5886, 5887, 5888, 5892, 5897, 5898, 5899, 5900, 5902, 5903, 5905, 5907, 5909, 5910, 5912, 5913, 5915, 5916, 5918, 5920, 5921, 5922, 5925, 5927, 5928, 5932, 5933, 5934, 5935, 5936, 5939, 5940, 5942, 5943, 5944, 5945, 5947, 5948, 5949, 5950, 5952, 5953, 5954, 5955, 5956, 5957, 5960, 5962, 5963, 5965, 5966, 5967, 5968, 5970, 5971, 5979, 5980, 5983, 5984, 5985, 5987, 5988, 5989, 5992, 5993, 5994, 5995, 5996, 5997, 5998, 6000, 6002, 6003, 6004, 6006, 6007, 6008, 6010, 6011, 6012, 6013, 6017, 6021, 6023, 6025, 6027, 6028, 6029, 6032, 6034, 6039, 6040, 6042, 6043, 6044, 6045, 6046, 6049, 6051, 6052, 6053, 6055, 6058, 6064, 6066, 6069, 6071, 6072, 6073, 6078, 6079, 6081, 6083, 6084, 6086, 6088, 6089, 6091, 6093, 6094, 6096, 6097, 6099, 6100, 6103, 6105, 6106, 6107, 6108, 6109, 6112, 6113, 6115, 6117, 6122, 6123, 6127, 6130, 6132, 6133, 6134, 6139, 6142, 6143, 6144, 6147, 6148, 6149, 6150, 6151, 6152, 6153, 6154, 6155, 6156, 6157, 6158, 6159, 6160, 6161, 6162, 6163, 6166, 6167, 6168, 6169, 6170, 6171, 6172, 6173, 6174, 6180, 6181, 6182, 6183, 6184, 6185, 6186, 6187, 6190, 6191, 6192, 6193, 6195, 6197, 6198, 6201, 6202, 6207, 6223, 6224, 6230, 6233, 6234, 6235, 6236, 6237, 6238, 6239, 6240, 6241, 6242, 6243, 6244, 6245, 6246, 6247, 6249, 6251, 6253, 6254, 6255, 6256, 6258, 6259, 6260, 6261, 6263, 6264, 6265, 6266, 6267, 6269, 6270, 6271, 6275, 6276, 6277, 6281, 6282, 6283, 6284, 6285, 6287, 6288, 6290, 6291, 6293, 6294, 6297, 6300, 6301, 6303, 6304, 6305, 6306, 6307, 6308, 6309, 6310, 6313, 6315, 6318, 6320, 6321, 6322, 6323, 6324, 6326, 6327, 6329, 6330, 6331, 6332, 6333, 6335, 6339, 6341, 6342, 6344, 6345, 6346, 6347, 6348, 6349, 6351, 6352, 6354, 6355, 6356, 6357, 6359, 6361, 6364, 6369, 6370, 6371, 6372, 6375, 6376, 6377, 6386, 6388, 6393, 6394, 6399, 6401, 6404, 6405, 6407, 6408, 6410, 6411, 6412, 6413, 6414, 6415, 6416, 6417, 6418, 6422, 6423, 6424, 6426, 6428, 6430, 6431, 6433, 6434, 6436, 6438, 6440, 6441, 6443, 6444, 6445, 6447, 6449, 6452, 6454, 6458, 6460, 6461, 6462, 6463, 6464, 6467, 6470, 6471, 6472, 6473, 6474, 6475, 6477, 6478, 6479, 6483, 6484, 6485, 6486, 6487, 6488, 6491, 6492, 6494, 6495, 6496, 6498, 6499, 6502, 6504, 6506, 6507, 6508, 6509, 6510, 6514, 6516, 6517, 6526, 6527, 6528, 6529, 6531, 6532, 6533, 6534, 6535, 6543, 6545, 6547, 6548, 6552, 6553, 6557, 6559, 6560, 6561, 6566, 6571, 6572, 6577, 6578, 6579, 6580, 6581, 6582, 6583, 6585, 6586, 6587, 6589, 6590, 6593, 6598, 6602, 6604, 6605, 6609, 6611, 6613, 6614, 6618, 6619, 6621, 6622, 6626, 6627, 6628, 6629, 6632, 6633, 6635, 6637, 6643, 6644, 6645, 6647, 6648, 6649, 6651, 6652, 6653, 6654, 6655, 6656, 6657, 6659, 6660, 6661, 6663, 6664, 6666, 6669, 6671, 6672, 6677, 6680, 6681, 6682, 6686, 6687, 6688, 6689, 6690, 6693, 6694, 6696, 6697, 6698, 6699, 6701, 6702, 6703, 6704, 6705, 6707, 6708, 6710, 6713, 6714, 6715, 6717, 6718, 6719, 6724, 6725, 6728, 6733, 6738, 6739, 6740, 6741, 6742, 6743, 6745, 6748, 6750, 6751, 6753, 6755, 6756, 6759, 6760, 6764, 6765, 6766, 6767, 6769, 6770, 6773, 6775, 6776, 6777, 6778, 6779, 6780, 6781, 6783, 6784, 6785, 6788, 6789, 6790, 6791}",3310,"{5120, 5121, 5122, 5123, 6144, 6147, 6148, 6149, 6150, 6151, 6152, 6153, 6154, 6155, 6156, 6157, 6159, 6160, 6161, 6162, 6163, 6166, 6167, 6168, 6169, 6170, 6171, 6185, 1078, 1088, 1089, 1090, 1092, 1093, 1095, 1096, 1097, 1098, 1099, 1100, 1101, 1103, 1104, 1105, 1106, 1107, 1108, 1109, 1112, 5209, 5210, 6233, 1114, 1115, 1116, 1117, 1118, 5217, 1120, 1121, 5220, 5221, 1122, 1123, 5224, 5225, 5226, 1124, 1125, 5229, 5230, 5231, 5232, 1128, 1129, 1130, 5236, 5237, 5238, 5239, 6255, 6256, 5242, 5243, 6259, 6260, 5246, 6263, 5248, 6264, 6265, 6266, 6267, 5253, 6269, 6270, 6271, 6275, 6276, 6277, 6281, 6282, 6283, 6284, 6285, 6287, 6288, 6290, 6291, 6293, 6294, 6297, 6300, 6301, 6303, 6304, 6305, 6306, 1187, 6307, 6308, 6309, 6310, 6318, 6142, 6143, 1213, 1214, 1215, 1216, 6335, 1218, 1219, 6339, 1221, 1222, 1223, 6341, 1225, 6342, 6344, 1228, 1229, 1230, 6345, 6346, 6347, 1234, 6348, 6349, 1237, 1238, 1239, 1240, 1241, 1242, 6351, 6352, 6356, 6357, 6359, 6361, 6354, 6364, 6355, 6399, 6401, 6404, 6405, 6407, 6408, 6410, 6411, 6412, 6413, 6414, 6415, 6416, 6417, 6418, 6422, 6423, 6424, 6426, 6428, 6430, 6431, 6433, 6434, 6436, 6438, 6464, 1347, 5443, 6473, 6474, 6475, 6477, 6478, 6479, 6483, 4436, 6484, 6486, 1367, 1368, 1369, 1370, 6487, 6488, 1373, 1374, 6491, 6492, 1377, 1378, 1379, 5476, 1380, 6494, 6495, 6496, 6498, 1385, 1386, 1387, 1388, 1389, 1390, 1391, 1392, 1393, 6508, 6516, 1395, 1396, 4479, 4480, 5505, 5506, 4481, 4482, 4483, 4484, 4485, 4486, 4487, 4488, 4489, 4490, 4491, 1413, 5511, 5512, 4495, 4496, 4498, 4499, 4500, 4501, 4502, 4503, 5520, 5521, 5522, 5523, 5529, 5530, 5534, 5535, 5536, 5537, 5538, 1443, 1457, 1458, 1459, 6580, 1460, 1461, 1462, 1464, 1467, 1469, 1470, 1471, 1472, 1473, 1476, 1477, 1478, 5513, 1483, 1484, 1485, 1487, 1489, 1491, 1493, 1495, 1499, 1501, 1502, 1503, 1504, 5514, 1505, 1507, 6628, 6629, 1508, 1509, 1510, 1511, 1512, 1513, 6633, 1515, 1516, 1518, 1520, 1521, 1522, 1523, 1524, 6643, 1526, 6644, 1528, 6645, 5515, 1530, 1531, 6648, 6649, 6651, 6652, 6656, 6657, 6653, 6659, 6660, 6661, 6655, 6663, 6664, 6666, 6669, 6671, 6672, 5516, 6677, 6680, 6681, 6682, 6686, 6687, 6688, 6689, 6690, 1126, 6693, 6694, 1127, 6696, 6697, 6698, 6699, 6701, 6702, 6703, 6704, 6705, 1131, 5518, 5701, 6245, 6249, 6251, 6253, 6254, 4861, 6258, 1799, 1801, 1802, 1803, 1804, 6261, 1805, 1808, 1810, 1811, 1814, 1817, 1825, 1849, 1850, 5948, 5949, 5950, 5952, 5953, 5954, 1859, 5955, 5956, 5957, 1863, 5960, 1865, 5962, 1867, 5963, 1869, 1870, 1871, 5965, 5968, 1874, 1875, 5970, 5971, 1878, 1880, 1881, 5979, 5980, 5983, 5984, 5985, 5987, 5988, 6017, 6499, 5084, 5090, 5091, 5092, 5093, 5095, 5096, 5097, 5105, 5107, 5108, 5109, 5110, 6132, 5114, 6139, 5117, 5118, 5119}",454,"{989, 1085, 1094, 1134, 1135, 1136, 1137, 1138, 1140, 1142, 1145, 1147, 1148, 1149, 1150, 1151, 1152, 1153, 1155, 1156, 1158, 1160, 1161, 1162, 1163, 1165, 1167, 1169, 1170, 1171, 1172, 1176, 1177, 1179, 1180, 1181, 1182, 1183, 1184, 1185, 1186, 1188, 1190, 1196, 1197, 1198, 1199, 1200, 1201, 1203, 1204, 1205, 1207, 1208, 1209, 1210, 1231, 1233, 1244, 1246, 1247, 1250, 1254, 1255, 1263, 1265, 1268, 1272, 1273, 1274, 1275, 1276, 1277, 1280, 1281, 1282, 1284, 1285, 1287, 1290, 1291, 1294, 1300, 1301, 1302, 1304, 1305, 1307, 1308, 1309, 1310, 1311, 1313, 1314, 1315, 1318, 1320, 1321, 1323, 1324, 1325, 1327, 1328, 1329, 1330, 1331, 1332, 1334, 1335, 1336, 1338, 1342, 1345, 1346, 1349, 1353, 1357, 1360, 1365, 1382, 1397, 1400, 1401, 1402, 1404, 1405, 1406, 1409, 1410, 1414, 1415, 1420, 1421, 1423, 1424, 1429, 1430, 1431, 1432, 1434, 1435, 1439, 1440, 1441, 1442, 1446, 1448, 1450, 1452, 1453, 1454, 1455, 1456, 1468, 1496, 1514, 1532, 1533, 1536, 1538, 1540, 1542, 1543, 1544, 1545, 1546, 1549, 1551, 1552, 1553, 1554, 1556, 1558, 1560, 1562, 1563, 1565, 1566, 1567, 1568, 1569, 1573, 1574, 1578, 1579, 1580, 1581, 1582, 1583, 1584, 1587, 1588, 1589, 1591, 1592, 1593, 1594, 1595, 1596, 1597, 1598, 1601, 1602, 1604, 1605, 1606, 1607, 1610, 1612, 1614, 1619, 1620, 1621, 1622, 1624, 1625, 1627, 1628, 1629, 1630, 1633, 1637, 1639, 1640, 1642, 1643, 1644, 1645, 1646, 1647, 1648, 1655, 1658, 1661, 1662, 1663, 1665, 1666, 1667, 1669, 1670, 1671, 1674, 1678, 1681, 1682, 1683, 1687, 1691, 1693, 1694, 1699, 1700, 1701, 1702, 1704, 1706, 1707, 1708, 1709, 1710, 1712, 1713, 1714, 1715, 1716, 1717, 1718, 1726, 1727, 1728, 1730, 1731, 1732, 1736, 1737, 1739, 1743, 1744, 1745, 1746, 1748, 1752, 1753, 1754, 1756, 1757, 1758, 1760, 1761, 1764, 1769, 1771, 1772, 1773, 1774, 1775, 1776, 1778, 1779, 1780, 1786, 1790, 1796, 1812, 1818, 1819, 1821, 1822, 1827, 1828, 1829, 1830, 1831, 1834, 1835, 1836, 1837, 1840, 1841, 1842, 1843, 1847, 1848, 1883, 1885, 1886, 1888, 1892, 1893, 1895, 1896, 1897, 1898, 1900, 1901, 1902, 1903, 1905, 1907, 1909, 1910, 1911, 1912, 1915, 1918, 1919, 1920, 1921, 1922, 1923, 1924, 1928, 1929, 1931, 1934, 1937, 1940, 1941, 1944, 1945, 1946, 1947, 1948, 1951, 1955, 1956, 1957, 1958, 1960, 1962, 1964, 1965, 1967, 1968, 1969, 1971, 1972, 1976, 1978, 1979, 1981, 1983, 1986, 1987, 1992, 1993, 1994, 1996, 1997, 1999, 2000, 2001, 2002, 2004, 2005, 2006, 2007, 2010, 2011, 2017, 2019, 2020, 2023, 2024, 2025, 2026, 2031, 2032, 2033, 2034, 2039, 2040, 2041, 2043, 2044, 2047, 2049, 2050, 2051, 2052, 2053, 2056, 2063, 2064, 2065, 2071, 2073, 2074, 2075, 2077, 2079, 2080, 2082, 2083, 2084, 2085, 2087, 2091, 2094, 2100, 2103, 2109, 2111, 2113, 2114, 2115, 2116, 2117, 2119, 2121, 2122, 2124, 2125, 2126, 2128, 2129, 2130, 2131, 2133, 2134, 2135, 2137, 2138, 2141, 2143, 2144, 2148, 2150, 2151, 2154, 2155, 2157, 2158, 2159, 2164, 2166, 2167, 2168, 2169, 2172, 2173, 2174, 2175, 2176, 2177, 2178, 2180, 2181, 2182, 2183, 2186, 2188, 2189, 2191, 2194, 2195, 2196, 2197, 2200, 2201, 2202, 2203, 2204, 2205, 2209, 2210, 2211, 2213, 2214, 2216, 2218, 2219, 2222, 2223, 2226, 2230, 2232, 2234, 2235, 2237, 2239, 2241, 2242, 2244, 2246, 2247, 2248, 2251, 2252, 2253, 2254, 2255, 2259, 2260, 2261, 2262, 2263, 2264, 2265, 2268, 2269, 2272, 2277, 2280, 2284, 2285, 2287, 2288, 2289, 2291, 2292, 2293, 2294, 2295, 2296, 2297, 2299, 2302, 2303, 2304, 2305, 2306, 2310, 2313, 2315, 2320, 2321, 2324, 2327, 2328, 2329, 2331, 2336, 2337, 2338, 2341, 2342, 2345, 2346, 2348, 2349, 2350, 2351, 2352, 2353, 2354, 2357, 2358, 2359, 2360, 2363, 2364, 2365, 2366, 2370, 2373, 2374, 2375, 2377, 2380, 2383, 2385, 2386, 2387, 2388, 2389, 2390, 2391, 2392, 2393, 2396, 2397, 2398, 2401, 2403, 2404, 2405, 2407, 2408, 2409, 2410, 2411, 2412, 2416, 2420, 2421, 2422, 2423, 2425, 2426, 2427, 2428, 2429, 2430, 2437, 2440, 2443, 2448, 2450, 2452, 2453, 2454, 2455, 2459, 2460, 2466, 2470, 2471, 2472, 2473, 2475, 2476, 2477, 2478, 2480, 2481, 2482, 2484, 2485, 2486, 2487, 2488, 2489, 2490, 2491, 2492, 2494, 2495, 2496, 2497, 2501, 2503, 2504, 2508, 2510, 2511, 2515, 2516, 2517, 2518, 2519, 2520, 2522, 2523, 2524, 2525, 2526, 2527, 2528, 2529, 2530, 2531, 2535, 2540, 2543, 2544, 2551, 2552, 2553, 2554, 2557, 2559, 2561, 2562, 2564, 2569, 2570, 2574, 2579, 2580, 2584, 2586, 2591, 2592, 2593, 2595, 2596, 2597, 2599, 2603, 2604, 2606, 2607, 2608, 2614, 2615, 2616, 2620, 2622, 2623, 2624, 2625, 2627, 2628, 2629, 2633, 2635, 2636, 2637, 2640, 2643, 2648, 2650, 2652, 2653, 2656, 2660, 2662, 2666, 2667, 2669, 2672, 2673, 2677, 2679, 2680, 2681, 2683, 2685, 2686, 2687, 2688, 2690, 2692, 2693, 2694, 2696, 2697, 2698, 2699, 2700, 2701, 2703, 2704, 2705, 2707, 2708, 2710, 2712, 2713, 2717, 2718, 2720, 2724, 2725, 2727, 2732, 2733, 2734, 2735, 2736, 2738, 2739, 2740, 2745, 2746, 2747, 2748, 2753, 2754, 2755, 2756, 2757, 2758, 2759, 2760, 2763, 2765, 2768, 2770, 2771, 2772, 2773, 2774, 2777, 2779, 2782, 2783, 2784, 2787, 2789, 2790, 2792, 2793, 2794, 2795, 2800, 2802, 2804, 2808, 2811, 2813, 2817, 2819, 2820, 2821, 2828, 2830, 2831, 2832, 2833, 2835, 2836, 2837, 2838, 2841, 2842, 2843, 2845, 2846, 2847, 2850, 2851, 2855, 2856, 2857, 2858, 2859, 2860, 2861, 2862, 2863, 2865, 2866, 2867, 2868, 2869, 2870, 2872, 2873, 2877, 2878, 2883, 2887, 2888, 2891, 2897, 2898, 2899, 2900, 2901, 2904, 2908, 2909, 2910, 2911, 2912, 2914, 2916, 2917, 2918, 2921, 2923, 2924, 2926, 2930, 2931, 2932, 2934, 2938, 2941, 2942, 2943, 2944, 2945, 2946, 2947, 2949, 2950, 2952, 2953, 2959, 2962, 2963, 2965, 2967, 2969, 2970, 2971, 2974, 2975, 2976, 2977, 2979, 2980, 2982, 2983, 2984, 2985, 2986, 2987, 2989, 2991, 2992, 2993, 2995, 2997, 2998, 2999, 3001, 3004, 3005, 3006, 3008, 3010, 3012, 3015, 3016, 3018, 3020, 3022, 3023, 3024, 3025, 3026, 3027, 3028, 3029, 3030, 3031, 3034, 3036, 3038, 3039, 3040, 3042, 3043, 3046, 3047, 3048, 3049, 3050, 3052, 3053, 3057, 3058, 3059, 3060, 3061, 3062, 3063, 3066, 3067, 3070, 3071, 3072, 3073, 3075, 3076, 3077, 3079, 3080, 3081, 3082, 3084, 3086, 3087, 3088, 3089, 3091, 3093, 3094, 3097, 3098, 3100, 3101, 3103, 3104, 3107, 3108, 3109, 3111, 3112, 3113, 3114, 3115, 3116, 3119, 3121, 3122, 3123, 3124, 3125, 3126, 3128, 3131, 3132, 3134, 3135, 3136, 3137, 3142, 3144, 3146, 3147, 3151, 3152, 3155, 3156, 3157, 3159, 3160, 3163, 3164, 3165, 3166, 3170, 3171, 3172, 3174, 3175, 3176, 3178, 3179, 3180, 3181, 3182, 3184, 3187, 3188, 3192, 3195, 3196, 3197, 3198, 3199, 3200, 3202, 3205, 3206, 3210, 3212, 3213, 3215, 3216, 3217, 3218, 3219, 3224, 3226, 3227, 3228, 3231, 3232, 3234, 3236, 3240, 3241, 3242, 3243, 3244, 3247, 3248, 3249, 3252, 3253, 3254, 3255, 3256, 3260, 3262, 3263, 3265, 3269, 3271, 3273, 3276, 3277, 3279, 3283, 3284, 3285, 3287, 3288, 3289, 3291, 3292, 3293, 3294, 3295, 3296, 3298, 3300, 3302, 3304, 3305, 3306, 3307, 3318, 3319, 3320, 3323, 3325, 3326, 3328, 3330, 3331, 3335, 3338, 3341, 3343, 3345, 3346, 3349, 3350, 3351, 3355, 3357, 3358, 3359, 3363, 3364, 3366, 3368, 3369, 3370, 3371, 3372, 3373, 3375, 3377, 3378, 3380, 3381, 3382, 3383, 3387, 3390, 3391, 3393, 3394, 3396, 3397, 3398, 3399, 3400, 3402, 3403, 3404, 3405, 3406, 3407, 3410, 3411, 3413, 3414, 3416, 3417, 3418, 3422, 3423, 3426, 3428, 3429, 3435, 3437, 3438, 3439, 3440, 3442, 3444, 3446, 3447, 3449, 3452, 3453, 3454, 3456, 3459, 3460, 3462, 3463, 3465, 3466, 3467, 3468, 3469, 3470, 3471, 3474, 3476, 3480, 3481, 3482, 3483, 3485, 3487, 3490, 3493, 3494, 3495, 3497, 3498, 3499, 3502, 3503, 3504, 3505, 3506, 3507, 3509, 3514, 3515, 3516, 3520, 3522, 3523, 3525, 3526, 3527, 3529, 3531, 3532, 3536, 3538, 3541, 3542, 3544, 3546, 3547, 3548, 3549, 3550, 3551, 3552, 3553, 3556, 3557, 3563, 3564, 3565, 3566, 3568, 3569, 3576, 3577, 3578, 3580, 3581, 3582, 3583, 3584, 3586, 3589, 3591, 3592, 3593, 3594, 3595, 3596, 3598, 3599, 3600, 3601, 3602, 3604, 3605, 3608, 3610, 3611, 3612, 3613, 3614, 3615, 3620, 3621, 3622, 3625, 3627, 3629, 3632, 3633, 3635, 3640, 3642, 3644, 3645, 3646, 3650, 3651, 3652, 3653, 3658, 3660, 3664, 3665, 3667, 3669, 3672, 3674, 3676, 3677, 3680, 3681, 3682, 3683, 3684, 3686, 3688, 3689, 3692, 3694, 3696, 3697, 3699, 3707, 3708, 3710, 3711, 3712, 3713, 3716, 3717, 3718, 3721, 3722, 3728, 3729, 3731, 3733, 3735, 3737, 3740, 3743, 3744, 3749, 3751, 3752, 3753, 3754, 3757, 3758, 3759, 3760, 3762, 3765, 3767, 3768, 3770, 3773, 3775, 3776, 3778, 3779, 3782, 3783, 3785, 3787, 3788, 3791, 3792, 3793, 3795, 3796, 3798, 3800, 3802, 3803, 3805, 3806, 3807, 3808, 3809, 3810, 3811, 3812, 3814, 3815, 3817, 3822, 3826, 3828, 3834, 3835, 3836, 3839, 3840, 3841, 3845, 3846, 3847, 3848, 3849, 3850, 3851, 3852, 3853, 3854, 3855, 3859, 3860, 3861, 3862, 3863, 3864, 3866, 3867, 3869, 3871, 3872, 3874, 3877, 3878, 3879, 3880, 3884, 3886, 3887, 3888, 3889, 3890, 3891, 3892, 3893, 3898, 3900, 3901, 3902, 3904, 3905, 3906, 3908, 3912, 3913, 3915, 3917, 3918, 3919, 3921, 3922, 3924, 3926, 3928, 3929, 3930, 3932, 3933, 3934, 3937, 3941, 3943, 3944, 3945, 3946, 3949, 3951, 3952, 3954, 3955, 3956, 3959, 3963, 3964, 3966, 3972, 3974, 3979, 3980, 3981, 3982, 3983, 3984, 3987, 3988, 3989, 3992, 3993, 3995, 3999, 4001, 4003, 4010, 4011, 4012, 4013, 4014, 4016, 4017, 4018, 4020, 4021, 4022, 4023, 4024, 4025, 4028, 4032, 4033, 4037, 4038, 4039, 4040, 4041, 4042, 4043, 4044, 4045, 4053, 4056, 4057, 4058, 4059, 4060, 4067, 4068, 4069, 4070, 4071, 4072, 4073, 4074, 4075, 4077, 4078, 4081, 4083, 4084, 4085, 4086, 4088, 4090, 4091, 4092, 4093, 4094, 4095, 4097, 4098, 4099, 4104, 4106, 4107, 4108, 4109, 4111, 4112, 4113, 4114, 4115, 4118, 4120, 4121, 4124, 4127, 4128, 4129, 4130, 4132, 4133, 4134, 4135, 4136, 4137, 4139, 4142, 4144, 4145, 4147, 4148, 4149, 4150, 4151, 4152, 4153, 4156, 4157, 4160, 4164, 4165, 4168, 4170, 4171, 4172, 4173, 4174, 4175, 4176, 4177, 4178, 4179, 4181, 4182, 4185, 4186, 4187, 4189, 4190, 4192, 4193, 4195, 4198, 4201, 4202, 4203, 4204, 4205, 4207, 4209, 4210, 4211, 4213, 4217, 4218, 4219, 4221, 4222, 4225, 4227, 4229, 4230, 4231, 4232, 4234, 4235, 4237, 4239, 4240, 4243, 4245, 4247, 4248, 4251, 4252, 4254, 4255, 4257, 4259, 4260, 4261, 4264, 4265, 4266, 4267, 4269, 4271, 4272, 4276, 4281, 4283, 4284, 4287, 4288, 4292, 4294, 4295, 4298, 4300, 4301, 4302, 4303, 4305, 4306, 4307, 4310, 4311, 4312, 4313, 4322, 4323, 4326, 4328, 4329, 4332, 4334, 4337, 4339, 4340, 4341, 4343, 4344, 4346, 4347, 4348, 4350, 4351, 4353, 4354, 4356, 4357, 4359, 4361, 4362, 4365, 4366, 4367, 4369, 4373, 4374, 4376, 4378, 4380, 4383, 4384, 4385, 4387, 4389, 4390, 4391, 4393, 4394, 4395, 4396, 4397, 4400, 4402, 4403, 4404, 4405, 4406, 4408, 4410, 4412, 4414, 4415, 4416, 4418, 4419, 4421, 4423, 4424, 4428, 4429, 4434, 4437, 4439, 4442, 4443, 4444, 4446, 4448, 4449, 4450, 4451, 4452, 4453, 4455, 4456, 4457, 4458, 4459, 4465, 4466, 4467, 4473, 4474, 4477, 4504, 4505, 4506, 4507, 4511, 4512, 4513, 4514, 4515, 4516, 4517, 4519, 4520, 4521, 4522, 4523, 4525, 4526, 4528, 4529, 4530, 4531, 4532, 4533, 4534, 4535, 4537, 4538, 4539, 4541, 4542, 4545, 4546, 4547, 4548, 4549, 4551, 4552, 4555, 4556, 4557, 4558, 4559, 4560, 4561, 4562, 4566, 4567, 4568, 4569, 4570, 4575, 4577, 4579, 4581, 4583, 4584, 4588, 4593, 4595, 4598, 4599, 4600, 4601, 4604, 4605, 4611, 4612, 4615, 4622, 4623, 4624, 4625, 4628, 4630, 4635, 4636, 4637, 4639, 4640, 4641, 4642, 4645, 4646, 4647, 4648, 4651, 4652, 4654, 4657, 4658, 4659, 4660, 4661, 4663, 4664, 4666, 4668, 4670, 4671, 4672, 4674, 4675, 4676, 4678, 4679, 4680, 4681, 4685, 4686, 4687, 4688, 4689, 4690, 4691, 4693, 4695, 4696, 4697, 4698, 4699, 4700, 4701, 4703, 4704, 4705, 4706, 4707, 4708, 4709, 4710, 4711, 4712, 4713, 4715, 4716, 4717, 4718, 4719, 4720, 4722, 4724, 4727, 4728, 4729, 4730, 4731, 4736, 4739, 4740, 4742, 4743, 4744, 4745, 4746, 4747, 4748, 4749, 4750, 4751, 4752, 4753, 4755, 4757, 4761, 4762, 4764, 4765, 4767, 4773, 4774, 4777, 4779, 4781, 4784, 4785, 4788, 4790, 4791, 4792, 4793, 4794, 4795, 4796, 4797, 4798, 4799, 4800, 4802, 4805, 4807, 4808, 4809, 4810, 4811, 4814, 4815, 4821, 4823, 4827, 4828, 4829, 4832, 4833, 4834, 4835, 4836, 4837, 4842, 4843, 4844, 4845, 4846, 4848, 4849, 4850, 4851, 4854, 4855, 4856, 4857, 4859, 4860, 4862, 4863, 4868, 4869, 4871, 4872, 4873, 4874, 4876, 4877, 4879, 4880, 4882, 4885, 4888, 4889, 4891, 4892, 4893, 4894, 4898, 4901, 4903, 4904, 4905, 4906, 4907, 4908, 4909, 4910, 4911, 4912, 4914, 4915, 4919, 4920, 4921, 4923, 4926, 4927, 4929, 4930, 4931, 4935, 4937, 4940, 4942, 4948, 4949, 4950, 4951, 4954, 4955, 4958, 4959, 4962, 4963, 4964, 4968, 4969, 4970, 4971, 4972, 4973, 4974, 4975, 4980, 4981, 4982, 4983, 4984, 4987, 4995, 4998, 5000, 5002, 5003, 5004, 5005, 5006, 5007, 5009, 5011, 5012, 5014, 5015, 5017, 5018, 5019, 5020, 5021, 5023, 5024, 5025, 5027, 5029, 5032, 5033, 5036, 5037, 5038, 5039, 5040, 5041, 5042, 5043, 5044, 5045, 5047, 5051, 5052, 5055, 5056, 5057, 5058, 5059, 5060, 5063, 5066, 5067, 5068, 5070, 5072, 5075, 5076, 5077, 5080, 5081, 5082, 5083, 5085, 5086, 5087, 5115, 5124, 5125, 5126, 5127, 5128, 5129, 5130, 5132, 5133, 5134, 5135, 5136, 5137, 5140, 5141, 5142, 5143, 5145, 5147, 5149, 5150, 5155, 5157, 5158, 5160, 5161, 5162, 5163, 5164, 5166, 5167, 5169, 5170, 5171, 5174, 5176, 5178, 5182, 5183, 5185, 5187, 5190, 5191, 5194, 5195, 5196, 5197, 5198, 5199, 5201, 5202, 5203, 5205, 5211, 5212, 5214, 5215, 5257, 5258, 5259, 5260, 5262, 5263, 5264, 5265, 5267, 5268, 5269, 5270, 5273, 5274, 5275, 5278, 5279, 5281, 5283, 5284, 5287, 5288, 5291, 5292, 5296, 5297, 5300, 5301, 5302, 5303, 5304, 5305, 5307, 5308, 5312, 5314, 5315, 5316, 5319, 5320, 5321, 5323, 5327, 5328, 5329, 5330, 5333, 5334, 5336, 5337, 5339, 5340, 5342, 5343, 5344, 5345, 5346, 5347, 5353, 5354, 5357, 5361, 5362, 5364, 5365, 5368, 5369, 5370, 5371, 5372, 5373, 5375, 5376, 5377, 5378, 5379, 5380, 5383, 5384, 5385, 5387, 5388, 5389, 5390, 5391, 5392, 5394, 5397, 5399, 5402, 5403, 5404, 5406, 5407, 5408, 5409, 5411, 5412, 5413, 5414, 5416, 5418, 5419, 5420, 5422, 5423, 5425, 5426, 5427, 5428, 5429, 5430, 5437, 5438, 5440, 5441, 5442, 5444, 5445, 5446, 5447, 5448, 5449, 5450, 5452, 5453, 5454, 5457, 5458, 5459, 5460, 5461, 5462, 5463, 5464, 5466, 5468, 5469, 5471, 5474, 5477, 5480, 5481, 5482, 5483, 5484, 5485, 5486, 5487, 5489, 5490, 5491, 5493, 5496, 5501, 5502, 5504, 5539, 5540, 5541, 5543, 5544, 5545, 5548, 5549, 5551, 5557, 5558, 5561, 5562, 5571, 5573, 5575, 5576, 5577, 5579, 5581, 5582, 5583, 5584, 5585, 5587, 5589, 5590, 5591, 5592, 5593, 5594, 5595, 5598, 5600, 5601, 5602, 5603, 5606, 5607, 5608, 5609, 5610, 5614, 5615, 5617, 5618, 5622, 5628, 5630, 5631, 5637, 5639, 5640, 5642, 5645, 5647, 5648, 5650, 5651, 5652, 5653, 5654, 5655, 5656, 5657, 5659, 5660, 5662, 5663, 5664, 5665, 5666, 5667, 5668, 5669, 5670, 5671, 5672, 5673, 5677, 5678, 5679, 5680, 5681, 5683, 5686, 5689, 5690, 5691, 5692, 5693, 5694, 5696, 5698, 5699, 5700, 5703, 5705, 5707, 5709, 5712, 5714, 5716, 5720, 5721, 5722, 5723, 5724, 5726, 5728, 5729, 5730, 5736, 5737, 5739, 5741, 5742, 5743, 5744, 5745, 5746, 5747, 5748, 5749, 5751, 5752, 5754, 5755, 5756, 5758, 5759, 5761, 5762, 5763, 5766, 5768, 5772, 5773, 5774, 5776, 5778, 5779, 5781, 5784, 5785, 5786, 5788, 5789, 5791, 5792, 5793, 5794, 5795, 5796, 5797, 5798, 5802, 5803, 5808, 5809, 5811, 5813, 5814, 5815, 5816, 5817, 5819, 5823, 5828, 5830, 5832, 5834, 5837, 5838, 5844, 5848, 5849, 5851, 5853, 5854, 5855, 5860, 5861, 5862, 5864, 5865, 5866, 5868, 5874, 5881, 5882, 5886, 5887, 5888, 5892, 5897, 5898, 5899, 5900, 5902, 5903, 5905, 5907, 5909, 5910, 5912, 5913, 5915, 5916, 5918, 5920, 5921, 5922, 5925, 5927, 5928, 5932, 5933, 5934, 5935, 5936, 5939, 5940, 5942, 5943, 5944, 5945, 5947, 5966, 5967, 5989, 5992, 5993, 5994, 5995, 5996, 5997, 5998, 6000, 6002, 6003, 6004, 6006, 6007, 6008, 6010, 6011, 6012, 6013, 6021, 6023, 6025, 6027, 6028, 6029, 6032, 6034, 6039, 6040, 6042, 6043, 6044, 6045, 6046, 6049, 6051, 6052, 6053, 6055, 6058, 6064, 6066, 6069, 6071, 6072, 6073, 6078, 6079, 6081, 6083, 6084, 6086, 6088, 6089, 6091, 6093, 6094, 6096, 6097, 6099, 6100, 6103, 6105, 6106, 6107, 6108, 6109, 6112, 6113, 6115, 6117, 6122, 6123, 6127, 6130, 6133, 6134, 6158, 6172, 6173, 6174, 6180, 6181, 6182, 6183, 6184, 6186, 6187, 6190, 6191, 6192, 6193, 6195, 6197, 6198, 6201, 6202, 6207, 6223, 6224, 6230, 6234, 6235, 6236, 6237, 6238, 6239, 6240, 6241, 6242, 6243, 6244, 6246, 6247, 6313, 6315, 6320, 6321, 6322, 6323, 6324, 6326, 6327, 6329, 6330, 6331, 6332, 6333, 6369, 6370, 6371, 6372, 6375, 6376, 6377, 6386, 6388, 6393, 6394, 6440, 6441, 6443, 6444, 6445, 6447, 6449, 6452, 6454, 6458, 6460, 6461, 6462, 6463, 6467, 6470, 6471, 6472, 6485, 6502, 6504, 6506, 6507, 6509, 6510, 6514, 6517, 6526, 6527, 6528, 6529, 6531, 6532, 6533, 6534, 6535, 6543, 6545, 6547, 6548, 6552, 6553, 6557, 6559, 6560, 6561, 6566, 6571, 6572, 6577, 6578, 6579, 6581, 6582, 6583, 6585, 6586, 6587, 6589, 6590, 6593, 6598, 6602, 6604, 6605, 6609, 6611, 6613, 6614, 6618, 6619, 6621, 6622, 6626, 6627, 6632, 6635, 6637, 6647, 6654, 6707, 6708, 6710, 6713, 6714, 6715, 6717, 6718, 6719, 6724, 6725, 6728, 6733, 6738, 6739, 6740, 6741, 6742, 6743, 6745, 6748, 6750, 6751, 6753, 6755, 6756, 6759, 6760, 6764, 6765, 6766, 6767, 6769, 6770, 6773, 6775, 6776, 6777, 6778, 6779, 6780, 6781, 6783, 6784, 6785, 6788, 6789, 6790, 6791}",2856
9,"(('enter', ('Request For Payment APPROVED by ADMINISTRATION', 'Request For Payment APPROVED by BUDGET OWNER')),)",1,29,"{1081, 1086, 1087, 1110, 1111, 1113, 1119, 1132, 1133, 1139, 1141, 1143, 1144, 1146, 1154, 1157, 1159, 1166, 1168, 1173, 1174, 1175, 1178, 1189, 1191, 1192, 1193, 1194, 1195, 1202, 1206, 1211, 1212, 1217, 1220, 1224, 1226, 1227, 1232, 1235, 1236, 1243, 1245, 1248, 1249, 1251, 1252, 1253, 1258, 1259, 1260, 1262, 1264, 1267, 1269, 1270, 1271, 1278, 1279, 1283, 1286, 1288, 1289, 1292, 1293, 1295, 1296, 1298, 1299, 1303, 1306, 1316, 1317, 1326, 1329, 1333, 1337, 1339, 1340, 1343, 1344, 1348, 1350, 1351, 1352, 1354, 1355, 1356, 1358, 1359, 1361, 1362, 1364, 1366, 1371, 1372, 1375, 1376, 1381, 1383, 1384, 1394, 1399, 1400, 1403, 1407, 1408, 1411, 1412, 1416, 1418, 1419, 1422, 1426, 1427, 1428, 1433, 1436, 1437, 1445, 1447, 1449, 1451, 1463, 1465, 1466, 1474, 1475, 1479, 1481, 1482, 1488, 1492, 1494, 1500, 1506, 1514, 1517, 1519, 1525, 1527, 1529, 1534, 1535, 1539, 1541, 1548, 1550, 1557, 1559, 1561, 1564, 1570, 1571, 1572, 1575, 1576, 1577, 1585, 1586, 1590, 1599, 1600, 1603, 1608, 1609, 1613, 1615, 1616, 1617, 1618, 1623, 1626, 1631, 1632, 1634, 1635, 1636, 1638, 1641, 1649, 1650, 1651, 1652, 1653, 1654, 1656, 1657, 1659, 1660, 1664, 1668, 1672, 1673, 1675, 1676, 1679, 1680, 1684, 1685, 1686, 1688, 1689, 1690, 1692, 1695, 1696, 1697, 1698, 1703, 1705, 1711, 1719, 1720, 1721, 1722, 1723, 1724, 1725, 1729, 1734, 1735, 1738, 1740, 1741, 1742, 1747, 1749, 1755, 1759, 1762, 1765, 1766, 1767, 1768, 1770, 1781, 1782, 1783, 1784, 1785, 1787, 1788, 1789, 1791, 1792, 1793, 1795, 1797, 1798, 1800, 1806, 1807, 1809, 1813, 1815, 1816, 1820, 1823, 1824, 1826, 1832, 1833, 1838, 1839, 1844, 1845, 1846, 1851, 1852, 1853, 1854, 1855, 1857, 1858, 1860, 1861, 1862, 1864, 1866, 1868, 1872, 1873, 1876, 1877, 1879, 1882, 1884, 1887, 1889, 1890, 1891, 1894, 1899, 1904, 1908, 1914, 1916, 1925, 1926, 1927, 1930, 1932, 1936, 1938, 1939, 1942, 1943, 1949, 1950, 1952, 1954, 1959, 1961, 1963, 1966, 1970, 1973, 1974, 1975, 1977, 1980, 1982, 1984, 1985, 1988, 1990, 1991, 1995, 1998, 2003, 2008, 2009, 2012, 2014, 2015, 2016, 2018, 2021, 2022, 2027, 2028, 2029, 2030, 2035, 2036, 2037, 2038, 2042, 2045, 2046, 2055, 2057, 2058, 2059, 2060, 2061, 2062, 2066, 2067, 2068, 2069, 2070, 2076, 2081, 2086, 2088, 2089, 2090, 2092, 2095, 2096, 2097, 2098, 2099, 2101, 2102, 2104, 2106, 2107, 2108, 2110, 2112, 2118, 2120, 2123, 2132, 2139, 2140, 2142, 2146, 2147, 2149, 2152, 2153, 2156, 2160, 2161, 2162, 2163, 2170, 2171, 2179, 2184, 2185, 2187, 2190, 2192, 2193, 2198, 2206, 2207, 2208, 2212, 2215, 2217, 2220, 2221, 2224, 2225, 2228, 2229, 2231, 2233, 2236, 2240, 2243, 2245, 2249, 2250, 2266, 2267, 2270, 2271, 2273, 2274, 2275, 2276, 2281, 2282, 2283, 2290, 2298, 2300, 2301, 2307, 2309, 2311, 2312, 2316, 2317, 2318, 2319, 2322, 2323, 2325, 2330, 2332, 2333, 2334, 2335, 2339, 2340, 2344, 2347, 2355, 2356, 2361, 2362, 2367, 2368, 2369, 2371, 2376, 2378, 2379, 2381, 2382, 2384, 2394, 2395, 2399, 2402, 2406, 2413, 2414, 2415, 2419, 2424, 2431, 2432, 2433, 2434, 2435, 2436, 2438, 2439, 2441, 2442, 2444, 2445, 2446, 2449, 2456, 2457, 2458, 2461, 2462, 2463, 2464, 2465, 2467, 2469, 2474, 2479, 2483, 2499, 2500, 2505, 2506, 2509, 2512, 2513, 2514, 2521, 2532, 2533, 2534, 2536, 2537, 2538, 2541, 2542, 2546, 2547, 2548, 2549, 2550, 2555, 2556, 2558, 2560, 2563, 2566, 2567, 2568, 2572, 2575, 2576, 2577, 2578, 2581, 2582, 2583, 2585, 2587, 2590, 2594, 2598, 2600, 2601, 2605, 2609, 2610, 2611, 2612, 2613, 2617, 2621, 2626, 2630, 2631, 2632, 2639, 2641, 2642, 2644, 2645, 2646, 2647, 2649, 2654, 2655, 2657, 2658, 2659, 2664, 2668, 2671, 2674, 2682, 2684, 2689, 2691, 2695, 2706, 2709, 2711, 2715, 2716, 2721, 2723, 2725, 2726, 2728, 2729, 2730, 2731, 2737, 2741, 2744, 2749, 2750, 2751, 2761, 2762, 2764, 2766, 2769, 2775, 2776, 2780, 2785, 2786, 2791, 2796, 2797, 2798, 2799, 2801, 2803, 2805, 2806, 2807, 2809, 2812, 2814, 2815, 2816, 2818, 2822, 2823, 2825, 2826, 2827, 2834, 2839, 2840, 2844, 2848, 2849, 2852, 2853, 2854, 2871, 2874, 2875, 2880, 2884, 2886, 2889, 2890, 2892, 2893, 2894, 2895, 2896, 2902, 2903, 2905, 2906, 2907, 2915, 2919, 2920, 2925, 2927, 2933, 2935, 2937, 2939, 2940, 2951, 2955, 2956, 2957, 2960, 2961, 2966, 2968, 2972, 2973, 2978, 2981, 2988, 2990, 2994, 2996, 3000, 3002, 3003, 3007, 3009, 3011, 3014, 3017, 3019, 3032, 3033, 3035, 3037, 3044, 3045, 3051, 3054, 3055, 3064, 3065, 3068, 3074, 3083, 3090, 3095, 3096, 3099, 3102, 3105, 3106, 3110, 3118, 3120, 3127, 3133, 3138, 3139, 3141, 3143, 3149, 3150, 3153, 3158, 3162, 3167, 3169, 3173, 3177, 3183, 3185, 3186, 3189, 3190, 3191, 3193, 3194, 3201, 3203, 3204, 3207, 3208, 3209, 3211, 3214, 3222, 3223, 3225, 3229, 3233, 3245, 3250, 3251, 3257, 3258, 3259, 3261, 3270, 3272, 3280, 3281, 3282, 3286, 3299, 3301, 3303, 3310, 3311, 3312, 3313, 3314, 3316, 3317, 3321, 3322, 3327, 3329, 3332, 3333, 3334, 3336, 3337, 3339, 3340, 3342, 3344, 3345, 3347, 3352, 3353, 3354, 3356, 3360, 3362, 3367, 3374, 3376, 3379, 3384, 3386, 3388, 3389, 3392, 3401, 3408, 3412, 3415, 3419, 3421, 3424, 3427, 3430, 3431, 3432, 3433, 3434, 3436, 3441, 3443, 3445, 3448, 3450, 3451, 3455, 3457, 3461, 3472, 3473, 3477, 3484, 3486, 3488, 3489, 3491, 3492, 3500, 3501, 3510, 3511, 3512, 3513, 3519, 3521, 3528, 3530, 3533, 3534, 3535, 3539, 3540, 3543, 3545, 3558, 3562, 3567, 3570, 3571, 3572, 3573, 3574, 3575, 3585, 3588, 3603, 3606, 3607, 3609, 3616, 3617, 3618, 3623, 3624, 3626, 3628, 3630, 3631, 3634, 3636, 3637, 3638, 3639, 3647, 3648, 3649, 3655, 3656, 3657, 3661, 3662, 3663, 3666, 3668, 3670, 3671, 3673, 3675, 3678, 3679, 3685, 3687, 3690, 3691, 3693, 3698, 3700, 3701, 3702, 3703, 3704, 3705, 3706, 3709, 3719, 3724, 3730, 3732, 3734, 3736, 3738, 3739, 3748, 3750, 3756, 3761, 3763, 3764, 3766, 3769, 3772, 3774, 3777, 3781, 3784, 3786, 3789, 3790, 3794, 3797, 3799, 3801, 3804, 3813, 3818, 3819, 3820, 3821, 3823, 3825, 3827, 3829, 3830, 3831, 3832, 3833, 3837, 3838, 3843, 3844, 3856, 3857, 3858, 3868, 3870, 3873, 3875, 3894, 3895, 3896, 3897, 3899, 3903, 3907, 3910, 3920, 3923, 3925, 3927, 3935, 3936, 3938, 3939, 3940, 3947, 3948, 3950, 3953, 3957, 3958, 3960, 3962, 3965, 3967, 3969, 3973, 3975, 3976, 3977, 3978, 3985, 3986, 3990, 3991, 3994, 3996, 3997, 3998, 4000, 4002, 4004, 4005, 4006, 4007, 4008, 4009, 4019, 4026, 4027, 4029, 4030, 4031, 4034, 4046, 4047, 4049, 4050, 4054, 4055, 4061, 4062, 4063, 4076, 4079, 4080, 4082, 4087, 4089, 4096, 4100, 4101, 4102, 4103, 4105, 4116, 4117, 4119, 4122, 4123, 4125, 4126, 4131, 4138, 4140, 4141, 4143, 4154, 4155, 4158, 4159, 4161, 4163, 4166, 4167, 4169, 4183, 4184, 4188, 4191, 4194, 4196, 4197, 4200, 4206, 4208, 4212, 4214, 4215, 4216, 4223, 4224, 4226, 4228, 4233, 4238, 4241, 4242, 4244, 4246, 4249, 4250, 4253, 4256, 4258, 4262, 4263, 4270, 4273, 4275, 4277, 4278, 4279, 4280, 4286, 4289, 4290, 4293, 4297, 4299, 4304, 4308, 4309, 4314, 4315, 4316, 4317, 4318, 4319, 4320, 4321, 4325, 4327, 4330, 4331, 4333, 4335, 4336, 4342, 4345, 4349, 4352, 4358, 4363, 4364, 4368, 4370, 4371, 4372, 4375, 4377, 4379, 4381, 4382, 4386, 4388, 4392, 4398, 4399, 4401, 4407, 4409, 4411, 4413, 4417, 4420, 4422, 4425, 4426, 4427, 4430, 4432, 4433, 4435, 4438, 4440, 4441, 4445, 4447, 4460, 4461, 4463, 4468, 4469, 4471, 4472, 4478, 4492, 4493, 4494, 4497, 4508, 4509, 4510, 4518, 4524, 4527, 4536, 4540, 4543, 4544, 4553, 4554, 4563, 4564, 4565, 4571, 4572, 4573, 4574, 4576, 4578, 4580, 4582, 4585, 4586, 4587, 4589, 4590, 4591, 4594, 4596, 4597, 4602, 4603, 4606, 4607, 4608, 4610, 4613, 4614, 4616, 4618, 4619, 4620, 4621, 4624, 4626, 4627, 4629, 4632, 4633, 4634, 4643, 4644, 4650, 4653, 4655, 4656, 4662, 4665, 4667, 4669, 4673, 4677, 4682, 4683, 4684, 4692, 4694, 4702, 4723, 4725, 4726, 4732, 4733, 4734, 4735, 4737, 4738, 4741, 4754, 4756, 4758, 4759, 4760, 4763, 4768, 4770, 4771, 4772, 4775, 4776, 4778, 4780, 4783, 4789, 4801, 4803, 4804, 4806, 4813, 4816, 4817, 4818, 4819, 4820, 4822, 4826, 4830, 4831, 4838, 4839, 4840, 4841, 4847, 4852, 4853, 4858, 4864, 4865, 4866, 4867, 4875, 4878, 4881, 4883, 4884, 4887, 4890, 4895, 4897, 4899, 4900, 4902, 4916, 4917, 4918, 4922, 4924, 4925, 4928, 4932, 4933, 4934, 4936, 4938, 4939, 4943, 4944, 4945, 4946, 4947, 4952, 4953, 4956, 4957, 4960, 4961, 4965, 4967, 4977, 4978, 4979, 4986, 4988, 4989, 4990, 4991, 4993, 4994, 4996, 4997, 4999, 5001, 5010, 5013, 5016, 5022, 5026, 5028, 5031, 5034, 5035, 5046, 5048, 5049, 5050, 5053, 5061, 5062, 5064, 5065, 5069, 5071, 5073, 5074, 5076, 5078, 5079, 5098, 5099, 5100, 5101, 5102, 5103, 5104, 5106, 5111, 5112, 5113, 5116, 5131, 5138, 5139, 5144, 5148, 5151, 5152, 5156, 5159, 5165, 5168, 5172, 5175, 5179, 5181, 5186, 5188, 5192, 5193, 5200, 5204, 5206, 5207, 5208, 5213, 5216, 5218, 5219, 5233, 5240, 5241, 5245, 5247, 5249, 5250, 5251, 5252, 5256, 5261, 5266, 5271, 5272, 5276, 5277, 5280, 5282, 5285, 5286, 5289, 5290, 5294, 5295, 5298, 5299, 5306, 5309, 5310, 5311, 5313, 5317, 5324, 5325, 5326, 5329, 5331, 5335, 5338, 5341, 5348, 5350, 5351, 5352, 5355, 5356, 5358, 5359, 5363, 5366, 5367, 5381, 5386, 5393, 5396, 5398, 5400, 5401, 5405, 5410, 5417, 5424, 5431, 5432, 5433, 5434, 5435, 5439, 5451, 5455, 5456, 5465, 5467, 5470, 5472, 5473, 5475, 5478, 5479, 5488, 5492, 5494, 5495, 5497, 5498, 5499, 5500, 5503, 5507, 5508, 5509, 5510, 5517, 5519, 5524, 5525, 5526, 5527, 5531, 5532, 5533, 5542, 5547, 5550, 5552, 5554, 5555, 5556, 5559, 5560, 5563, 5564, 5565, 5566, 5567, 5568, 5569, 5570, 5572, 5574, 5578, 5580, 5586, 5588, 5596, 5597, 5604, 5605, 5612, 5613, 5616, 5620, 5623, 5624, 5625, 5626, 5627, 5629, 5632, 5633, 5634, 5635, 5636, 5643, 5646, 5649, 5658, 5661, 5674, 5676, 5682, 5684, 5685, 5688, 5695, 5697, 5702, 5704, 5706, 5708, 5711, 5713, 5717, 5718, 5731, 5732, 5733, 5734, 5735, 5740, 5753, 5757, 5760, 5764, 5765, 5767, 5769, 5771, 5775, 5777, 5780, 5782, 5783, 5787, 5799, 5800, 5801, 5804, 5805, 5806, 5810, 5820, 5821, 5822, 5825, 5826, 5827, 5829, 5831, 5833, 5835, 5836, 5839, 5840, 5841, 5842, 5843, 5846, 5847, 5850, 5852, 5856, 5857, 5858, 5859, 5863, 5869, 5870, 5871, 5872, 5875, 5876, 5877, 5878, 5880, 5883, 5884, 5889, 5890, 5891, 5893, 5894, 5895, 5896, 5901, 5904, 5908, 5914, 5917, 5919, 5924, 5926, 5929, 5937, 5938, 5946, 5969, 5972, 5973, 5974, 5975, 5976, 5977, 5978, 5981, 5986, 5990, 5991, 5999, 6001, 6005, 6009, 6015, 6016, 6018, 6019, 6022, 6024, 6030, 6031, 6036, 6037, 6041, 6047, 6048, 6056, 6057, 6059, 6060, 6061, 6063, 6065, 6067, 6068, 6070, 6074, 6075, 6076, 6077, 6080, 6085, 6087, 6090, 6092, 6095, 6101, 6102, 6104, 6111, 6114, 6116, 6119, 6120, 6121, 6124, 6126, 6128, 6129, 6131, 6135, 6136, 6137, 6140, 6141, 6145, 6146, 6164, 6165, 6175, 6176, 6178, 6179, 6189, 6194, 6196, 6200, 6203, 6204, 6205, 6206, 6208, 6209, 6210, 6211, 6212, 6213, 6214, 6215, 6216, 6217, 6218, 6219, 6220, 6221, 6222, 6225, 6226, 6227, 6228, 6229, 6231, 6232, 6233, 6248, 6250, 6252, 6257, 6262, 6272, 6273, 6274, 6278, 6279, 6280, 6286, 6289, 6292, 6295, 6296, 6298, 6302, 6311, 6314, 6316, 6317, 6319, 6325, 6328, 6334, 6336, 6338, 6340, 6343, 6350, 6353, 6358, 6360, 6362, 6363, 6365, 6373, 6374, 6378, 6379, 6380, 6381, 6382, 6383, 6384, 6385, 6387, 6389, 6390, 6391, 6392, 6395, 6396, 6402, 6419, 6420, 6421, 6425, 6427, 6429, 6435, 6437, 6439, 6442, 6446, 6448, 6450, 6453, 6455, 6457, 6468, 6469, 6476, 6481, 6482, 6489, 6493, 6497, 6500, 6501, 6503, 6505, 6511, 6512, 6513, 6515, 6518, 6519, 6520, 6521, 6522, 6523, 6524, 6525, 6530, 6536, 6537, 6538, 6539, 6540, 6541, 6542, 6544, 6554, 6555, 6556, 6558, 6562, 6563, 6564, 6565, 6567, 6568, 6569, 6570, 6573, 6575, 6576, 6584, 6591, 6592, 6594, 6595, 6596, 6597, 6600, 6601, 6603, 6606, 6607, 6608, 6610, 6612, 6615, 6616, 6617, 6620, 6623, 6624, 6625, 6630, 6631, 6634, 6636, 6639, 6640, 6641, 6642, 6646, 6650, 6658, 6662, 6665, 6667, 6668, 6670, 6673, 6675, 6676, 6678, 6679, 6683, 6684, 6685, 6691, 6692, 6695, 6700, 6706, 6709, 6711, 6712, 6716, 6720, 6721, 6722, 6723, 6726, 6727, 6729, 6730, 6731, 6732, 6734, 6735, 6736, 6737, 6744, 6747, 6752, 6754, 6757, 6762, 6768, 6771, 6774, 6782, 6786, 6787, 6792, 6793}",1989,"{2068, 6518, 6179, 2095, 2096, 2097, 2098, 2099, 2101, 2102, 2104, 2107, 2108, 6203, 2110, 6204, 6206, 6208, 6209, 6210, 6211, 6212, 6213, 6214, 6215, 6218, 6219, 6220, 6227, 1110, 6232, 5218, 5250, 6336, 6338, 6340, 6343, 6350, 6353, 6358, 6360, 6362, 6363, 6365, 6373, 6374, 6378, 6379, 6380, 6381, 6383, 6384, 6385, 6387, 6389, 6390, 6391, 6392, 1278, 1288, 2319, 6439, 6442, 6446, 6448, 6450, 6453, 1337, 6457, 1339, 1340, 1343, 3392, 1344, 1348, 6469, 6468, 1350, 1351, 1352, 1354, 1356, 1358, 1359, 1361, 1362, 1364, 1366, 5470, 3430, 3431, 3432, 3433, 3434, 6503, 3436, 2413, 6505, 2414, 2415, 3441, 6511, 3443, 6512, 3445, 6513, 2419, 6520, 6521, 3448, 6523, 6515, 3450, 3451, 6524, 6519, 3455, 6530, 6522, 6525, 5503, 2431, 2432, 6536, 6537, 6538, 5507, 5508, 5509, 5510, 6542, 6544, 2442, 5517, 5519, 6539, 6540, 6541, 5525, 5526, 5527, 6554, 5531, 6555, 5533, 6556, 6558, 6562, 6563, 6564, 6565, 5542, 6567, 6568, 6569, 6570, 5547, 6573, 5550, 6575, 5552, 6576, 5554, 5555, 5556, 5559, 5560, 5567, 5568, 5569, 5570, 6591, 6596, 6592, 6594, 6595, 6597, 6600, 6601, 6603, 6606, 6607, 6608, 6610, 6612, 6615, 6616, 6617, 6620, 6623, 6624, 6625, 5604, 2533, 5605, 6630, 6631, 2537, 2538, 6634, 5612, 2541, 2542, 5613, 6636, 5616, 2546, 2547, 2548, 2549, 2550, 5620, 5623, 5624, 5625, 2555, 5626, 5627, 2558, 2560, 5632, 5633, 2563, 2566, 2567, 2568, 2572, 6670, 2575, 2576, 6673, 2577, 6675, 6676, 2578, 6678, 6679, 2581, 2582, 2585, 6683, 6684, 6685, 2587, 2590, 2594, 6691, 6692, 2598, 6695, 2600, 2601, 2605, 6709, 6711, 6712, 4667, 6716, 6720, 6721, 6722, 6723, 6726, 6727, 6729, 6730, 6731, 6732, 1613, 6734, 1615, 6736, 6737, 1616, 1617, 1618, 1623, 1626, 3679, 1631, 1632, 1634, 1635, 1636, 1638, 3687, 1641, 2668, 4725, 4763, 3769, 3777, 4801, 4803, 4804, 4806, 4813, 3790, 4816, 4817, 4818, 4819, 4820, 5846, 5847, 5850, 5852, 2791, 1768, 2796, 2797, 2798, 2799, 2801, 2805, 2806, 2807, 2809, 1797, 1798, 1800, 1806, 1807, 1809, 1813, 1815, 1816, 1820, 1823, 1824, 1826, 1851, 1852, 1854, 1855, 1857, 1858, 1860, 1861, 1862, 1864, 4938, 1866, 1868, 1872, 1873, 1877, 1879, 1882, 1890, 3947, 3948, 3950, 5999, 1904, 3953, 4978, 4979, 3957, 3958, 3960, 3962, 4986, 4988, 3965, 4989, 3967, 4990, 3969, 4991, 4993, 1400, 4994, 3973, 4996, 3975, 3976, 3977, 3978, 4997, 4999, 6024, 5001, 3985, 3986, 3990, 3991, 1942, 3994, 3996, 3997, 3998, 5026, 2424, 4004, 6056, 6057, 6059, 6060, 6061, 6063, 6065, 6067, 6068, 6070, 4026, 4027, 6074, 4029, 4030, 4031, 6075, 1980, 6076, 1982, 6077, 1984, 1985, 6080, 1988, 1990, 1991, 1995, 4046, 4047, 1998, 5073, 5074, 2433, 4049, 4050, 2003, 4054, 4055, 2434, 2008, 2009, 2435, 2012, 2014, 2015, 2016, 2436, 2018, 2021, 2022, 2438, 2027, 2028, 2029, 2030, 2439, 2035, 2036, 2037, 2038, 2042, 2046}",458,"{4096, 4100, 4101, 4102, 4103, 4105, 4116, 4117, 4119, 4122, 4123, 4125, 4126, 4131, 4138, 4140, 4141, 4143, 4154, 4155, 4158, 4159, 4161, 4163, 4166, 4167, 4169, 4183, 4184, 4188, 4191, 4194, 4196, 4197, 4200, 4206, 4208, 4212, 4214, 4215, 4216, 4223, 4224, 4226, 4228, 4233, 4238, 4241, 4242, 4244, 4246, 4249, 4250, 4253, 4256, 4258, 4262, 4263, 4270, 4273, 4275, 4277, 4278, 4279, 4280, 4286, 4289, 4290, 4293, 4297, 4299, 4304, 4308, 4309, 4314, 4315, 4316, 4317, 4318, 4319, 4320, 4321, 4325, 4327, 4330, 4331, 4333, 4335, 4336, 4342, 4345, 4349, 4352, 4358, 4363, 4364, 4368, 4370, 4371, 4372, 4375, 4377, 4379, 4381, 4382, 4386, 4388, 4392, 4398, 4399, 4401, 4407, 4409, 4411, 4413, 4417, 4420, 4422, 4425, 4426, 4427, 4430, 4432, 4433, 4435, 4438, 4440, 4441, 4445, 4447, 4460, 4461, 4463, 4468, 4469, 4471, 4472, 4478, 4492, 4493, 4494, 4497, 4508, 4509, 4510, 4518, 4524, 4527, 4536, 4540, 4543, 4544, 4553, 4554, 4563, 4564, 4565, 4571, 4572, 4573, 4574, 4576, 4578, 4580, 4582, 4585, 4586, 4587, 4589, 4590, 4591, 4594, 4596, 4597, 4602, 4603, 4606, 4607, 4608, 4610, 4613, 4614, 4616, 4618, 4619, 4620, 4621, 4624, 4626, 4627, 4629, 4632, 4633, 4634, 4643, 4644, 4650, 4653, 4655, 4656, 4662, 4665, 4669, 4673, 4677, 4682, 4683, 4684, 4692, 4694, 4702, 4723, 4726, 4732, 4733, 4734, 4735, 4737, 4738, 4741, 4754, 4756, 4758, 4759, 4760, 4768, 4770, 4771, 4772, 4775, 4776, 4778, 4780, 4783, 4789, 4822, 4826, 4830, 4831, 4838, 4839, 4840, 4841, 4847, 4852, 4853, 4858, 4864, 4865, 4866, 4867, 4875, 4878, 4881, 4883, 4884, 4887, 4890, 4895, 4897, 4899, 4900, 4902, 4916, 4917, 4918, 4922, 4924, 4925, 4928, 4932, 4933, 4934, 4936, 4939, 4943, 4944, 4945, 4946, 4947, 4952, 4953, 4956, 4957, 4960, 4961, 4965, 4967, 4977, 5880, 5010, 5013, 5016, 5022, 5028, 5031, 5034, 5035, 5046, 5048, 5049, 5050, 5053, 5061, 5062, 5064, 5065, 5069, 5071, 5076, 5078, 5079, 5098, 5099, 5100, 5101, 5102, 5103, 5104, 5106, 5111, 5112, 5113, 5116, 5131, 5138, 5139, 5144, 5148, 5151, 5152, 5156, 5159, 5165, 5168, 5172, 5175, 1081, 5179, 5181, 1086, 1087, 5186, 5188, 5192, 5193, 5200, 5204, 1111, 5206, 1113, 5207, 5208, 5213, 1119, 5216, 5219, 1132, 1133, 5233, 1139, 1141, 1143, 1144, 5240, 1146, 5241, 5245, 5247, 5249, 1154, 5251, 1157, 5252, 1159, 5256, 5261, 1166, 1168, 5266, 1173, 1174, 1175, 5271, 5272, 1178, 5276, 5277, 5280, 5282, 1189, 5285, 1191, 1192, 1193, 1194, 1195, 5286, 5289, 5290, 5294, 5295, 1202, 5298, 5299, 1206, 5306, 1211, 1212, 5309, 5310, 5311, 1217, 5313, 1220, 5317, 1224, 1226, 1227, 5324, 5325, 5326, 1232, 5329, 1235, 1236, 5331, 5335, 5338, 1243, 1245, 5341, 1248, 1249, 1251, 1252, 1253, 5348, 5350, 5351, 5352, 1258, 1259, 1260, 5355, 1262, 5356, 1264, 5358, 5359, 1267, 5363, 1269, 1270, 1271, 5366, 5367, 1279, 1283, 5381, 1286, 1289, 5386, 1292, 1293, 1295, 1296, 5393, 1298, 1299, 5396, 5398, 1303, 5400, 5401, 1306, 5405, 5410, 1316, 1317, 5417, 1326, 5424, 1329, 1333, 5431, 5432, 5433, 5434, 5435, 5439, 1355, 5451, 5455, 5456, 5465, 1371, 1372, 5467, 1375, 1376, 5472, 5473, 5475, 1381, 5478, 1383, 1384, 5479, 5488, 1394, 5492, 5494, 1399, 5495, 5497, 1403, 5498, 5499, 5500, 1407, 1408, 1411, 1412, 1416, 1418, 1419, 1422, 1426, 1427, 1428, 5524, 1433, 1436, 1437, 5532, 1445, 1447, 1449, 1451, 1463, 1465, 1466, 5563, 5564, 5565, 5566, 1474, 1475, 5572, 1479, 5574, 1481, 1482, 5578, 5580, 1488, 5586, 1492, 5588, 1494, 1500, 5596, 5597, 1506, 1514, 1517, 1519, 1525, 1527, 1529, 1534, 1535, 5629, 1539, 5634, 1541, 5635, 5636, 5643, 1548, 1550, 5646, 5649, 1557, 1559, 1561, 5658, 1564, 5661, 1570, 1571, 1572, 1575, 1576, 1577, 5674, 5676, 1585, 1586, 5682, 5684, 5685, 1590, 5688, 1599, 1600, 5695, 5697, 1603, 5702, 1608, 1609, 5704, 5706, 5708, 5711, 5713, 5717, 5718, 5731, 5732, 5733, 5734, 5735, 5740, 1649, 1650, 1651, 1652, 1653, 1654, 1656, 1657, 5753, 1659, 1660, 5757, 1664, 5760, 1668, 5764, 5765, 5767, 1672, 1673, 5769, 1675, 1676, 5771, 1679, 1680, 5775, 5777, 1684, 1685, 1686, 5780, 1688, 1689, 1690, 5782, 1692, 5783, 5787, 1695, 1696, 1697, 1698, 1703, 5799, 1705, 5800, 5801, 5804, 5805, 5806, 1711, 5810, 1719, 1720, 1721, 1722, 1723, 1724, 1725, 5820, 5821, 5822, 1729, 5825, 5826, 5827, 5829, 1734, 1735, 5831, 5833, 1738, 5835, 1740, 1741, 1742, 5836, 5839, 5840, 5841, 1747, 5842, 1749, 5843, 1755, 1759, 5856, 5857, 1762, 5858, 5859, 1765, 1766, 1767, 5863, 1770, 5869, 5870, 5871, 5872, 5875, 5876, 1781, 1782, 1783, 1784, 1785, 5877, 1787, 1788, 1789, 5878, 1791, 1792, 1793, 5883, 1795, 5884, 5889, 5890, 5891, 5893, 5894, 5895, 5896, 5901, 5904, 5908, 5914, 5917, 5919, 5924, 5926, 1832, 1833, 5929, 1838, 1839, 5937, 5938, 1844, 1845, 1846, 5946, 1853, 5969, 1876, 5972, 5973, 5974, 5975, 1884, 5976, 5977, 1887, 5978, 1889, 1891, 5981, 5986, 1894, 5990, 5991, 1899, 6001, 1908, 6005, 6009, 1914, 1916, 6015, 6016, 6018, 6019, 1925, 1926, 1927, 6022, 1930, 1932, 6030, 6031, 1936, 1938, 1939, 6036, 6037, 1943, 6041, 1949, 1950, 6047, 1952, 6048, 1954, 1959, 1961, 1963, 1966, 1970, 1973, 1974, 1975, 1977, 6085, 6087, 6090, 6092, 6095, 6101, 6102, 6104, 6111, 6114, 6116, 6119, 6120, 6121, 6124, 6126, 6128, 6129, 6131, 6135, 6136, 6137, 6140, 2045, 6141, 6145, 6146, 2055, 2057, 2058, 2059, 2060, 2061, 2062, 2066, 2067, 2069, 2070, 6164, 6165, 2076, 6175, 6176, 2081, 6178, 2086, 2088, 2089, 2090, 2092, 6189, 6194, 6196, 6200, 2106, 2112, 6205, 2118, 2120, 2123, 6216, 6217, 6221, 2132, 6222, 6225, 6226, 6228, 6229, 2139, 2140, 6231, 2142, 6233, 2146, 2147, 2149, 2152, 2153, 6248, 6250, 2156, 6252, 2160, 2161, 2162, 2163, 6257, 6262, 2170, 2171, 6272, 6273, 6274, 2179, 6278, 6279, 2184, 2185, 6280, 2187, 2190, 6286, 2192, 2193, 6289, 6292, 2198, 6295, 6296, 6298, 2206, 2207, 2208, 6302, 2212, 2215, 6311, 2217, 6314, 2220, 2221, 6316, 6317, 2224, 2225, 6319, 2228, 2229, 6325, 2231, 6328, 2233, 2236, 6334, 2240, 2243, 2245, 2249, 2250, 2266, 2267, 2270, 2271, 2273, 2274, 2275, 2276, 2281, 2282, 2283, 6382, 2290, 2298, 6395, 2300, 2301, 6396, 6402, 2307, 2309, 2311, 2312, 2316, 2317, 2318, 2322, 2323, 6419, 2325, 6420, 6421, 6425, 2330, 6427, 2332, 2333, 2334, 2335, 6429, 2339, 2340, 6435, 6437, 2344, 2347, 2355, 2356, 6455, 2361, 2362, 2367, 2368, 2369, 2371, 2376, 2378, 2379, 6476, 2381, 2382, 2384, 6481, 6482, 6489, 2394, 2395, 6493, 2399, 6497, 2402, 6500, 6501, 2406, 2441, 2444, 2445, 2446, 2449, 2456, 2457, 2458, 2461, 2462, 2463, 2464, 2465, 2467, 2469, 2474, 2479, 2483, 6584, 2499, 2500, 2505, 2506, 2509, 2512, 2513, 2514, 2521, 2532, 2534, 2536, 6639, 6640, 6641, 6642, 6646, 6650, 2556, 6658, 6662, 6665, 6667, 6668, 2583, 6700, 2609, 2610, 2611, 2612, 2613, 6706, 2617, 2621, 2626, 2630, 2631, 2632, 2639, 2641, 2642, 6735, 2644, 2645, 2646, 2647, 2649, 6744, 6747, 2654, 2655, 6752, 2657, 2658, 2659, 6754, 6757, 2664, 6762, 2671, 6768, 2674, 6771, 6774, 2682, 2684, 6782, 2689, 6786, 2691, 6787, 2695, 6792, 6793, 2706, 2709, 2711, 2715, 2716, 2721, 2723, 2725, 2726, 2728, 2729, 2730, 2731, 2737, 2741, 2744, 2749, 2750, 2751, 2761, 2762, 2764, 2766, 2769, 2775, 2776, 2780, 2785, 2786, 2803, 2812, 2814, 2815, 2816, 2818, 2822, 2823, 2825, 2826, 2827, 2834, 2839, 2840, 2844, 2848, 2849, 2852, 2853, 2854, 2871, 2874, 2875, 2880, 2884, 2886, 2889, 2890, 2892, 2893, 2894, 2895, 2896, 2902, 2903, 2905, 2906, 2907, 2915, 2919, 2920, 2925, 2927, 2933, 2935, 2937, 2939, 2940, 2951, 2955, 2956, 2957, 2960, 2961, 2966, 2968, 2972, 2973, 2978, 2981, 2988, 2990, 2994, 2996, 3000, 3002, 3003, 3007, 3009, 3011, 3014, 3017, 3019, 3032, 3033, 3035, 3037, 3044, 3045, 3051, 3054, 3055, 3064, 3065, 3068, 3074, 3083, 3090, 3095, 3096, 3099, 3102, 3105, 3106, 3110, 3118, 3120, 3127, 3133, 3138, 3139, 3141, 3143, 3149, 3150, 3153, 3158, 3162, 3167, 3169, 3173, 3177, 3183, 3185, 3186, 3189, 3190, 3191, 3193, 3194, 3201, 3203, 3204, 3207, 3208, 3209, 3211, 3214, 3222, 3223, 3225, 3229, 3233, 3245, 3250, 3251, 3257, 3258, 3259, 3261, 3270, 3272, 3280, 3281, 3282, 3286, 3299, 3301, 3303, 3310, 3311, 3312, 3313, 3314, 3316, 3317, 3321, 3322, 3327, 3329, 3332, 3333, 3334, 3336, 3337, 3339, 3340, 3342, 3344, 3345, 3347, 3352, 3353, 3354, 3356, 3360, 3362, 3367, 3374, 3376, 3379, 3384, 3386, 3388, 3389, 3401, 3408, 3412, 3415, 3419, 3421, 3424, 3427, 3457, 3461, 3472, 3473, 3477, 3484, 3486, 3488, 3489, 3491, 3492, 3500, 3501, 3510, 3511, 3512, 3513, 3519, 3521, 3528, 3530, 3533, 3534, 3535, 3539, 3540, 3543, 3545, 3558, 3562, 3567, 3570, 3571, 3572, 3573, 3574, 3575, 3585, 3588, 3603, 3606, 3607, 3609, 3616, 3617, 3618, 3623, 3624, 3626, 3628, 3630, 3631, 3634, 3636, 3637, 3638, 3639, 3647, 3648, 3649, 3655, 3656, 3657, 3661, 3662, 3663, 3666, 3668, 3670, 3671, 3673, 3675, 3678, 3685, 3690, 3691, 3693, 3698, 3700, 3701, 3702, 3703, 3704, 3705, 3706, 3709, 3719, 3724, 3730, 3732, 3734, 3736, 3738, 3739, 3748, 3750, 3756, 3761, 3763, 3764, 3766, 3772, 3774, 3781, 3784, 3786, 3789, 3794, 3797, 3799, 3801, 3804, 3813, 3818, 3819, 3820, 3821, 3823, 3825, 3827, 3829, 3830, 3831, 3832, 3833, 3837, 3838, 3843, 3844, 3856, 3857, 3858, 3868, 3870, 3873, 3875, 3894, 3895, 3896, 3897, 3899, 3903, 3907, 3910, 3920, 3923, 3925, 3927, 3935, 3936, 3938, 3939, 3940, 4000, 4002, 4005, 4006, 4007, 4008, 4009, 4019, 4034, 4061, 4062, 4063, 4076, 4079, 4080, 4082, 4087, 4089}",1531
10,"(('exit', ('Request For Payment APPROVED by ADMINISTRATION', 'Request For Payment FINAL_APPROVED by SUPERVISOR')), ('enter', ('Request For Payment FINAL_APPROVED by SUPERVISOR', 'Request Payment')))",2,23,"{989, 1078, 1085, 1088, 1089, 1090, 1092, 1093, 1094, 1095, 1096, 1097, 1098, 1099, 1100, 1101, 1103, 1104, 1105, 1106, 1107, 1108, 1109, 1112, 1114, 1115, 1116, 1117, 1118, 1120, 1121, 1122, 1123, 1124, 1125, 1126, 1127, 1128, 1129, 1130, 1131, 1134, 1135, 1136, 1137, 1138, 1140, 1142, 1145, 1147, 1148, 1149, 1150, 1151, 1152, 1153, 1155, 1156, 1158, 1160, 1161, 1162, 1163, 1165, 1167, 1169, 1170, 1171, 1172, 1176, 1177, 1179, 1180, 1181, 1182, 1183, 1184, 1185, 1186, 1187, 1188, 1190, 1196, 1197, 1198, 1199, 1200, 1201, 1203, 1204, 1205, 1207, 1208, 1209, 1210, 1213, 1214, 1215, 1216, 1218, 1219, 1221, 1222, 1223, 1225, 1228, 1229, 1230, 1231, 1233, 1234, 1237, 1238, 1239, 1240, 1241, 1242, 1244, 1246, 1247, 1250, 1254, 1255, 1263, 1265, 1268, 1272, 1273, 1274, 1275, 1276, 1277, 1280, 1281, 1282, 1284, 1285, 1287, 1290, 1291, 1294, 1300, 1301, 1302, 1304, 1305, 1307, 1308, 1309, 1310, 1311, 1313, 1314, 1315, 1318, 1320, 1321, 1323, 1324, 1325, 1327, 1328, 1329, 1330, 1331, 1332, 1334, 1335, 1336, 1338, 1342, 1345, 1346, 1347, 1349, 1353, 1357, 1360, 1365, 1367, 1368, 1369, 1370, 1373, 1374, 1377, 1378, 1379, 1380, 1382, 1385, 1386, 1387, 1388, 1389, 1390, 1391, 1392, 1393, 1395, 1396, 1397, 1400, 1401, 1402, 1404, 1405, 1406, 1409, 1410, 1413, 1414, 1415, 1420, 1421, 1423, 1424, 1429, 1430, 1431, 1432, 1434, 1435, 1439, 1440, 1441, 1442, 1443, 1446, 1448, 1450, 1452, 1453, 1454, 1455, 1456, 1457, 1458, 1459, 1460, 1461, 1462, 1464, 1467, 1468, 1469, 1470, 1471, 1472, 1473, 1476, 1477, 1478, 1483, 1484, 1485, 1487, 1489, 1491, 1493, 1495, 1496, 1499, 1501, 1502, 1503, 1504, 1505, 1507, 1508, 1509, 1510, 1511, 1512, 1513, 1514, 1515, 1516, 1518, 1520, 1521, 1522, 1523, 1524, 1526, 1528, 1530, 1531, 1532, 1533, 1536, 1538, 1540, 1542, 1543, 1544, 1545, 1546, 1549, 1551, 1552, 1553, 1554, 1556, 1558, 1560, 1562, 1563, 1565, 1566, 1567, 1568, 1569, 1573, 1574, 1578, 1579, 1580, 1581, 1582, 1583, 1584, 1587, 1588, 1589, 1591, 1592, 1593, 1594, 1595, 1596, 1597, 1598, 1601, 1602, 1604, 1605, 1606, 1607, 1610, 1612, 1614, 1619, 1620, 1621, 1622, 1624, 1625, 1627, 1628, 1629, 1630, 1633, 1637, 1639, 1640, 1642, 1643, 1644, 1645, 1646, 1647, 1648, 1655, 1658, 1661, 1662, 1663, 1665, 1666, 1667, 1669, 1670, 1671, 1674, 1678, 1681, 1682, 1683, 1687, 1691, 1693, 1694, 1699, 1700, 1701, 1702, 1704, 1706, 1707, 1708, 1709, 1710, 1712, 1713, 1714, 1715, 1716, 1717, 1718, 1726, 1727, 1728, 1730, 1731, 1732, 1736, 1737, 1739, 1743, 1744, 1745, 1746, 1748, 1752, 1753, 1754, 1756, 1757, 1758, 1760, 1761, 1764, 1769, 1771, 1772, 1773, 1774, 1775, 1776, 1778, 1779, 1780, 1786, 1790, 1796, 1799, 1801, 1802, 1803, 1804, 1805, 1808, 1810, 1811, 1812, 1814, 1817, 1818, 1819, 1821, 1822, 1825, 1827, 1828, 1829, 1830, 1831, 1834, 1835, 1836, 1837, 1840, 1841, 1842, 1843, 1847, 1848, 1849, 1850, 1859, 1863, 1865, 1867, 1869, 1870, 1871, 1874, 1875, 1878, 1880, 1881, 1883, 1885, 1886, 1888, 1892, 1893, 1895, 1896, 1897, 1898, 1900, 1901, 1902, 1903, 1905, 1907, 1909, 1910, 1911, 1912, 1915, 1918, 1919, 1920, 1921, 1922, 1923, 1924, 1928, 1929, 1931, 1934, 1937, 1940, 1941, 1944, 1945, 1946, 1947, 1948, 1951, 1955, 1956, 1957, 1958, 1960, 1962, 1964, 1965, 1967, 1968, 1969, 1971, 1972, 1976, 1978, 1979, 1981, 1983, 1986, 1987, 1992, 1993, 1994, 1996, 1997, 1999, 2000, 2001, 2002, 2004, 2005, 2006, 2007, 2010, 2011, 2017, 2019, 2020, 2023, 2024, 2025, 2026, 2031, 2032, 2033, 2034, 2039, 2040, 2041, 2043, 2044, 2047, 2049, 2050, 2051, 2052, 2053, 2056, 2063, 2064, 2065, 2071, 2073, 2074, 2075, 2077, 2079, 2080, 2082, 2083, 2084, 2085, 2087, 2091, 2094, 2100, 2103, 2109, 2111, 2113, 2114, 2115, 2116, 2117, 2119, 2121, 2122, 2124, 2125, 2126, 2128, 2129, 2130, 2131, 2133, 2134, 2135, 2137, 2138, 2141, 2143, 2144, 2148, 2150, 2151, 2154, 2155, 2157, 2158, 2159, 2164, 2166, 2167, 2168, 2169, 2172, 2173, 2174, 2175, 2176, 2177, 2178, 2180, 2181, 2182, 2183, 2186, 2188, 2189, 2191, 2194, 2195, 2196, 2197, 2200, 2201, 2202, 2203, 2204, 2205, 2209, 2210, 2211, 2213, 2214, 2216, 2218, 2219, 2222, 2223, 2226, 2230, 2232, 2234, 2235, 2237, 2239, 2241, 2242, 2244, 2246, 2247, 2248, 2251, 2252, 2253, 2254, 2255, 2259, 2260, 2261, 2262, 2263, 2264, 2265, 2268, 2269, 2272, 2277, 2280, 2284, 2285, 2287, 2288, 2289, 2291, 2292, 2293, 2294, 2295, 2296, 2297, 2299, 2302, 2303, 2304, 2305, 2306, 2310, 2313, 2315, 2320, 2321, 2324, 2327, 2328, 2329, 2331, 2336, 2337, 2338, 2341, 2342, 2345, 2346, 2348, 2349, 2350, 2351, 2352, 2353, 2354, 2357, 2358, 2359, 2360, 2363, 2364, 2365, 2366, 2370, 2373, 2374, 2375, 2377, 2380, 2383, 2385, 2386, 2387, 2388, 2389, 2390, 2391, 2392, 2393, 2396, 2397, 2398, 2401, 2403, 2404, 2405, 2407, 2408, 2409, 2410, 2411, 2412, 2416, 2420, 2421, 2422, 2423, 2425, 2426, 2427, 2428, 2429, 2430, 2437, 2440, 2443, 2448, 2450, 2452, 2453, 2454, 2455, 2459, 2460, 2466, 2470, 2471, 2472, 2473, 2475, 2476, 2477, 2478, 2480, 2481, 2482, 2484, 2485, 2486, 2487, 2488, 2489, 2490, 2491, 2492, 2494, 2495, 2496, 2497, 2501, 2503, 2504, 2508, 2510, 2511, 2515, 2516, 2517, 2518, 2519, 2520, 2522, 2523, 2524, 2525, 2526, 2527, 2528, 2529, 2530, 2531, 2535, 2540, 2543, 2544, 2551, 2552, 2553, 2554, 2557, 2559, 2561, 2562, 2564, 2569, 2570, 2574, 2579, 2580, 2584, 2586, 2591, 2592, 2593, 2595, 2596, 2597, 2599, 2603, 2604, 2606, 2607, 2608, 2614, 2615, 2616, 2620, 2622, 2623, 2624, 2625, 2627, 2628, 2629, 2633, 2635, 2636, 2637, 2640, 2643, 2648, 2650, 2652, 2653, 2656, 2660, 2662, 2666, 2667, 2669, 2672, 2673, 2677, 2679, 2680, 2681, 2683, 2685, 2686, 2687, 2688, 2690, 2692, 2693, 2694, 2696, 2697, 2698, 2699, 2700, 2701, 2703, 2704, 2705, 2707, 2708, 2710, 2712, 2713, 2717, 2718, 2720, 2724, 2725, 2727, 2732, 2733, 2734, 2735, 2736, 2738, 2739, 2740, 2745, 2746, 2747, 2748, 2753, 2754, 2755, 2756, 2757, 2758, 2759, 2760, 2763, 2765, 2768, 2770, 2771, 2772, 2773, 2774, 2777, 2779, 2782, 2783, 2784, 2787, 2789, 2790, 2792, 2793, 2794, 2795, 2800, 2802, 2804, 2808, 2811, 2813, 2817, 2819, 2820, 2821, 2828, 2830, 2831, 2832, 2833, 2835, 2836, 2837, 2838, 2841, 2842, 2843, 2845, 2846, 2847, 2850, 2851, 2855, 2856, 2857, 2858, 2859, 2860, 2861, 2862, 2863, 2865, 2866, 2867, 2868, 2869, 2870, 2872, 2873, 2877, 2878, 2883, 2887, 2888, 2891, 2897, 2898, 2899, 2900, 2901, 2904, 2908, 2909, 2910, 2911, 2912, 2914, 2916, 2917, 2918, 2921, 2923, 2924, 2926, 2930, 2931, 2932, 2934, 2938, 2941, 2942, 2943, 2944, 2945, 2946, 2947, 2949, 2950, 2952, 2953, 2959, 2962, 2963, 2965, 2967, 2969, 2970, 2971, 2974, 2975, 2976, 2977, 2979, 2980, 2982, 2983, 2984, 2985, 2986, 2987, 2989, 2991, 2992, 2993, 2995, 2997, 2998, 2999, 3001, 3004, 3005, 3006, 3008, 3010, 3012, 3015, 3016, 3018, 3020, 3022, 3023, 3024, 3025, 3026, 3027, 3028, 3029, 3030, 3031, 3034, 3036, 3038, 3039, 3040, 3042, 3043, 3046, 3047, 3048, 3049, 3050, 3052, 3053, 3057, 3058, 3059, 3060, 3061, 3062, 3063, 3066, 3067, 3070, 3071, 3072, 3073, 3075, 3076, 3077, 3079, 3080, 3081, 3082, 3084, 3086, 3087, 3088, 3089, 3091, 3093, 3094, 3097, 3098, 3100, 3101, 3103, 3104, 3107, 3108, 3109, 3111, 3112, 3113, 3114, 3115, 3116, 3119, 3121, 3122, 3123, 3124, 3125, 3126, 3128, 3131, 3132, 3134, 3135, 3136, 3137, 3142, 3144, 3146, 3147, 3151, 3152, 3155, 3156, 3157, 3159, 3160, 3163, 3164, 3165, 3166, 3170, 3171, 3172, 3174, 3175, 3176, 3178, 3179, 3180, 3181, 3182, 3184, 3187, 3188, 3192, 3195, 3196, 3197, 3198, 3199, 3200, 3202, 3205, 3206, 3210, 3212, 3213, 3215, 3216, 3217, 3218, 3219, 3224, 3226, 3227, 3228, 3231, 3232, 3234, 3236, 3240, 3241, 3242, 3243, 3244, 3247, 3248, 3249, 3252, 3253, 3254, 3255, 3256, 3260, 3262, 3263, 3265, 3269, 3271, 3273, 3276, 3277, 3279, 3283, 3284, 3285, 3287, 3288, 3289, 3291, 3292, 3293, 3294, 3295, 3296, 3298, 3300, 3302, 3304, 3305, 3306, 3307, 3318, 3319, 3320, 3323, 3325, 3326, 3328, 3330, 3331, 3335, 3338, 3341, 3343, 3345, 3346, 3349, 3350, 3351, 3355, 3357, 3358, 3359, 3363, 3364, 3366, 3368, 3369, 3370, 3371, 3372, 3373, 3375, 3377, 3378, 3380, 3381, 3382, 3383, 3387, 3390, 3391, 3393, 3394, 3396, 3397, 3398, 3399, 3400, 3402, 3403, 3404, 3405, 3406, 3407, 3410, 3411, 3413, 3414, 3416, 3417, 3418, 3422, 3423, 3426, 3428, 3429, 3435, 3437, 3438, 3439, 3440, 3442, 3444, 3446, 3447, 3449, 3452, 3453, 3454, 3456, 3459, 3460, 3462, 3465, 3466, 3467, 3468, 3469, 3470, 3471, 3474, 3476, 3480, 3481, 3482, 3483, 3485, 3487, 3490, 3493, 3494, 3495, 3497, 3498, 3499, 3502, 3503, 3504, 3505, 3506, 3507, 3509, 3514, 3515, 3516, 3520, 3522, 3523, 3525, 3526, 3527, 3529, 3531, 3532, 3536, 3538, 3541, 3542, 3544, 3546, 3547, 3548, 3549, 3550, 3551, 3552, 3553, 3556, 3557, 3563, 3564, 3565, 3566, 3568, 3569, 3576, 3577, 3578, 3580, 3581, 3582, 3583, 3584, 3586, 3589, 3591, 3592, 3593, 3594, 3595, 3596, 3598, 3599, 3600, 3601, 3602, 3604, 3605, 3608, 3610, 3611, 3612, 3613, 3614, 3615, 3620, 3621, 3622, 3625, 3627, 3629, 3632, 3633, 3635, 3640, 3642, 3644, 3645, 3646, 3650, 3651, 3652, 3653, 3658, 3660, 3664, 3665, 3667, 3669, 3672, 3674, 3676, 3677, 3680, 3681, 3682, 3683, 3684, 3686, 3688, 3689, 3692, 3694, 3696, 3697, 3699, 3707, 3708, 3710, 3711, 3712, 3713, 3716, 3717, 3718, 3721, 3722, 3728, 3729, 3731, 3733, 3735, 3737, 3740, 3743, 3744, 3749, 3751, 3752, 3753, 3754, 3757, 3758, 3759, 3760, 3762, 3765, 3767, 3768, 3770, 3773, 3775, 3776, 3778, 3779, 3782, 3783, 3785, 3787, 3788, 3791, 3792, 3793, 3795, 3796, 3798, 3800, 3802, 3803, 3805, 3806, 3807, 3808, 3809, 3810, 3811, 3812, 3814, 3815, 3817, 3822, 3826, 3828, 3834, 3835, 3836, 3839, 3840, 3841, 3845, 3846, 3847, 3848, 3849, 3850, 3851, 3852, 3853, 3854, 3855, 3859, 3860, 3861, 3862, 3863, 3864, 3866, 3867, 3869, 3871, 3872, 3874, 3877, 3878, 3879, 3880, 3884, 3886, 3887, 3888, 3889, 3890, 3891, 3892, 3893, 3898, 3900, 3901, 3902, 3904, 3905, 3906, 3908, 3912, 3913, 3915, 3917, 3918, 3919, 3921, 3922, 3924, 3926, 3928, 3929, 3930, 3932, 3933, 3934, 3937, 3941, 3943, 3944, 3945, 3946, 3949, 3951, 3952, 3954, 3955, 3956, 3959, 3963, 3964, 3966, 3972, 3974, 3979, 3980, 3981, 3982, 3983, 3984, 3987, 3988, 3989, 3992, 3993, 3995, 3999, 4001, 4003, 4010, 4011, 4012, 4013, 4014, 4016, 4017, 4018, 4020, 4021, 4022, 4023, 4024, 4025, 4028, 4032, 4033, 4037, 4038, 4039, 4040, 4041, 4042, 4043, 4044, 4045, 4053, 4056, 4057, 4058, 4059, 4060, 4067, 4068, 4069, 4070, 4071, 4072, 4073, 4074, 4075, 4077, 4078, 4081, 4083, 4084, 4085, 4086, 4088, 4090, 4091, 4092, 4093, 4094, 4095, 4097, 4098, 4099, 4104, 4106, 4107, 4108, 4109, 4111, 4112, 4113, 4114, 4115, 4118, 4120, 4121, 4124, 4127, 4128, 4129, 4130, 4132, 4133, 4134, 4135, 4136, 4137, 4139, 4142, 4144, 4145, 4147, 4148, 4149, 4150, 4151, 4152, 4153, 4156, 4157, 4160, 4164, 4165, 4168, 4170, 4171, 4172, 4173, 4174, 4175, 4176, 4177, 4178, 4179, 4181, 4182, 4185, 4186, 4187, 4189, 4190, 4192, 4193, 4195, 4198, 4201, 4202, 4203, 4204, 4205, 4207, 4209, 4210, 4211, 4213, 4217, 4218, 4219, 4221, 4222, 4225, 4227, 4229, 4230, 4231, 4232, 4234, 4235, 4237, 4239, 4240, 4243, 4245, 4247, 4248, 4251, 4252, 4254, 4255, 4257, 4259, 4260, 4261, 4264, 4265, 4266, 4267, 4269, 4271, 4272, 4276, 4281, 4283, 4284, 4287, 4288, 4292, 4294, 4295, 4298, 4300, 4301, 4302, 4303, 4305, 4306, 4307, 4310, 4311, 4312, 4313, 4322, 4323, 4326, 4328, 4329, 4332, 4334, 4337, 4339, 4340, 4341, 4343, 4344, 4346, 4347, 4348, 4350, 4351, 4353, 4354, 4356, 4357, 4359, 4361, 4362, 4365, 4366, 4367, 4369, 4373, 4374, 4376, 4378, 4380, 4383, 4384, 4385, 4387, 4389, 4390, 4391, 4393, 4394, 4395, 4396, 4397, 4400, 4402, 4403, 4404, 4405, 4406, 4408, 4410, 4412, 4414, 4415, 4416, 4418, 4419, 4421, 4423, 4424, 4428, 4429, 4434, 4436, 4437, 4439, 4442, 4443, 4444, 4446, 4448, 4449, 4450, 4451, 4452, 4453, 4455, 4456, 4457, 4458, 4459, 4465, 4466, 4467, 4473, 4474, 4477, 4479, 4480, 4481, 4482, 4483, 4484, 4485, 4486, 4487, 4488, 4489, 4490, 4491, 4495, 4496, 4498, 4499, 4500, 4501, 4502, 4503, 4504, 4505, 4506, 4507, 4511, 4512, 4513, 4514, 4515, 4516, 4517, 4519, 4520, 4521, 4522, 4523, 4525, 4526, 4528, 4529, 4530, 4531, 4532, 4533, 4534, 4535, 4537, 4538, 4539, 4541, 4542, 4545, 4546, 4547, 4548, 4549, 4551, 4552, 4555, 4556, 4557, 4558, 4559, 4560, 4561, 4562, 4566, 4567, 4568, 4569, 4570, 4575, 4577, 4579, 4581, 4583, 4584, 4588, 4593, 4595, 4598, 4599, 4600, 4601, 4604, 4605, 4611, 4612, 4615, 4622, 4623, 4624, 4625, 4628, 4630, 4635, 4636, 4637, 4639, 4640, 4641, 4642, 4645, 4646, 4647, 4648, 4651, 4652, 4654, 4657, 4658, 4659, 4660, 4661, 4663, 4664, 4666, 4668, 4670, 4671, 4672, 4674, 4675, 4676, 4678, 4679, 4680, 4681, 4685, 4686, 4687, 4688, 4689, 4690, 4691, 4693, 4695, 4696, 4697, 4698, 4699, 4700, 4701, 4703, 4704, 4705, 4706, 4707, 4708, 4709, 4710, 4711, 4712, 4713, 4715, 4716, 4717, 4718, 4719, 4720, 4722, 4724, 4727, 4728, 4729, 4730, 4731, 4736, 4739, 4740, 4742, 4743, 4744, 4745, 4746, 4747, 4748, 4749, 4750, 4751, 4752, 4753, 4755, 4757, 4761, 4762, 4764, 4765, 4767, 4773, 4774, 4777, 4779, 4781, 4784, 4785, 4788, 4790, 4791, 4792, 4793, 4794, 4795, 4796, 4797, 4798, 4799, 4800, 4802, 4805, 4807, 4808, 4809, 4810, 4811, 4814, 4815, 4821, 4823, 4827, 4828, 4829, 4832, 4833, 4834, 4835, 4836, 4837, 4842, 4843, 4844, 4845, 4846, 4848, 4849, 4850, 4851, 4854, 4855, 4856, 4857, 4859, 4860, 4861, 4862, 4863, 4868, 4869, 4871, 4872, 4873, 4874, 4876, 4877, 4879, 4880, 4882, 4885, 4888, 4889, 4891, 4892, 4893, 4894, 4898, 4901, 4903, 4904, 4905, 4906, 4907, 4908, 4909, 4910, 4911, 4912, 4914, 4915, 4919, 4920, 4921, 4923, 4926, 4927, 4929, 4930, 4931, 4935, 4937, 4940, 4942, 4948, 4949, 4950, 4951, 4954, 4955, 4958, 4959, 4962, 4963, 4964, 4968, 4969, 4970, 4971, 4972, 4973, 4974, 4975, 4980, 4981, 4982, 4983, 4984, 4987, 4995, 4998, 5000, 5002, 5003, 5004, 5005, 5006, 5007, 5009, 5011, 5012, 5014, 5015, 5017, 5018, 5019, 5020, 5021, 5023, 5024, 5025, 5027, 5029, 5032, 5033, 5036, 5037, 5038, 5039, 5040, 5041, 5042, 5043, 5044, 5045, 5047, 5051, 5052, 5055, 5056, 5057, 5058, 5059, 5060, 5063, 5066, 5067, 5068, 5070, 5072, 5075, 5076, 5077, 5080, 5081, 5082, 5083, 5084, 5085, 5086, 5087, 5090, 5091, 5092, 5093, 5095, 5096, 5097, 5105, 5107, 5108, 5109, 5110, 5114, 5115, 5117, 5118, 5119, 5120, 5121, 5122, 5123, 5124, 5125, 5126, 5127, 5128, 5129, 5130, 5132, 5133, 5134, 5135, 5136, 5137, 5140, 5141, 5142, 5143, 5145, 5149, 5150, 5155, 5157, 5158, 5160, 5161, 5162, 5163, 5164, 5166, 5167, 5169, 5170, 5171, 5174, 5176, 5178, 5182, 5183, 5185, 5187, 5190, 5191, 5194, 5195, 5196, 5197, 5198, 5199, 5201, 5202, 5203, 5205, 5209, 5210, 5211, 5212, 5214, 5215, 5217, 5220, 5221, 5224, 5225, 5226, 5229, 5230, 5231, 5232, 5236, 5237, 5238, 5239, 5242, 5243, 5246, 5248, 5253, 5257, 5258, 5259, 5260, 5262, 5263, 5264, 5265, 5267, 5268, 5269, 5270, 5273, 5274, 5275, 5278, 5279, 5281, 5283, 5284, 5287, 5288, 5291, 5292, 5296, 5297, 5300, 5301, 5302, 5303, 5304, 5305, 5307, 5308, 5312, 5314, 5315, 5316, 5319, 5320, 5321, 5323, 5327, 5328, 5329, 5330, 5333, 5334, 5336, 5337, 5339, 5340, 5342, 5343, 5344, 5345, 5346, 5347, 5353, 5354, 5357, 5361, 5362, 5364, 5365, 5368, 5369, 5370, 5371, 5372, 5373, 5375, 5376, 5377, 5378, 5379, 5380, 5383, 5384, 5385, 5387, 5388, 5389, 5390, 5391, 5392, 5394, 5397, 5399, 5402, 5403, 5404, 5406, 5407, 5408, 5409, 5411, 5412, 5413, 5414, 5416, 5418, 5419, 5420, 5422, 5423, 5425, 5426, 5427, 5428, 5429, 5430, 5437, 5438, 5440, 5441, 5442, 5443, 5444, 5445, 5446, 5447, 5448, 5449, 5450, 5452, 5453, 5454, 5457, 5458, 5459, 5460, 5461, 5462, 5463, 5464, 5466, 5468, 5469, 5471, 5474, 5476, 5477, 5480, 5481, 5482, 5483, 5484, 5485, 5486, 5487, 5489, 5490, 5491, 5493, 5496, 5501, 5502, 5504, 5505, 5506, 5511, 5512, 5513, 5514, 5515, 5516, 5518, 5520, 5521, 5522, 5523, 5529, 5530, 5534, 5535, 5536, 5537, 5538, 5539, 5540, 5541, 5543, 5544, 5545, 5548, 5549, 5551, 5557, 5558, 5561, 5562, 5571, 5573, 5575, 5576, 5577, 5579, 5581, 5582, 5583, 5584, 5585, 5587, 5589, 5590, 5591, 5592, 5593, 5594, 5595, 5598, 5600, 5601, 5602, 5603, 5606, 5607, 5608, 5609, 5610, 5614, 5615, 5617, 5618, 5622, 5628, 5630, 5631, 5637, 5639, 5640, 5642, 5645, 5647, 5648, 5650, 5651, 5652, 5653, 5654, 5655, 5656, 5657, 5659, 5660, 5662, 5663, 5664, 5665, 5666, 5667, 5668, 5669, 5670, 5671, 5672, 5673, 5677, 5678, 5679, 5680, 5681, 5683, 5686, 5689, 5690, 5691, 5692, 5693, 5694, 5696, 5698, 5699, 5700, 5701, 5703, 5705, 5707, 5709, 5712, 5714, 5716, 5720, 5721, 5722, 5723, 5724, 5726, 5728, 5729, 5730, 5736, 5737, 5739, 5741, 5742, 5743, 5744, 5745, 5746, 5747, 5748, 5749, 5751, 5752, 5754, 5755, 5756, 5758, 5759, 5761, 5762, 5763, 5766, 5768, 5772, 5773, 5774, 5776, 5778, 5779, 5781, 5784, 5785, 5786, 5788, 5789, 5791, 5792, 5793, 5794, 5795, 5796, 5797, 5798, 5802, 5803, 5808, 5809, 5811, 5813, 5814, 5815, 5816, 5817, 5819, 5823, 5828, 5830, 5832, 5834, 5837, 5838, 5844, 5848, 5849, 5851, 5853, 5854, 5855, 5860, 5861, 5862, 5864, 5865, 5866, 5868, 5874, 5881, 5882, 5886, 5887, 5888, 5892, 5897, 5898, 5899, 5900, 5902, 5903, 5905, 5907, 5909, 5910, 5912, 5913, 5915, 5916, 5918, 5920, 5921, 5922, 5925, 5927, 5928, 5932, 5933, 5934, 5935, 5936, 5939, 5940, 5942, 5943, 5944, 5945, 5947, 5948, 5949, 5950, 5952, 5953, 5954, 5955, 5956, 5957, 5960, 5962, 5963, 5965, 5966, 5967, 5968, 5970, 5971, 5979, 5980, 5983, 5984, 5985, 5987, 5988, 5989, 5992, 5993, 5994, 5995, 5996, 5997, 5998, 6000, 6002, 6003, 6004, 6006, 6007, 6008, 6010, 6011, 6012, 6013, 6017, 6021, 6023, 6025, 6027, 6028, 6029, 6032, 6034, 6040, 6042, 6043, 6044, 6045, 6046, 6049, 6051, 6052, 6053, 6055, 6058, 6064, 6066, 6069, 6071, 6072, 6073, 6078, 6079, 6081, 6083, 6084, 6086, 6088, 6089, 6091, 6093, 6094, 6096, 6097, 6099, 6100, 6103, 6105, 6106, 6107, 6108, 6109, 6112, 6113, 6115, 6117, 6122, 6123, 6127, 6130, 6132, 6133, 6134, 6139, 6142, 6143, 6144, 6147, 6148, 6149, 6150, 6151, 6152, 6153, 6154, 6155, 6156, 6157, 6158, 6159, 6160, 6161, 6162, 6163, 6166, 6167, 6168, 6169, 6170, 6171, 6172, 6173, 6174, 6180, 6181, 6182, 6183, 6184, 6185, 6186, 6187, 6190, 6191, 6192, 6193, 6195, 6197, 6198, 6201, 6202, 6207, 6223, 6224, 6230, 6233, 6234, 6235, 6236, 6237, 6238, 6239, 6240, 6241, 6242, 6243, 6244, 6245, 6246, 6247, 6249, 6251, 6253, 6254, 6255, 6256, 6258, 6259, 6260, 6261, 6263, 6264, 6265, 6266, 6267, 6269, 6270, 6271, 6275, 6276, 6277, 6281, 6282, 6283, 6284, 6285, 6287, 6288, 6290, 6291, 6293, 6294, 6297, 6300, 6301, 6303, 6304, 6305, 6306, 6307, 6308, 6309, 6310, 6313, 6315, 6318, 6320, 6321, 6322, 6323, 6324, 6326, 6327, 6329, 6330, 6331, 6332, 6333, 6335, 6339, 6341, 6342, 6344, 6345, 6346, 6347, 6348, 6349, 6351, 6352, 6354, 6355, 6356, 6357, 6359, 6361, 6364, 6369, 6370, 6371, 6372, 6375, 6376, 6377, 6386, 6388, 6393, 6394, 6399, 6401, 6404, 6405, 6407, 6408, 6410, 6411, 6412, 6413, 6414, 6415, 6416, 6417, 6418, 6422, 6423, 6424, 6426, 6428, 6430, 6431, 6433, 6434, 6436, 6438, 6440, 6441, 6443, 6444, 6445, 6447, 6449, 6452, 6454, 6458, 6460, 6461, 6462, 6463, 6464, 6467, 6470, 6471, 6472, 6473, 6474, 6475, 6477, 6478, 6479, 6483, 6484, 6485, 6486, 6487, 6488, 6491, 6492, 6494, 6495, 6496, 6498, 6499, 6502, 6504, 6506, 6507, 6508, 6509, 6510, 6514, 6516, 6517, 6526, 6527, 6528, 6529, 6531, 6532, 6533, 6534, 6535, 6543, 6545, 6547, 6548, 6552, 6553, 6557, 6559, 6560, 6561, 6566, 6571, 6572, 6577, 6578, 6579, 6580, 6581, 6582, 6583, 6585, 6586, 6587, 6589, 6590, 6593, 6598, 6602, 6604, 6605, 6609, 6611, 6613, 6614, 6618, 6619, 6621, 6622, 6626, 6627, 6628, 6629, 6632, 6633, 6635, 6637, 6643, 6644, 6645, 6647, 6648, 6649, 6651, 6652, 6653, 6654, 6655, 6656, 6657, 6659, 6660, 6661, 6663, 6664, 6666, 6669, 6671, 6672, 6677, 6680, 6681, 6682, 6686, 6687, 6688, 6689, 6690, 6693, 6694, 6696, 6697, 6698, 6699, 6701, 6702, 6703, 6704, 6705, 6707, 6708, 6710, 6713, 6714, 6715, 6717, 6718, 6719, 6724, 6725, 6728, 6733, 6738, 6739, 6740, 6741, 6742, 6743, 6745, 6748, 6750, 6751, 6753, 6755, 6756, 6759, 6760, 6764, 6765, 6766, 6767, 6769, 6770, 6773, 6775, 6776, 6777, 6778, 6779, 6780, 6781, 6783, 6784, 6785, 6788, 6789, 6790, 6791}",3307,"{2051, 2053, 2056, 6158, 2064, 2065, 6161, 2071, 6167, 2073, 2074, 2075, 2077, 4130, 2084, 2085, 6180, 6187, 6223, 6233, 6245, 2150, 6247, 6251, 6266, 6269, 6270, 6271, 6275, 2181, 6281, 6282, 6283, 6284, 6287, 6288, 2197, 6294, 6297, 6300, 6301, 6303, 6305, 2210, 2211, 6306, 6308, 6309, 6310, 6313, 6315, 6320, 6321, 6322, 6323, 6324, 6326, 2232, 6330, 6333, 6341, 6345, 6346, 2252, 6349, 6354, 6355, 6356, 2269, 6375, 4332, 6386, 2302, 6399, 2304, 6407, 2313, 6414, 6415, 6416, 6417, 6423, 6424, 6426, 6428, 6431, 2336, 6436, 2342, 6438, 4393, 2349, 2350, 2351, 6445, 6449, 2354, 6452, 6458, 2366, 6462, 6464, 6463, 6467, 6471, 6472, 6475, 6477, 6478, 2385, 6484, 6485, 2391, 6491, 2397, 2409, 2411, 6510, 2416, 6514, 2420, 2421, 6526, 2437, 6534, 2440, 2443, 6548, 2453, 2460, 6557, 6559, 6561, 2466, 2475, 2476, 6571, 2478, 2480, 2481, 2482, 6579, 6578, 2484, 2485, 2486, 2487, 2488, 2489, 2490, 2491, 2492, 6581, 2494, 2495, 2496, 6585, 6589, 6590, 6593, 6598, 2503, 2504, 6602, 2508, 6605, 2511, 6609, 6611, 6613, 6614, 2517, 2523, 6619, 6621, 6622, 2527, 2528, 6628, 6629, 6637, 6645, 6648, 6649, 6651, 6652, 6653, 6655, 6656, 6657, 6659, 6664, 6666, 4622, 6671, 6672, 6680, 6681, 6682, 6686, 6687, 6688, 4640, 6696, 6697, 6698, 4654, 4657, 4663, 4664, 4676, 4680, 4687, 4701, 4703, 4705, 4706, 4708, 4709, 4710, 4711, 4712, 4713, 4715, 4716, 4717, 4719, 4727, 4729, 4739, 4740, 4747, 4764, 4767, 4773, 4774, 4779, 4784, 4785, 4829, 4833, 4835, 4836, 4844, 4848, 4859, 4861, 4872, 4876, 4893, 4903, 4904, 4906, 4911, 4919, 4920, 4923, 4926, 4929, 4935, 4937, 4949, 4964, 4968, 4970, 4972, 4973, 4974, 4975, 4980, 4982, 4984, 4998, 5002, 5003, 5004, 5005, 5006, 5007, 5012, 5014, 5017, 5018, 5019, 5025, 5027, 5032, 5036, 5037, 5038, 5039, 5040, 5041, 5042, 5043, 5044, 5045, 5051, 5058, 5067, 5072, 5075, 5077, 5080, 5081, 5082, 5083, 5085, 5086, 5087, 989, 5090, 5091, 5092, 5093, 5095, 5096, 5097, 5105, 5107, 5108, 5114, 5129, 5132, 5136, 5140, 5143, 5149, 5163, 5164, 5169, 5171, 5174, 5178, 5182, 5183, 5187, 5197, 5199, 5203, 5205, 5211, 5212, 1117, 5214, 5217, 5226, 5230, 5231, 5232, 1145, 1149, 5248, 1155, 1160, 1169, 1170, 5270, 5273, 1177, 5275, 1180, 1181, 1185, 1187, 5284, 1188, 1197, 1200, 1201, 1203, 1204, 1205, 1207, 1208, 1209, 1210, 1213, 1215, 5312, 1216, 5315, 1219, 1221, 1222, 5319, 1223, 1225, 5320, 5321, 1228, 3277, 1231, 5328, 5333, 5336, 5339, 5340, 5344, 5364, 5369, 5370, 5372, 5373, 5375, 5376, 5379, 5380, 5383, 5384, 5385, 5391, 5394, 1300, 5399, 1304, 1305, 5402, 5403, 5404, 1307, 1308, 5407, 1309, 5409, 1310, 5411, 1311, 1313, 5414, 1314, 1315, 1321, 5419, 1323, 1324, 1325, 1327, 1328, 1330, 5427, 1331, 1332, 5430, 1338, 3387, 5437, 5438, 1342, 1345, 5442, 1346, 5445, 1349, 5448, 5449, 1357, 5454, 5459, 5461, 5462, 5463, 5466, 5468, 5471, 5476, 5477, 5485, 5486, 5487, 5490, 5491, 3444, 5493, 3446, 5496, 5501, 3454, 5502, 3456, 1405, 5505, 1413, 3462, 5511, 5512, 3466, 3468, 5516, 5518, 3471, 5520, 5523, 5529, 3482, 3483, 3485, 1443, 3495, 5544, 5545, 3499, 3502, 3503, 5551, 3507, 3509, 5558, 3522, 1476, 3525, 3527, 3529, 5579, 3532, 1484, 5581, 1485, 3536, 1487, 3538, 1489, 5587, 1491, 3542, 5589, 5590, 1493, 3546, 1495, 5593, 5594, 3550, 3551, 5595, 1496, 1501, 1502, 5600, 1504, 1505, 5603, 1507, 1511, 5608, 5609, 5610, 5617, 5618, 1521, 5622, 5631, 1536, 1538, 5637, 5640, 5645, 5647, 5652, 5653, 5654, 5655, 5656, 5657, 1556, 5659, 5660, 1563, 1566, 5663, 5664, 5665, 5666, 5667, 5668, 5669, 1569, 5672, 1578, 1579, 5678, 5680, 5681, 1587, 1588, 5686, 1591, 5689, 1594, 5691, 5692, 5693, 5694, 1596, 1597, 1598, 5698, 1602, 5700, 1604, 1605, 1606, 1610, 1614, 3664, 1619, 5716, 1620, 1622, 1624, 1625, 1630, 3680, 1633, 3682, 3688, 1643, 1648, 1658, 3710, 1662, 1663, 1665, 1667, 3716, 3717, 1669, 1670, 1674, 1678, 3729, 1681, 1691, 3758, 3760, 3762, 3768, 3776, 3783, 1737, 3811, 3815, 1775, 3848, 3849, 3851, 3854, 3855, 3860, 3861, 3862, 3863, 3864, 1812, 3866, 3867, 1819, 3872, 3877, 3880, 3886, 3887, 3888, 3889, 3890, 3891, 3892, 1850, 3904, 1859, 3908, 3913, 3915, 1867, 3917, 3918, 1871, 1880, 1883, 1895, 1897, 1898, 1900, 1901, 1902, 1903, 1907, 1910, 1911, 1912, 1915, 6012, 1918, 1919, 1920, 1922, 1923, 1924, 6023, 1928, 1929, 1931, 1934, 6032, 1937, 1940, 1941, 1945, 1946, 6042, 6043, 1951, 6052, 6053, 1958, 6066, 6073, 6089, 1997, 1999, 2001, 6099, 6100, 2005, 2006, 6105, 6107, 6112, 2019, 6115, 6117, 2023, 6132, 2040, 2047}",735,"{1078, 1085, 1088, 1089, 1090, 1092, 1093, 1094, 1095, 1096, 1097, 1098, 1099, 1100, 1101, 1103, 1104, 1105, 1106, 1107, 1108, 1109, 1112, 1114, 1115, 1116, 1118, 1120, 1121, 1122, 1123, 1124, 1125, 1126, 1127, 1128, 1129, 1130, 1131, 1134, 1135, 1136, 1137, 1138, 1140, 1142, 1147, 1148, 1150, 1151, 1152, 1153, 1156, 1158, 1161, 1162, 1163, 1165, 1167, 1171, 1172, 1176, 1179, 1182, 1183, 1184, 1186, 1190, 1196, 1198, 1199, 1214, 1218, 1229, 1230, 1233, 1234, 1237, 1238, 1239, 1240, 1241, 1242, 1244, 1246, 1247, 1250, 1254, 1255, 1263, 1265, 1268, 1272, 1273, 1274, 1275, 1276, 1277, 1280, 1281, 1282, 1284, 1285, 1287, 1290, 1291, 1294, 1301, 1302, 1318, 1320, 1329, 1334, 1335, 1336, 1347, 1353, 1360, 1365, 1367, 1368, 1369, 1370, 1373, 1374, 1377, 1378, 1379, 1380, 1382, 1385, 1386, 1387, 1388, 1389, 1390, 1391, 1392, 1393, 1395, 1396, 1397, 1400, 1401, 1402, 1404, 1406, 1409, 1410, 1414, 1415, 1420, 1421, 1423, 1424, 1429, 1430, 1431, 1432, 1434, 1435, 1439, 1440, 1441, 1442, 1446, 1448, 1450, 1452, 1453, 1454, 1455, 1456, 1457, 1458, 1459, 1460, 1461, 1462, 1464, 1467, 1468, 1469, 1470, 1471, 1472, 1473, 1477, 1478, 1483, 1499, 1503, 1508, 1509, 1510, 1512, 1513, 1514, 1515, 1516, 1518, 1520, 1522, 1523, 1524, 1526, 1528, 1530, 1531, 1532, 1533, 1540, 1542, 1543, 1544, 1545, 1546, 1549, 1551, 1552, 1553, 1554, 1558, 1560, 1562, 1565, 1567, 1568, 1573, 1574, 1580, 1581, 1582, 1583, 1584, 1589, 1592, 1593, 1595, 1601, 1607, 1612, 1621, 1627, 1628, 1629, 1637, 1639, 1640, 1642, 1644, 1645, 1646, 1647, 1655, 1661, 1666, 1671, 1682, 1683, 1687, 1693, 1694, 1699, 1700, 1701, 1702, 1704, 1706, 1707, 1708, 1709, 1710, 1712, 1713, 1714, 1715, 1716, 1717, 1718, 1726, 1727, 1728, 1730, 1731, 1732, 1736, 1739, 1743, 1744, 1745, 1746, 1748, 1752, 1753, 1754, 1756, 1757, 1758, 1760, 1761, 1764, 1769, 1771, 1772, 1773, 1774, 1776, 1778, 1779, 1780, 1786, 1790, 1796, 1799, 1801, 1802, 1803, 1804, 1805, 1808, 1810, 1811, 1814, 1817, 1818, 1821, 1822, 1825, 1827, 1828, 1829, 1830, 1831, 1834, 1835, 1836, 1837, 1840, 1841, 1842, 1843, 1847, 1848, 1849, 1863, 1865, 1869, 1870, 1874, 1875, 1878, 1881, 1885, 1886, 1888, 1892, 1893, 1896, 1905, 1909, 1921, 1944, 1947, 1948, 1955, 1956, 1957, 1960, 1962, 1964, 1965, 1967, 1968, 1969, 1971, 1972, 1976, 1978, 1979, 1981, 1983, 1986, 1987, 1992, 1993, 1994, 1996, 2000, 2002, 2004, 2007, 2010, 2011, 2017, 2020, 2024, 2025, 2026, 2031, 2032, 2033, 2034, 2039, 2041, 2043, 2044, 2049, 2050, 2052, 2063, 2079, 2080, 2082, 2083, 2087, 2091, 2094, 2100, 2103, 2109, 2111, 2113, 2114, 2115, 2116, 2117, 2119, 2121, 2122, 2124, 2125, 2126, 2128, 2129, 2130, 2131, 2133, 2134, 2135, 2137, 2138, 2141, 2143, 2144, 2148, 2151, 2154, 2155, 2157, 2158, 2159, 2164, 2166, 2167, 2168, 2169, 2172, 2173, 2174, 2175, 2176, 2177, 2178, 2180, 2182, 2183, 2186, 2188, 2189, 2191, 2194, 2195, 2196, 2200, 2201, 2202, 2203, 2204, 2205, 2209, 2213, 2214, 2216, 2218, 2219, 2222, 2223, 2226, 2230, 2234, 2235, 2237, 2239, 2241, 2242, 2244, 2246, 2247, 2248, 2251, 2253, 2254, 2255, 2259, 2260, 2261, 2262, 2263, 2264, 2265, 2268, 2272, 2277, 2280, 2284, 2285, 2287, 2288, 2289, 2291, 2292, 2293, 2294, 2295, 2296, 2297, 2299, 2303, 2305, 2306, 2310, 2315, 2320, 2321, 2324, 2327, 2328, 2329, 2331, 2337, 2338, 2341, 2345, 2346, 2348, 2352, 2353, 2357, 2358, 2359, 2360, 2363, 2364, 2365, 2370, 2373, 2374, 2375, 2377, 2380, 2383, 2386, 2387, 2388, 2389, 2390, 2392, 2393, 2396, 2398, 2401, 2403, 2404, 2405, 2407, 2408, 2410, 2412, 2422, 2423, 2425, 2426, 2427, 2428, 2429, 2430, 2448, 2450, 2452, 2454, 2455, 2459, 2470, 2471, 2472, 2473, 2477, 2497, 2501, 2510, 2515, 2516, 2518, 2519, 2520, 2522, 2524, 2525, 2526, 2529, 2530, 2531, 2535, 2540, 2543, 2544, 2551, 2552, 2553, 2554, 2557, 2559, 2561, 2562, 2564, 2569, 2570, 2574, 2579, 2580, 2584, 2586, 2591, 2592, 2593, 2595, 2596, 2597, 2599, 2603, 2604, 2606, 2607, 2608, 2614, 2615, 2616, 2620, 2622, 2623, 2624, 2625, 2627, 2628, 2629, 2633, 2635, 2636, 2637, 2640, 2643, 2648, 2650, 2652, 2653, 2656, 2660, 2662, 2666, 2667, 2669, 2672, 2673, 2677, 2679, 2680, 2681, 2683, 2685, 2686, 2687, 2688, 2690, 2692, 2693, 2694, 2696, 2697, 2698, 2699, 2700, 2701, 2703, 2704, 2705, 2707, 2708, 2710, 2712, 2713, 2717, 2718, 2720, 2724, 2725, 2727, 2732, 2733, 2734, 2735, 2736, 2738, 2739, 2740, 2745, 2746, 2747, 2748, 2753, 2754, 2755, 2756, 2757, 2758, 2759, 2760, 2763, 2765, 2768, 2770, 2771, 2772, 2773, 2774, 2777, 2779, 2782, 2783, 2784, 2787, 2789, 2790, 2792, 2793, 2794, 2795, 2800, 2802, 2804, 2808, 2811, 2813, 2817, 2819, 2820, 2821, 2828, 2830, 2831, 2832, 2833, 2835, 2836, 2837, 2838, 2841, 2842, 2843, 2845, 2846, 2847, 2850, 2851, 2855, 2856, 2857, 2858, 2859, 2860, 2861, 2862, 2863, 2865, 2866, 2867, 2868, 2869, 2870, 2872, 2873, 2877, 2878, 2883, 2887, 2888, 2891, 2897, 2898, 2899, 2900, 2901, 2904, 2908, 2909, 2910, 2911, 2912, 2914, 2916, 2917, 2918, 2921, 2923, 2924, 2926, 2930, 2931, 2932, 2934, 2938, 2941, 2942, 2943, 2944, 2945, 2946, 2947, 2949, 2950, 2952, 2953, 2959, 2962, 2963, 2965, 2967, 2969, 2970, 2971, 2974, 2975, 2976, 2977, 2979, 2980, 2982, 2983, 2984, 2985, 2986, 2987, 2989, 2991, 2992, 2993, 2995, 2997, 2998, 2999, 3001, 3004, 3005, 3006, 3008, 3010, 3012, 3015, 3016, 3018, 3020, 3022, 3023, 3024, 3025, 3026, 3027, 3028, 3029, 3030, 3031, 3034, 3036, 3038, 3039, 3040, 3042, 3043, 3046, 3047, 3048, 3049, 3050, 3052, 3053, 3057, 3058, 3059, 3060, 3061, 3062, 3063, 3066, 3067, 3070, 3071, 3072, 3073, 3075, 3076, 3077, 3079, 3080, 3081, 3082, 3084, 3086, 3087, 3088, 3089, 3091, 3093, 3094, 3097, 3098, 3100, 3101, 3103, 3104, 3107, 3108, 3109, 3111, 3112, 3113, 3114, 3115, 3116, 3119, 3121, 3122, 3123, 3124, 3125, 3126, 3128, 3131, 3132, 3134, 3135, 3136, 3137, 3142, 3144, 3146, 3147, 3151, 3152, 3155, 3156, 3157, 3159, 3160, 3163, 3164, 3165, 3166, 3170, 3171, 3172, 3174, 3175, 3176, 3178, 3179, 3180, 3181, 3182, 3184, 3187, 3188, 3192, 3195, 3196, 3197, 3198, 3199, 3200, 3202, 3205, 3206, 3210, 3212, 3213, 3215, 3216, 3217, 3218, 3219, 3224, 3226, 3227, 3228, 3231, 3232, 3234, 3236, 3240, 3241, 3242, 3243, 3244, 3247, 3248, 3249, 3252, 3253, 3254, 3255, 3256, 3260, 3262, 3263, 3265, 3269, 3271, 3273, 3276, 3279, 3283, 3284, 3285, 3287, 3288, 3289, 3291, 3292, 3293, 3294, 3295, 3296, 3298, 3300, 3302, 3304, 3305, 3306, 3307, 3318, 3319, 3320, 3323, 3325, 3326, 3328, 3330, 3331, 3335, 3338, 3341, 3343, 3345, 3346, 3349, 3350, 3351, 3355, 3357, 3358, 3359, 3363, 3364, 3366, 3368, 3369, 3370, 3371, 3372, 3373, 3375, 3377, 3378, 3380, 3381, 3382, 3383, 3390, 3391, 3393, 3394, 3396, 3397, 3398, 3399, 3400, 3402, 3403, 3404, 3405, 3406, 3407, 3410, 3411, 3413, 3414, 3416, 3417, 3418, 3422, 3423, 3426, 3428, 3429, 3435, 3437, 3438, 3439, 3440, 3442, 3447, 3449, 3452, 3453, 3459, 3460, 3465, 3467, 3469, 3470, 3474, 3476, 3480, 3481, 3487, 3490, 3493, 3494, 3497, 3498, 3504, 3505, 3506, 3514, 3515, 3516, 3520, 3523, 3526, 3531, 3541, 3544, 3547, 3548, 3549, 3552, 3553, 3556, 3557, 3563, 3564, 3565, 3566, 3568, 3569, 3576, 3577, 3578, 3580, 3581, 3582, 3583, 3584, 3586, 3589, 3591, 3592, 3593, 3594, 3595, 3596, 3598, 3599, 3600, 3601, 3602, 3604, 3605, 3608, 3610, 3611, 3612, 3613, 3614, 3615, 3620, 3621, 3622, 3625, 3627, 3629, 3632, 3633, 3635, 3640, 3642, 3644, 3645, 3646, 3650, 3651, 3652, 3653, 3658, 3660, 3665, 3667, 3669, 3672, 3674, 3676, 3677, 3681, 3683, 3684, 3686, 3689, 3692, 3694, 3696, 3697, 3699, 3707, 3708, 3711, 3712, 3713, 3718, 3721, 3722, 3728, 3731, 3733, 3735, 3737, 3740, 3743, 3744, 3749, 3751, 3752, 3753, 3754, 3757, 3759, 3765, 3767, 3770, 3773, 3775, 3778, 3779, 3782, 3785, 3787, 3788, 3791, 3792, 3793, 3795, 3796, 3798, 3800, 3802, 3803, 3805, 3806, 3807, 3808, 3809, 3810, 3812, 3814, 3817, 3822, 3826, 3828, 3834, 3835, 3836, 3839, 3840, 3841, 3845, 3846, 3847, 3850, 3852, 3853, 3859, 3869, 3871, 3874, 3878, 3879, 3884, 3893, 3898, 3900, 3901, 3902, 3905, 3906, 3912, 3919, 3921, 3922, 3924, 3926, 3928, 3929, 3930, 3932, 3933, 3934, 3937, 3941, 3943, 3944, 3945, 3946, 3949, 3951, 3952, 3954, 3955, 3956, 3959, 3963, 3964, 3966, 3972, 3974, 3979, 3980, 3981, 3982, 3983, 3984, 3987, 3988, 3989, 3992, 3993, 3995, 3999, 4001, 4003, 4010, 4011, 4012, 4013, 4014, 4016, 4017, 4018, 4020, 4021, 4022, 4023, 4024, 4025, 4028, 4032, 4033, 4037, 4038, 4039, 4040, 4041, 4042, 4043, 4044, 4045, 4053, 4056, 4057, 4058, 4059, 4060, 4067, 4068, 4069, 4070, 4071, 4072, 4073, 4074, 4075, 4077, 4078, 4081, 4083, 4084, 4085, 4086, 4088, 4090, 4091, 4092, 4093, 4094, 4095, 4097, 4098, 4099, 4104, 4106, 4107, 4108, 4109, 4111, 4112, 4113, 4114, 4115, 4118, 4120, 4121, 4124, 4127, 4128, 4129, 4132, 4133, 4134, 4135, 4136, 4137, 4139, 4142, 4144, 4145, 4147, 4148, 4149, 4150, 4151, 4152, 4153, 4156, 4157, 4160, 4164, 4165, 4168, 4170, 4171, 4172, 4173, 4174, 4175, 4176, 4177, 4178, 4179, 4181, 4182, 4185, 4186, 4187, 4189, 4190, 4192, 4193, 4195, 4198, 4201, 4202, 4203, 4204, 4205, 4207, 4209, 4210, 4211, 4213, 4217, 4218, 4219, 4221, 4222, 4225, 4227, 4229, 4230, 4231, 4232, 4234, 4235, 4237, 4239, 4240, 4243, 4245, 4247, 4248, 4251, 4252, 4254, 4255, 4257, 4259, 4260, 4261, 4264, 4265, 4266, 4267, 4269, 4271, 4272, 4276, 4281, 4283, 4284, 4287, 4288, 4292, 4294, 4295, 4298, 4300, 4301, 4302, 4303, 4305, 4306, 4307, 4310, 4311, 4312, 4313, 4322, 4323, 4326, 4328, 4329, 4334, 4337, 4339, 4340, 4341, 4343, 4344, 4346, 4347, 4348, 4350, 4351, 4353, 4354, 4356, 4357, 4359, 4361, 4362, 4365, 4366, 4367, 4369, 4373, 4374, 4376, 4378, 4380, 4383, 4384, 4385, 4387, 4389, 4390, 4391, 4394, 4395, 4396, 4397, 4400, 4402, 4403, 4404, 4405, 4406, 4408, 4410, 4412, 4414, 4415, 4416, 4418, 4419, 4421, 4423, 4424, 4428, 4429, 4434, 4436, 4437, 4439, 4442, 4443, 4444, 4446, 4448, 4449, 4450, 4451, 4452, 4453, 4455, 4456, 4457, 4458, 4459, 4465, 4466, 4467, 4473, 4474, 4477, 4479, 4480, 4481, 4482, 4483, 4484, 4485, 4486, 4487, 4488, 4489, 4490, 4491, 4495, 4496, 4498, 4499, 4500, 4501, 4502, 4503, 4504, 4505, 4506, 4507, 4511, 4512, 4513, 4514, 4515, 4516, 4517, 4519, 4520, 4521, 4522, 4523, 4525, 4526, 4528, 4529, 4530, 4531, 4532, 4533, 4534, 4535, 4537, 4538, 4539, 4541, 4542, 4545, 4546, 4547, 4548, 4549, 4551, 4552, 4555, 4556, 4557, 4558, 4559, 4560, 4561, 4562, 4566, 4567, 4568, 4569, 4570, 4575, 4577, 4579, 4581, 4583, 4584, 4588, 4593, 4595, 4598, 4599, 4600, 4601, 4604, 4605, 4611, 4612, 4615, 4623, 4624, 4625, 4628, 4630, 4635, 4636, 4637, 4639, 4641, 4642, 4645, 4646, 4647, 4648, 4651, 4652, 4658, 4659, 4660, 4661, 4666, 4668, 4670, 4671, 4672, 4674, 4675, 4678, 4679, 4681, 4685, 4686, 4688, 4689, 4690, 4691, 4693, 4695, 4696, 4697, 4698, 4699, 4700, 4704, 4707, 4718, 4720, 4722, 4724, 4728, 4730, 4731, 4736, 4742, 4743, 4744, 4745, 4746, 4748, 4749, 4750, 4751, 4752, 4753, 4755, 4757, 4761, 4762, 4765, 4777, 4781, 4788, 4790, 4791, 4792, 4793, 4794, 4795, 4796, 4797, 4798, 4799, 4800, 4802, 4805, 4807, 4808, 4809, 4810, 4811, 4814, 4815, 4821, 4823, 4827, 4828, 4832, 4834, 4837, 4842, 4843, 4845, 4846, 4849, 4850, 4851, 4854, 4855, 4856, 4857, 4860, 4862, 4863, 4868, 4869, 4871, 4873, 4874, 4877, 4879, 4880, 4882, 4885, 4888, 4889, 4891, 4892, 4894, 4898, 4901, 4905, 4907, 4908, 4909, 4910, 4912, 4914, 4915, 4921, 4927, 4930, 4931, 4940, 4942, 4948, 4950, 4951, 4954, 4955, 4958, 4959, 4962, 4963, 4969, 4971, 4981, 4983, 4987, 4995, 5000, 5009, 5011, 5015, 5020, 5021, 5023, 5024, 5029, 5033, 5047, 5052, 5055, 5056, 5057, 5059, 5060, 5063, 5066, 5068, 5070, 5076, 5084, 5109, 5110, 5115, 5117, 5118, 5119, 5120, 5121, 5122, 5123, 5124, 5125, 5126, 5127, 5128, 5130, 5133, 5134, 5135, 5137, 5141, 5142, 5145, 5150, 5155, 5157, 5158, 5160, 5161, 5162, 5166, 5167, 5170, 5176, 5185, 5190, 5191, 5194, 5195, 5196, 5198, 5201, 5202, 5209, 5210, 5215, 5220, 5221, 5224, 5225, 5229, 5236, 5237, 5238, 5239, 5242, 5243, 5246, 5253, 5257, 5258, 5259, 5260, 5262, 5263, 5264, 5265, 5267, 5268, 5269, 5274, 5278, 5279, 5281, 5283, 5287, 5288, 5291, 5292, 5296, 5297, 5300, 5301, 5302, 5303, 5304, 5305, 5307, 5308, 5314, 5316, 5323, 5327, 5329, 5330, 5334, 5337, 5342, 5343, 5345, 5346, 5347, 5353, 5354, 5357, 5361, 5362, 5365, 5368, 5371, 5377, 5378, 5387, 5388, 5389, 5390, 5392, 5397, 5406, 5408, 5412, 5413, 5416, 5418, 5420, 5422, 5423, 5425, 5426, 5428, 5429, 5440, 5441, 5443, 5444, 5446, 5447, 5450, 5452, 5453, 5457, 5458, 5460, 5464, 5469, 5474, 5480, 5481, 5482, 5483, 5484, 5489, 5504, 5506, 5513, 5514, 5515, 5521, 5522, 5530, 5534, 5535, 5536, 5537, 5538, 5539, 5540, 5541, 5543, 5548, 5549, 5557, 5561, 5562, 5571, 5573, 5575, 5576, 5577, 5582, 5583, 5584, 5585, 5591, 5592, 5598, 5601, 5602, 5606, 5607, 5614, 5615, 5628, 5630, 5639, 5642, 5648, 5650, 5651, 5662, 5670, 5671, 5673, 5677, 5679, 5683, 5690, 5696, 5699, 5701, 5703, 5705, 5707, 5709, 5712, 5714, 5720, 5721, 5722, 5723, 5724, 5726, 5728, 5729, 5730, 5736, 5737, 5739, 5741, 5742, 5743, 5744, 5745, 5746, 5747, 5748, 5749, 5751, 5752, 5754, 5755, 5756, 5758, 5759, 5761, 5762, 5763, 5766, 5768, 5772, 5773, 5774, 5776, 5778, 5779, 5781, 5784, 5785, 5786, 5788, 5789, 5791, 5792, 5793, 5794, 5795, 5796, 5797, 5798, 5802, 5803, 5808, 5809, 5811, 5813, 5814, 5815, 5816, 5817, 5819, 5823, 5828, 5830, 5832, 5834, 5837, 5838, 5844, 5848, 5849, 5851, 5853, 5854, 5855, 5860, 5861, 5862, 5864, 5865, 5866, 5868, 5874, 5881, 5882, 5886, 5887, 5888, 5892, 5897, 5898, 5899, 5900, 5902, 5903, 5905, 5907, 5909, 5910, 5912, 5913, 5915, 5916, 5918, 5920, 5921, 5922, 5925, 5927, 5928, 5932, 5933, 5934, 5935, 5936, 5939, 5940, 5942, 5943, 5944, 5945, 5947, 5948, 5949, 5950, 5952, 5953, 5954, 5955, 5956, 5957, 5960, 5962, 5963, 5965, 5966, 5967, 5968, 5970, 5971, 5979, 5980, 5983, 5984, 5985, 5987, 5988, 5989, 5992, 5993, 5994, 5995, 5996, 5997, 5998, 6000, 6002, 6003, 6004, 6006, 6007, 6008, 6010, 6011, 6013, 6017, 6021, 6025, 6027, 6028, 6029, 6034, 6040, 6044, 6045, 6046, 6049, 6051, 6055, 6058, 6064, 6069, 6071, 6072, 6078, 6079, 6081, 6083, 6084, 6086, 6088, 6091, 6093, 6094, 6096, 6097, 6103, 6106, 6108, 6109, 6113, 6122, 6123, 6127, 6130, 6133, 6134, 6139, 6142, 6143, 6144, 6147, 6148, 6149, 6150, 6151, 6152, 6153, 6154, 6155, 6156, 6157, 6159, 6160, 6162, 6163, 6166, 6168, 6169, 6170, 6171, 6172, 6173, 6174, 6181, 6182, 6183, 6184, 6185, 6186, 6190, 6191, 6192, 6193, 6195, 6197, 6198, 6201, 6202, 6207, 6224, 6230, 6234, 6235, 6236, 6237, 6238, 6239, 6240, 6241, 6242, 6243, 6244, 6246, 6249, 6253, 6254, 6255, 6256, 6258, 6259, 6260, 6261, 6263, 6264, 6265, 6267, 6276, 6277, 6285, 6290, 6291, 6293, 6304, 6307, 6318, 6327, 6329, 6331, 6332, 6335, 6339, 6342, 6344, 6347, 6348, 6351, 6352, 6357, 6359, 6361, 6364, 6369, 6370, 6371, 6372, 6376, 6377, 6388, 6393, 6394, 6401, 6404, 6405, 6408, 6410, 6411, 6412, 6413, 6418, 6422, 6430, 6433, 6434, 6440, 6441, 6443, 6444, 6447, 6454, 6460, 6461, 6470, 6473, 6474, 6479, 6483, 6486, 6487, 6488, 6492, 6494, 6495, 6496, 6498, 6499, 6502, 6504, 6506, 6507, 6508, 6509, 6516, 6517, 6527, 6528, 6529, 6531, 6532, 6533, 6535, 6543, 6545, 6547, 6552, 6553, 6560, 6566, 6572, 6577, 6580, 6582, 6583, 6586, 6587, 6604, 6618, 6626, 6627, 6632, 6633, 6635, 6643, 6644, 6647, 6654, 6660, 6661, 6663, 6669, 6677, 6689, 6690, 6693, 6694, 6699, 6701, 6702, 6703, 6704, 6705, 6707, 6708, 6710, 6713, 6714, 6715, 6717, 6718, 6719, 6724, 6725, 6728, 6733, 6738, 6739, 6740, 6741, 6742, 6743, 6745, 6748, 6750, 6751, 6753, 6755, 6756, 6759, 6760, 6764, 6765, 6766, 6767, 6769, 6770, 6773, 6775, 6776, 6777, 6778, 6779, 6780, 6781, 6783, 6784, 6785, 6788, 6789, 6790, 6791}",2572
11,"(('exit', ('Request For Payment FINAL_APPROVED by SUPERVISOR', 'Request Payment')), ('exit', ('Request Payment', 'Payment Handled')))",2,11,"{0, 1, 2, 3, 4, 5, 6, 7, 8, 9, 10, 11, 12, 14, 15, 16, 17, 18, 20, 21, 22, 23, 24, 25, 27, 28, 29, 30, 31, 32, 33, 34, 35, 36, 37, 38, 39, 42, 43, 44, 45, 46, 47, 48, 49, 50, 51, 52, 53, 54, 55, 56, 57, 58, 59, 60, 61, 62, 64, 65, 66, 67, 68, 69, 70, 71, 72, 73, 74, 75, 78, 79, 80, 81, 83, 84, 85, 86, 88, 89, 90, 91, 92, 93, 94, 95, 96, 97, 98, 99, 100, 101, 102, 103, 104, 105, 106, 107, 108, 109, 110, 111, 112, 113, 114, 116, 118, 123, 124, 125, 126, 127, 128, 129, 130, 131, 132, 133, 134, 135, 136, 137, 138, 139, 140, 141, 143, 144, 145, 146, 147, 148, 149, 150, 151, 153, 154, 155, 156, 158, 159, 160, 161, 162, 163, 164, 165, 166, 167, 168, 169, 171, 172, 175, 176, 179, 180, 181, 182, 183, 184, 185, 186, 187, 188, 189, 190, 191, 192, 193, 194, 195, 196, 198, 199, 200, 201, 202, 203, 204, 205, 206, 207, 208, 209, 210, 211, 212, 213, 214, 215, 216, 217, 218, 219, 220, 221, 222, 223, 224, 225, 226, 227, 228, 229, 230, 231, 232, 234, 235, 236, 237, 238, 239, 240, 241, 242, 243, 244, 245, 246, 247, 248, 249, 250, 251, 252, 253, 254, 256, 257, 258, 259, 260, 261, 262, 263, 264, 265, 266, 267, 268, 269, 271, 272, 273, 274, 275, 276, 277, 278, 279, 280, 281, 282, 283, 284, 285, 286, 287, 288, 289, 290, 291, 292, 293, 294, 295, 296, 297, 298, 300, 301, 302, 303, 305, 307, 310, 311, 312, 313, 314, 315, 316, 317, 318, 321, 322, 323, 324, 325, 326, 327, 331, 332, 333, 334, 335, 336, 337, 338, 339, 340, 341, 342, 343, 344, 345, 346, 348, 349, 350, 351, 352, 353, 356, 357, 358, 359, 360, 361, 362, 363, 364, 365, 366, 367, 368, 369, 370, 372, 373, 375, 376, 377, 378, 379, 380, 382, 383, 384, 385, 386, 387, 388, 389, 390, 391, 392, 393, 394, 395, 396, 397, 398, 399, 400, 401, 402, 403, 404, 405, 406, 407, 408, 409, 410, 411, 414, 415, 416, 417, 418, 419, 420, 421, 422, 423, 424, 425, 426, 427, 428, 429, 430, 431, 433, 434, 435, 436, 437, 438, 439, 440, 441, 443, 444, 445, 446, 447, 449, 450, 451, 452, 453, 454, 456, 457, 458, 459, 460, 461, 462, 463, 464, 466, 467, 468, 469, 470, 471, 473, 474, 475, 476, 477, 478, 479, 481, 482, 483, 484, 486, 487, 488, 489, 490, 491, 492, 493, 494, 495, 496, 497, 498, 499, 500, 501, 502, 503, 504, 505, 506, 508, 509, 510, 511, 512, 513, 514, 515, 516, 518, 519, 520, 521, 522, 523, 524, 525, 526, 527, 528, 530, 531, 533, 534, 535, 536, 537, 538, 539, 540, 541, 542, 543, 544, 545, 546, 547, 548, 549, 550, 551, 552, 553, 554, 555, 556, 557, 558, 559, 560, 561, 562, 563, 565, 566, 567, 568, 569, 570, 571, 572, 573, 574, 575, 576, 577, 578, 580, 582, 583, 584, 585, 586, 590, 591, 593, 594, 596, 597, 598, 599, 600, 601, 602, 603, 604, 605, 606, 607, 608, 610, 611, 612, 613, 614, 616, 617, 618, 620, 621, 622, 623, 624, 625, 626, 627, 628, 629, 631, 632, 633, 634, 635, 636, 637, 638, 639, 640, 641, 642, 643, 644, 645, 646, 647, 648, 649, 650, 651, 652, 653, 654, 655, 656, 657, 658, 659, 660, 661, 662, 663, 664, 665, 666, 667, 668, 669, 670, 671, 672, 673, 674, 675, 676, 677, 678, 679, 680, 681, 682, 683, 684, 685, 686, 687, 688, 689, 690, 693, 695, 696, 697, 698, 699, 700, 701, 702, 703, 704, 705, 706, 707, 708, 709, 710, 711, 712, 713, 714, 715, 716, 717, 718, 719, 720, 721, 722, 723, 724, 725, 726, 727, 728, 729, 730, 731, 732, 733, 734, 735, 736, 737, 738, 739, 740, 741, 742, 743, 744, 745, 746, 748, 749, 750, 751, 752, 753, 754, 755, 756, 757, 758, 759, 760, 761, 762, 763, 764, 765, 766, 767, 768, 769, 770, 771, 773, 774, 775, 776, 777, 778, 779, 780, 781, 782, 783, 784, 785, 786, 787, 788, 789, 790, 791, 792, 794, 795, 796, 797, 798, 799, 800, 801, 802, 803, 804, 805, 806, 807, 808, 809, 810, 811, 812, 813, 814, 815, 816, 817, 819, 820, 821, 824, 825, 826, 828, 829, 830, 831, 832, 833, 834, 835, 836, 837, 838, 839, 840, 841, 842, 843, 844, 845, 846, 847, 848, 849, 850, 851, 852, 854, 855, 856, 857, 858, 859, 860, 861, 862, 864, 865, 866, 867, 868, 869, 870, 871, 872, 873, 874, 875, 876, 877, 878, 879, 880, 881, 882, 883, 884, 885, 886, 887, 888, 889, 890, 891, 892, 893, 894, 895, 896, 897, 898, 899, 900, 901, 902, 903, 904, 905, 906, 907, 908, 909, 910, 911, 912, 913, 914, 915, 916, 917, 918, 919, 920, 921, 922, 923, 924, 925, 926, 927, 928, 929, 930, 931, 932, 933, 935, 936, 937, 939, 940, 941, 942, 943, 944, 945, 946, 947, 948, 949, 950, 951, 952, 953, 954, 955, 956, 957, 958, 959, 960, 961, 962, 963, 964, 965, 966, 967, 968, 969, 970, 971, 972, 973, 974, 975, 976, 977, 978, 979, 980, 981, 982, 983, 984, 985, 986, 987, 988, 989, 990, 991, 992, 993, 994, 996, 997, 999, 1000, 1001, 1002, 1003, 1004, 1005, 1006, 1007, 1008, 1009, 1010, 1011, 1012, 1013, 1014, 1015, 1016, 1017, 1018, 1019, 1020, 1021, 1022, 1023, 1024, 1025, 1026, 1028, 1029, 1030, 1031, 1032, 1033, 1034, 1036, 1037, 1038, 1039, 1040, 1041, 1042, 1043, 1044, 1045, 1046, 1047, 1048, 1050, 1051, 1052, 1053, 1054, 1055, 1056, 1057, 1058, 1059, 1060, 1061, 1063, 1064, 1065, 1066, 1067, 1069, 1070, 1071, 1073, 1074, 1075, 1076, 1077, 1078, 1079, 1080, 1081, 1082, 1083, 1085, 1086, 1087, 1088, 1089, 1090, 1092, 1093, 1094, 1095, 1096, 1097, 1098, 1099, 1100, 1101, 1103, 1104, 1105, 1106, 1107, 1108, 1109, 1110, 1111, 1112, 1113, 1114, 1115, 1116, 1117, 1118, 1119, 1120, 1121, 1122, 1123, 1124, 1125, 1126, 1127, 1128, 1129, 1130, 1131, 1132, 1133, 1134, 1135, 1136, 1137, 1138, 1140, 1141, 1142, 1143, 1144, 1145, 1146, 1147, 1148, 1149, 1150, 1151, 1152, 1153, 1154, 1155, 1156, 1157, 1158, 1159, 1160, 1161, 1162, 1163, 1165, 1166, 1167, 1168, 1169, 1170, 1171, 1172, 1173, 1174, 1175, 1176, 1177, 1178, 1179, 1180, 1181, 1182, 1183, 1184, 1185, 1186, 1187, 1188, 1189, 1190, 1191, 1192, 1193, 1194, 1195, 1196, 1197, 1198, 1199, 1200, 1201, 1202, 1203, 1204, 1205, 1206, 1207, 1208, 1209, 1210, 1211, 1212, 1213, 1214, 1215, 1216, 1217, 1218, 1219, 1220, 1221, 1222, 1223, 1224, 1225, 1226, 1227, 1228, 1229, 1230, 1231, 1232, 1233, 1234, 1235, 1236, 1237, 1238, 1239, 1240, 1241, 1242, 1243, 1244, 1245, 1246, 1247, 1248, 1249, 1250, 1251, 1252, 1253, 1254, 1255, 1258, 1259, 1260, 1262, 1263, 1264, 1265, 1267, 1268, 1269, 1270, 1271, 1272, 1273, 1274, 1275, 1276, 1277, 1278, 1279, 1280, 1281, 1282, 1283, 1284, 1285, 1286, 1287, 1288, 1289, 1290, 1291, 1292, 1293, 1294, 1295, 1298, 1299, 1300, 1301, 1302, 1303, 1304, 1305, 1306, 1307, 1308, 1309, 1310, 1311, 1313, 1314, 1315, 1316, 1317, 1318, 1320, 1321, 1323, 1324, 1325, 1326, 1327, 1328, 1329, 1330, 1331, 1332, 1333, 1334, 1335, 1336, 1337, 1338, 1339, 1340, 1342, 1343, 1344, 1345, 1346, 1347, 1348, 1349, 1350, 1351, 1352, 1353, 1354, 1355, 1356, 1357, 1358, 1359, 1360, 1361, 1362, 1364, 1365, 1366, 1367, 1368, 1369, 1370, 1371, 1372, 1373, 1374, 1375, 1376, 1377, 1378, 1379, 1380, 1381, 1382, 1383, 1384, 1385, 1386, 1387, 1388, 1389, 1390, 1391, 1392, 1393, 1394, 1395, 1396, 1397, 1399, 1400, 1401, 1402, 1403, 1404, 1405, 1406, 1407, 1408, 1409, 1410, 1411, 1412, 1413, 1414, 1415, 1416, 1418, 1419, 1420, 1421, 1422, 1423, 1424, 1426, 1427, 1428, 1429, 1430, 1431, 1432, 1433, 1434, 1435, 1436, 1437, 1439, 1440, 1441, 1442, 1443, 1445, 1446, 1447, 1448, 1449, 1450, 1451, 1452, 1453, 1454, 1455, 1456, 1457, 1458, 1459, 1460, 1461, 1462, 1464, 1465, 1466, 1467, 1468, 1469, 1470, 1471, 1472, 1473, 1474, 1475, 1476, 1477, 1478, 1479, 1481, 1482, 1483, 1484, 1485, 1487, 1488, 1489, 1491, 1492, 1493, 1494, 1495, 1496, 1499, 1500, 1501, 1502, 1503, 1504, 1505, 1506, 1507, 1508, 1509, 1510, 1511, 1512, 1513, 1514, 1515, 1516, 1517, 1518, 1519, 1520, 1521, 1522, 1523, 1524, 1525, 1526, 1527, 1528, 1529, 1530, 1531, 1532, 1533, 1534, 1535, 1536, 1538, 1539, 1540, 1541, 1542, 1543, 1544, 1545, 1546, 1548, 1549, 1550, 1551, 1552, 1553, 1554, 1556, 1557, 1558, 1559, 1560, 1561, 1562, 1563, 1564, 1565, 1566, 1567, 1568, 1569, 1570, 1571, 1572, 1573, 1574, 1575, 1576, 1577, 1578, 1579, 1580, 1581, 1582, 1583, 1584, 1585, 1586, 1587, 1588, 1589, 1590, 1591, 1592, 1593, 1594, 1595, 1596, 1597, 1598, 1599, 1600, 1601, 1602, 1603, 1604, 1605, 1606, 1607, 1608, 1609, 1610, 1612, 1613, 1614, 1615, 1616, 1617, 1618, 1619, 1620, 1621, 1622, 1623, 1624, 1625, 1626, 1627, 1628, 1629, 1630, 1631, 1632, 1633, 1634, 1635, 1636, 1637, 1638, 1639, 1640, 1641, 1642, 1643, 1644, 1645, 1646, 1647, 1648, 1649, 1650, 1651, 1652, 1653, 1654, 1655, 1656, 1657, 1658, 1659, 1660, 1661, 1662, 1663, 1664, 1665, 1666, 1667, 1668, 1669, 1670, 1671, 1672, 1673, 1674, 1675, 1676, 1678, 1679, 1680, 1681, 1682, 1683, 1684, 1685, 1686, 1687, 1688, 1689, 1690, 1691, 1692, 1693, 1694, 1695, 1696, 1697, 1698, 1699, 1700, 1701, 1702, 1703, 1704, 1705, 1706, 1707, 1708, 1709, 1710, 1711, 1712, 1713, 1714, 1715, 1716, 1717, 1718, 1719, 1720, 1721, 1722, 1723, 1724, 1725, 1726, 1727, 1728, 1729, 1730, 1731, 1732, 1734, 1735, 1736, 1737, 1738, 1739, 1740, 1741, 1742, 1743, 1744, 1745, 1746, 1747, 1748, 1749, 1752, 1753, 1754, 1755, 1756, 1757, 1758, 1759, 1760, 1761, 1762, 1764, 1765, 1766, 1767, 1768, 1769, 1770, 1771, 1772, 1773, 1774, 1775, 1776, 1778, 1779, 1780, 1781, 1782, 1783, 1784, 1785, 1786, 1787, 1788, 1789, 1790, 1791, 1792, 1793, 1795, 1796, 1797, 1798, 1799, 1800, 1801, 1802, 1803, 1804, 1805, 1806, 1807, 1808, 1809, 1810, 1811, 1812, 1813, 1814, 1815, 1816, 1817, 1818, 1819, 1820, 1821, 1822, 1823, 1824, 1825, 1826, 1827, 1828, 1829, 1830, 1831, 1832, 1833, 1834, 1835, 1836, 1837, 1838, 1839, 1840, 1841, 1842, 1843, 1844, 1845, 1846, 1847, 1848, 1849, 1850, 1851, 1852, 1853, 1854, 1855, 1857, 1858, 1859, 1860, 1861, 1862, 1863, 1864, 1865, 1866, 1867, 1868, 1869, 1870, 1871, 1872, 1873, 1874, 1875, 1876, 1877, 1878, 1879, 1880, 1881, 1882, 1883, 1884, 1885, 1886, 1887, 1888, 1889, 1890, 1891, 1892, 1893, 1894, 1895, 1896, 1897, 1898, 1899, 1900, 1901, 1902, 1903, 1904, 1905, 1907, 1908, 1909, 1910, 1911, 1912, 1914, 1915, 1916, 1918, 1919, 1920, 1921, 1922, 1923, 1924, 1925, 1926, 1927, 1928, 1929, 1930, 1931, 1932, 1934, 1936, 1937, 1938, 1939, 1940, 1941, 1942, 1943, 1944, 1945, 1946, 1947, 1948, 1949, 1950, 1951, 1952, 1954, 1955, 1956, 1957, 1958, 1959, 1960, 1961, 1962, 1963, 1964, 1965, 1966, 1967, 1968, 1969, 1970, 1971, 1972, 1973, 1974, 1975, 1976, 1977, 1978, 1979, 1980, 1981, 1982, 1983, 1984, 1985, 1986, 1987, 1988, 1990, 1991, 1992, 1993, 1994, 1995, 1996, 1997, 1998, 1999, 2000, 2001, 2002, 2003, 2004, 2005, 2006, 2007, 2008, 2009, 2010, 2011, 2012, 2014, 2015, 2016, 2017, 2018, 2019, 2020, 2021, 2022, 2023, 2024, 2025, 2026, 2027, 2028, 2029, 2030, 2031, 2032, 2033, 2034, 2035, 2036, 2037, 2038, 2039, 2040, 2041, 2042, 2043, 2044, 2045, 2046, 2047, 2049, 2050, 2051, 2052, 2053, 2055, 2056, 2057, 2058, 2059, 2060, 2061, 2062, 2063, 2064, 2065, 2066, 2067, 2068, 2069, 2070, 2071, 2073, 2074, 2075, 2076, 2077, 2079, 2080, 2081, 2082, 2083, 2084, 2085, 2086, 2087, 2088, 2089, 2090, 2091, 2092, 2094, 2095, 2096, 2097, 2098, 2099, 2100, 2101, 2102, 2103, 2104, 2106, 2107, 2108, 2109, 2110, 2111, 2112, 2113, 2114, 2115, 2116, 2117, 2118, 2119, 2120, 2121, 2122, 2123, 2124, 2125, 2126, 2128, 2129, 2130, 2131, 2132, 2133, 2134, 2135, 2137, 2138, 2139, 2140, 2141, 2142, 2143, 2144, 2146, 2147, 2148, 2149, 2150, 2151, 2152, 2153, 2154, 2155, 2156, 2157, 2158, 2159, 2160, 2161, 2162, 2163, 2164, 2166, 2167, 2168, 2169, 2170, 2171, 2172, 2173, 2174, 2175, 2176, 2177, 2178, 2179, 2180, 2181, 2182, 2183, 2184, 2185, 2186, 2187, 2188, 2189, 2190, 2191, 2192, 2193, 2194, 2195, 2196, 2197, 2198, 2200, 2201, 2202, 2203, 2204, 2205, 2206, 2207, 2208, 2209, 2210, 2211, 2212, 2213, 2214, 2215, 2216, 2217, 2218, 2219, 2220, 2221, 2222, 2223, 2224, 2225, 2226, 2228, 2229, 2230, 2231, 2232, 2233, 2234, 2235, 2236, 2237, 2239, 2240, 2241, 2242, 2243, 2244, 2245, 2246, 2247, 2248, 2249, 2250, 2251, 2252, 2253, 2254, 2255, 2259, 2260, 2261, 2262, 2263, 2264, 2265, 2266, 2267, 2268, 2269, 2270, 2271, 2272, 2273, 2274, 2275, 2276, 2277, 2280, 2281, 2282, 2283, 2284, 2285, 2287, 2288, 2289, 2290, 2291, 2292, 2293, 2294, 2295, 2296, 2297, 2298, 2299, 2300, 2301, 2302, 2303, 2304, 2305, 2306, 2307, 2309, 2310, 2311, 2312, 2313, 2315, 2316, 2317, 2318, 2319, 2320, 2321, 2322, 2323, 2324, 2325, 2327, 2328, 2329, 2330, 2331, 2332, 2333, 2334, 2335, 2336, 2337, 2338, 2339, 2340, 2341, 2342, 2344, 2345, 2346, 2347, 2348, 2349, 2350, 2351, 2352, 2353, 2354, 2355, 2356, 2357, 2358, 2359, 2360, 2361, 2362, 2363, 2364, 2365, 2366, 2367, 2368, 2369, 2370, 2371, 2373, 2374, 2375, 2376, 2377, 2378, 2379, 2380, 2381, 2382, 2383, 2384, 2385, 2386, 2387, 2388, 2389, 2390, 2391, 2392, 2393, 2394, 2395, 2396, 2397, 2398, 2399, 2401, 2402, 2403, 2404, 2405, 2406, 2407, 2408, 2409, 2410, 2411, 2412, 2413, 2414, 2415, 2416, 2419, 2420, 2421, 2422, 2423, 2424, 2425, 2426, 2427, 2428, 2429, 2430, 2431, 2432, 2433, 2434, 2435, 2436, 2437, 2438, 2439, 2440, 2441, 2442, 2443, 2444, 2445, 2448, 2449, 2450, 2452, 2453, 2454, 2455, 2456, 2457, 2458, 2459, 2460, 2461, 2462, 2463, 2464, 2465, 2466, 2467, 2469, 2470, 2471, 2472, 2473, 2474, 2475, 2476, 2477, 2478, 2479, 2480, 2481, 2482, 2483, 2484, 2485, 2486, 2487, 2488, 2489, 2490, 2491, 2492, 2494, 2495, 2496, 2497, 2499, 2500, 2501, 2503, 2504, 2505, 2506, 2508, 2509, 2510, 2511, 2512, 2513, 2514, 2515, 2516, 2517, 2518, 2519, 2520, 2521, 2522, 2523, 2524, 2525, 2526, 2527, 2528, 2529, 2530, 2531, 2532, 2533, 2534, 2535, 2536, 2537, 2538, 2540, 2541, 2543, 2544, 2546, 2547, 2548, 2549, 2550, 2551, 2552, 2553, 2554, 2555, 2556, 2557, 2558, 2559, 2560, 2561, 2562, 2563, 2564, 2566, 2567, 2568, 2569, 2570, 2572, 2574, 2575, 2576, 2577, 2578, 2579, 2580, 2581, 2582, 2583, 2584, 2585, 2586, 2587, 2590, 2591, 2592, 2593, 2594, 2595, 2596, 2597, 2598, 2599, 2600, 2601, 2603, 2604, 2605, 2606, 2607, 2608, 2609, 2610, 2611, 2612, 2613, 2614, 2615, 2616, 2617, 2620, 2621, 2622, 2623, 2624, 2625, 2626, 2627, 2628, 2629, 2630, 2631, 2632, 2633, 2635, 2636, 2637, 2639, 2640, 2641, 2642, 2643, 2644, 2645, 2646, 2647, 2648, 2649, 2650, 2652, 2653, 2654, 2655, 2656, 2657, 2658, 2659, 2660, 2662, 2664, 2666, 2667, 2668, 2669, 2671, 2672, 2673, 2674, 2677, 2679, 2680, 2681, 2682, 2683, 2684, 2685, 2686, 2687, 2688, 2689, 2690, 2691, 2692, 2693, 2694, 2695, 2696, 2697, 2698, 2699, 2700, 2701, 2703, 2704, 2705, 2706, 2707, 2708, 2709, 2710, 2711, 2712, 2713, 2715, 2716, 2717, 2718, 2720, 2721, 2723, 2724, 2725, 2726, 2727, 2728, 2729, 2730, 2731, 2732, 2733, 2734, 2735, 2736, 2737, 2738, 2739, 2740, 2741, 2744, 2745, 2746, 2747, 2748, 2749, 2750, 2751, 2753, 2754, 2755, 2756, 2757, 2758, 2759, 2760, 2761, 2762, 2763, 2764, 2765, 2766, 2768, 2769, 2770, 2771, 2772, 2773, 2774, 2775, 2776, 2777, 2779, 2780, 2782, 2783, 2784, 2785, 2786, 2787, 2789, 2790, 2791, 2792, 2793, 2794, 2795, 2796, 2797, 2798, 2799, 2800, 2801, 2802, 2803, 2804, 2805, 2806, 2807, 2808, 2809, 2811, 2812, 2813, 2814, 2815, 2816, 2817, 2818, 2819, 2820, 2821, 2822, 2823, 2825, 2826, 2827, 2828, 2830, 2831, 2832, 2833, 2834, 2835, 2836, 2837, 2838, 2839, 2840, 2841, 2842, 2843, 2844, 2845, 2846, 2847, 2848, 2849, 2850, 2851, 2852, 2853, 2854, 2855, 2856, 2857, 2858, 2859, 2860, 2861, 2862, 2863, 2865, 2866, 2867, 2868, 2869, 2870, 2871, 2872, 2873, 2874, 2875, 2877, 2878, 2880, 2883, 2884, 2886, 2887, 2888, 2889, 2890, 2891, 2892, 2893, 2894, 2895, 2896, 2897, 2898, 2899, 2900, 2901, 2902, 2903, 2904, 2905, 2906, 2907, 2908, 2909, 2910, 2911, 2912, 2914, 2915, 2916, 2917, 2918, 2919, 2920, 2921, 2923, 2924, 2925, 2926, 2927, 2930, 2931, 2932, 2933, 2934, 2935, 2937, 2938, 2939, 2940, 2941, 2942, 2943, 2944, 2945, 2946, 2947, 2949, 2950, 2951, 2952, 2953, 2955, 2956, 2957, 2959, 2960, 2961, 2962, 2963, 2965, 2966, 2967, 2968, 2969, 2970, 2971, 2972, 2973, 2974, 2975, 2976, 2977, 2978, 2979, 2980, 2981, 2982, 2983, 2984, 2985, 2986, 2987, 2988, 2989, 2990, 2991, 2992, 2993, 2994, 2995, 2996, 2997, 2998, 2999, 3000, 3001, 3002, 3003, 3004, 3005, 3006, 3007, 3008, 3009, 3010, 3011, 3012, 3014, 3015, 3016, 3017, 3018, 3019, 3020, 3022, 3023, 3024, 3025, 3026, 3027, 3028, 3029, 3030, 3031, 3032, 3033, 3034, 3035, 3036, 3037, 3038, 3039, 3040, 3042, 3043, 3044, 3045, 3046, 3047, 3048, 3049, 3050, 3051, 3052, 3053, 3054, 3055, 3057, 3058, 3059, 3060, 3061, 3062, 3063, 3064, 3065, 3066, 3067, 3068, 3070, 3071, 3072, 3073, 3074, 3075, 3076, 3077, 3079, 3080, 3081, 3082, 3083, 3084, 3086, 3087, 3088, 3089, 3090, 3091, 3093, 3094, 3095, 3096, 3097, 3098, 3099, 3100, 3101, 3102, 3103, 3104, 3105, 3106, 3107, 3108, 3109, 3110, 3111, 3112, 3113, 3114, 3115, 3116, 3118, 3119, 3120, 3121, 3122, 3123, 3124, 3125, 3126, 3127, 3128, 3131, 3132, 3133, 3134, 3135, 3136, 3137, 3138, 3139, 3142, 3143, 3144, 3146, 3147, 3149, 3150, 3151, 3152, 3153, 3155, 3156, 3157, 3158, 3159, 3160, 3162, 3163, 3164, 3165, 3166, 3167, 3169, 3170, 3171, 3172, 3173, 3174, 3175, 3176, 3177, 3178, 3179, 3180, 3181, 3182, 3183, 3184, 3185, 3186, 3187, 3188, 3189, 3190, 3191, 3192, 3193, 3194, 3195, 3196, 3197, 3198, 3199, 3200, 3201, 3202, 3203, 3204, 3205, 3206, 3207, 3208, 3209, 3210, 3211, 3212, 3213, 3214, 3215, 3216, 3217, 3218, 3219, 3222, 3223, 3224, 3225, 3226, 3227, 3228, 3229, 3231, 3232, 3233, 3234, 3236, 3240, 3241, 3242, 3243, 3244, 3245, 3247, 3248, 3249, 3250, 3251, 3252, 3253, 3254, 3255, 3256, 3258, 3259, 3260, 3261, 3262, 3263, 3265, 3269, 3270, 3271, 3272, 3273, 3276, 3277, 3279, 3280, 3281, 3282, 3283, 3284, 3285, 3286, 3287, 3288, 3289, 3291, 3292, 3293, 3294, 3295, 3296, 3298, 3299, 3300, 3301, 3302, 3303, 3304, 3305, 3306, 3307, 3310, 3311, 3312, 3313, 3314, 3316, 3317, 3318, 3319, 3320, 3321, 3322, 3323, 3325, 3326, 3327, 3328, 3329, 3330, 3331, 3332, 3333, 3334, 3335, 3337, 3338, 3339, 3340, 3341, 3342, 3343, 3344, 3345, 3346, 3347, 3349, 3350, 3351, 3352, 3353, 3354, 3355, 3356, 3357, 3358, 3359, 3360, 3362, 3363, 3364, 3366, 3367, 3368, 3369, 3370, 3371, 3372, 3373, 3374, 3375, 3376, 3377, 3378, 3379, 3380, 3381, 3382, 3383, 3384, 3386, 3387, 3388, 3389, 3390, 3391, 3392, 3393, 3394, 3396, 3397, 3398, 3399, 3400, 3401, 3402, 3403, 3404, 3405, 3406, 3407, 3408, 3410, 3411, 3412, 3413, 3414, 3415, 3416, 3417, 3418, 3419, 3421, 3422, 3423, 3424, 3426, 3427, 3428, 3429, 3430, 3431, 3432, 3433, 3434, 3435, 3436, 3437, 3438, 3439, 3440, 3441, 3442, 3443, 3444, 3445, 3446, 3447, 3448, 3449, 3450, 3451, 3452, 3453, 3454, 3455, 3456, 3457, 3459, 3460, 3461, 3462, 3465, 3466, 3467, 3468, 3469, 3470, 3471, 3472, 3473, 3474, 3476, 3477, 3480, 3481, 3482, 3483, 3484, 3485, 3486, 3487, 3488, 3489, 3490, 3491, 3492, 3493, 3494, 3495, 3497, 3498, 3499, 3500, 3501, 3502, 3503, 3504, 3505, 3506, 3507, 3509, 3510, 3511, 3512, 3513, 3514, 3515, 3516, 3519, 3520, 3521, 3522, 3523, 3525, 3526, 3527, 3528, 3529, 3530, 3531, 3532, 3533, 3534, 3535, 3536, 3538, 3539, 3540, 3541, 3542, 3543, 3544, 3545, 3546, 3547, 3548, 3549, 3550, 3551, 3552, 3553, 3556, 3557, 3558, 3562, 3563, 3564, 3565, 3566, 3567, 3568, 3569, 3570, 3571, 3572, 3573, 3574, 3575, 3576, 3577, 3578, 3580, 3581, 3582, 3583, 3584, 3585, 3586, 3588, 3589, 3591, 3592, 3593, 3594, 3595, 3596, 3598, 3599, 3600, 3601, 3602, 3603, 3604, 3605, 3606, 3607, 3608, 3609, 3610, 3611, 3612, 3613, 3614, 3615, 3616, 3617, 3618, 3620, 3621, 3622, 3623, 3624, 3625, 3626, 3627, 3628, 3629, 3630, 3631, 3632, 3633, 3634, 3635, 3636, 3637, 3638, 3639, 3640, 3642, 3644, 3645, 3646, 3647, 3648, 3649, 3650, 3651, 3652, 3653, 3655, 3656, 3657, 3658, 3660, 3661, 3662, 3663, 3664, 3665, 3666, 3667, 3668, 3669, 3670, 3671, 3672, 3673, 3674, 3675, 3676, 3677, 3678, 3679, 3680, 3681, 3682, 3683, 3684, 3685, 3686, 3687, 3688, 3689, 3690, 3691, 3692, 3693, 3694, 3696, 3697, 3698, 3699, 3700, 3701, 3702, 3703, 3704, 3705, 3706, 3707, 3708, 3709, 3710, 3711, 3712, 3713, 3716, 3717, 3718, 3719, 3721, 3722, 3724, 3728, 3729, 3730, 3731, 3732, 3733, 3734, 3735, 3736, 3737, 3738, 3739, 3740, 3743, 3744, 3748, 3749, 3750, 3751, 3752, 3753, 3754, 3756, 3757, 3758, 3759, 3760, 3761, 3762, 3763, 3764, 3765, 3766, 3767, 3768, 3769, 3770, 3772, 3773, 3774, 3775, 3776, 3777, 3778, 3779, 3781, 3782, 3783, 3784, 3785, 3786, 3787, 3788, 3789, 3790, 3791, 3792, 3793, 3794, 3795, 3796, 3797, 3798, 3799, 3800, 3801, 3802, 3803, 3804, 3805, 3806, 3807, 3808, 3809, 3810, 3811, 3812, 3813, 3814, 3815, 3817, 3818, 3819, 3820, 3821, 3822, 3823, 3825, 3826, 3827, 3828, 3829, 3830, 3831, 3832, 3833, 3834, 3835, 3836, 3837, 3838, 3839, 3840, 3841, 3843, 3844, 3845, 3846, 3847, 3848, 3849, 3850, 3851, 3852, 3853, 3854, 3855, 3856, 3857, 3858, 3859, 3860, 3861, 3862, 3863, 3864, 3866, 3867, 3868, 3869, 3870, 3871, 3872, 3873, 3874, 3875, 3877, 3878, 3879, 3880, 3884, 3886, 3887, 3888, 3889, 3890, 3891, 3892, 3893, 3894, 3895, 3896, 3897, 3898, 3899, 3900, 3901, 3902, 3903, 3904, 3905, 3906, 3907, 3908, 3910, 3912, 3913, 3915, 3917, 3918, 3919, 3920, 3921, 3922, 3923, 3924, 3925, 3926, 3927, 3928, 3929, 3930, 3932, 3933, 3934, 3935, 3936, 3937, 3938, 3939, 3940, 3941, 3943, 3944, 3945, 3946, 3947, 3948, 3949, 3950, 3951, 3952, 3953, 3954, 3955, 3956, 3957, 3958, 3959, 3960, 3962, 3963, 3964, 3965, 3966, 3967, 3969, 3972, 3973, 3974, 3975, 3976, 3977, 3978, 3979, 3980, 3981, 3982, 3983, 3984, 3985, 3986, 3987, 3988, 3989, 3990, 3991, 3992, 3993, 3994, 3995, 3996, 3997, 3998, 3999, 4000, 4001, 4002, 4003, 4004, 4005, 4006, 4007, 4008, 4009, 4010, 4011, 4012, 4013, 4014, 4016, 4017, 4018, 4019, 4020, 4021, 4022, 4023, 4024, 4025, 4026, 4027, 4028, 4029, 4030, 4031, 4032, 4033, 4034, 4037, 4038, 4039, 4040, 4041, 4042, 4043, 4044, 4045, 4046, 4047, 4049, 4050, 4053, 4054, 4055, 4056, 4057, 4058, 4059, 4060, 4061, 4062, 4063, 4067, 4068, 4069, 4070, 4071, 4072, 4073, 4074, 4075, 4076, 4077, 4078, 4079, 4080, 4081, 4082, 4083, 4084, 4085, 4086, 4087, 4088, 4089, 4090, 4091, 4092, 4093, 4094, 4095, 4096, 4097, 4098, 4099, 4100, 4101, 4102, 4103, 4104, 4105, 4106, 4107, 4108, 4109, 4111, 4112, 4113, 4114, 4115, 4116, 4117, 4118, 4119, 4120, 4121, 4122, 4123, 4124, 4125, 4126, 4127, 4128, 4129, 4130, 4131, 4132, 4133, 4134, 4135, 4136, 4137, 4138, 4139, 4140, 4141, 4142, 4143, 4144, 4145, 4147, 4148, 4149, 4150, 4151, 4152, 4153, 4154, 4155, 4156, 4157, 4158, 4159, 4160, 4161, 4163, 4164, 4165, 4166, 4167, 4168, 4169, 4170, 4171, 4172, 4173, 4174, 4175, 4176, 4177, 4178, 4179, 4181, 4182, 4183, 4184, 4185, 4186, 4187, 4188, 4189, 4190, 4191, 4192, 4193, 4194, 4195, 4196, 4197, 4198, 4200, 4201, 4202, 4203, 4204, 4205, 4206, 4207, 4208, 4209, 4210, 4211, 4212, 4213, 4214, 4215, 4216, 4217, 4218, 4219, 4221, 4222, 4223, 4224, 4225, 4226, 4227, 4228, 4229, 4230, 4231, 4232, 4233, 4234, 4235, 4237, 4238, 4239, 4240, 4241, 4242, 4243, 4244, 4245, 4246, 4247, 4248, 4249, 4250, 4251, 4252, 4253, 4254, 4255, 4256, 4257, 4258, 4259, 4260, 4261, 4262, 4263, 4264, 4265, 4266, 4267, 4269, 4270, 4271, 4272, 4273, 4275, 4276, 4277, 4278, 4279, 4280, 4281, 4283, 4284, 4286, 4287, 4288, 4289, 4290, 4292, 4293, 4294, 4295, 4297, 4298, 4299, 4300, 4301, 4302, 4303, 4304, 4305, 4306, 4307, 4308, 4309, 4310, 4311, 4312, 4313, 4314, 4315, 4316, 4317, 4318, 4319, 4320, 4321, 4322, 4323, 4325, 4326, 4327, 4328, 4329, 4330, 4331, 4332, 4333, 4334, 4335, 4336, 4337, 4339, 4340, 4341, 4342, 4343, 4344, 4345, 4346, 4347, 4348, 4349, 4350, 4351, 4352, 4353, 4354, 4356, 4357, 4358, 4359, 4361, 4362, 4363, 4364, 4365, 4366, 4367, 4368, 4369, 4370, 4371, 4372, 4373, 4374, 4375, 4376, 4377, 4378, 4379, 4380, 4381, 4382, 4383, 4384, 4385, 4386, 4387, 4388, 4389, 4390, 4391, 4392, 4393, 4394, 4395, 4396, 4397, 4398, 4399, 4400, 4401, 4402, 4403, 4404, 4405, 4406, 4407, 4408, 4409, 4410, 4411, 4412, 4413, 4414, 4415, 4416, 4417, 4418, 4419, 4420, 4421, 4422, 4423, 4424, 4425, 4426, 4427, 4428, 4429, 4430, 4432, 4433, 4434, 4435, 4436, 4437, 4438, 4439, 4440, 4441, 4442, 4443, 4444, 4445, 4446, 4447, 4448, 4449, 4450, 4451, 4452, 4453, 4455, 4456, 4457, 4458, 4459, 4460, 4461, 4463, 4465, 4466, 4467, 4468, 4469, 4471, 4472, 4473, 4474, 4477, 4478, 4479, 4480, 4481, 4482, 4483, 4484, 4485, 4486, 4487, 4488, 4489, 4490, 4491, 4492, 4493, 4494, 4495, 4496, 4497, 4498, 4499, 4500, 4501, 4502, 4503, 4504, 4505, 4506, 4507, 4508, 4509, 4510, 4511, 4512, 4513, 4514, 4515, 4516, 4517, 4518, 4519, 4520, 4521, 4522, 4523, 4524, 4525, 4526, 4527, 4528, 4529, 4530, 4531, 4532, 4533, 4534, 4535, 4536, 4537, 4538, 4539, 4540, 4541, 4542, 4543, 4544, 4545, 4546, 4547, 4548, 4549, 4551, 4552, 4553, 4554, 4555, 4556, 4557, 4558, 4559, 4560, 4561, 4562, 4563, 4564, 4565, 4566, 4567, 4568, 4569, 4570, 4571, 4572, 4573, 4574, 4575, 4576, 4577, 4578, 4579, 4580, 4581, 4582, 4583, 4584, 4585, 4586, 4587, 4588, 4589, 4590, 4591, 4593, 4594, 4595, 4596, 4597, 4598, 4599, 4600, 4601, 4602, 4603, 4604, 4605, 4606, 4607, 4608, 4610, 4611, 4612, 4613, 4614, 4615, 4616, 4618, 4619, 4620, 4621, 4622, 4623, 4624, 4625, 4626, 4627, 4628, 4629, 4630, 4632, 4633, 4634, 4635, 4636, 4637, 4639, 4640, 4641, 4642, 4643, 4644, 4645, 4646, 4647, 4648, 4650, 4651, 4652, 4653, 4654, 4655, 4656, 4657, 4658, 4659, 4660, 4661, 4662, 4663, 4664, 4665, 4666, 4667, 4668, 4669, 4670, 4671, 4672, 4673, 4674, 4675, 4676, 4677, 4678, 4679, 4680, 4681, 4682, 4683, 4684, 4685, 4686, 4687, 4688, 4689, 4690, 4691, 4692, 4693, 4694, 4695, 4696, 4697, 4698, 4699, 4700, 4701, 4702, 4703, 4704, 4705, 4706, 4707, 4708, 4709, 4710, 4711, 4712, 4713, 4715, 4716, 4717, 4718, 4719, 4720, 4722, 4723, 4724, 4725, 4726, 4727, 4728, 4729, 4730, 4731, 4732, 4733, 4734, 4735, 4736, 4737, 4738, 4739, 4740, 4741, 4742, 4743, 4744, 4745, 4746, 4747, 4748, 4749, 4750, 4751, 4752, 4753, 4754, 4755, 4756, 4757, 4758, 4759, 4760, 4761, 4762, 4763, 4764, 4765, 4767, 4768, 4770, 4771, 4772, 4773, 4774, 4775, 4776, 4777, 4778, 4779, 4780, 4781, 4783, 4784, 4785, 4788, 4789, 4790, 4791, 4792, 4793, 4794, 4795, 4796, 4797, 4798, 4799, 4800, 4801, 4802, 4803, 4804, 4805, 4806, 4807, 4808, 4809, 4810, 4811, 4813, 4814, 4815, 4816, 4817, 4818, 4819, 4820, 4821, 4822, 4823, 4826, 4827, 4828, 4829, 4831, 4832, 4833, 4834, 4835, 4836, 4837, 4838, 4839, 4840, 4841, 4842, 4843, 4844, 4845, 4846, 4847, 4848, 4849, 4850, 4851, 4852, 4853, 4854, 4855, 4856, 4857, 4858, 4859, 4860, 4861, 4862, 4863, 4864, 4865, 4866, 4867, 4868, 4869, 4871, 4872, 4873, 4874, 4875, 4876, 4877, 4878, 4879, 4880, 4881, 4882, 4883, 4884, 4885, 4887, 4888, 4889, 4890, 4891, 4892, 4893, 4894, 4895, 4897, 4898, 4899, 4900, 4901, 4902, 4903, 4904, 4905, 4906, 4907, 4908, 4909, 4910, 4911, 4912, 4914, 4915, 4916, 4917, 4918, 4919, 4920, 4921, 4922, 4923, 4925, 4926, 4927, 4928, 4929, 4930, 4931, 4932, 4933, 4934, 4935, 4936, 4937, 4938, 4939, 4940, 4942, 4943, 4944, 4945, 4946, 4947, 4948, 4949, 4950, 4951, 4952, 4953, 4954, 4955, 4956, 4957, 4958, 4959, 4960, 4961, 4962, 4963, 4964, 4965, 4967, 4968, 4969, 4970, 4971, 4972, 4973, 4974, 4975, 4977, 4978, 4979, 4980, 4981, 4982, 4983, 4984, 4986, 4987, 4988, 4989, 4990, 4991, 4993, 4994, 4995, 4996, 4997, 4998, 4999, 5000, 5001, 5002, 5003, 5004, 5005, 5006, 5007, 5009, 5010, 5011, 5012, 5013, 5014, 5015, 5016, 5017, 5018, 5019, 5020, 5021, 5022, 5023, 5024, 5025, 5026, 5027, 5028, 5029, 5031, 5032, 5033, 5034, 5035, 5036, 5037, 5038, 5039, 5040, 5041, 5042, 5043, 5044, 5045, 5046, 5047, 5048, 5049, 5050, 5051, 5052, 5055, 5056, 5057, 5058, 5059, 5060, 5061, 5062, 5063, 5064, 5065, 5066, 5067, 5068, 5069, 5070, 5071, 5072, 5073, 5074, 5075, 5076, 5077, 5078, 5079, 5080, 5081, 5082, 5083, 5084, 5085, 5086, 5087, 5090, 5091, 5092, 5093, 5095, 5096, 5097, 5098, 5099, 5100, 5101, 5102, 5103, 5104, 5105, 5106, 5107, 5108, 5109, 5110, 5111, 5112, 5113, 5114, 5115, 5116, 5117, 5118, 5119, 5120, 5121, 5122, 5123, 5124, 5125, 5126, 5127, 5128, 5129, 5130, 5131, 5132, 5133, 5134, 5135, 5136, 5137, 5138, 5139, 5140, 5141, 5142, 5143, 5144, 5145, 5148, 5149, 5150, 5151, 5152, 5155, 5156, 5157, 5158, 5159, 5160, 5161, 5162, 5163, 5164, 5165, 5166, 5167, 5168, 5169, 5170, 5171, 5172, 5174, 5175, 5176, 5178, 5179, 5181, 5182, 5183, 5185, 5186, 5187, 5188, 5190, 5191, 5192, 5193, 5194, 5195, 5196, 5197, 5198, 5199, 5200, 5201, 5202, 5203, 5204, 5205, 5206, 5207, 5208, 5209, 5210, 5211, 5212, 5213, 5214, 5215, 5216, 5217, 5218, 5219, 5220, 5221, 5224, 5225, 5226, 5229, 5230, 5231, 5232, 5233, 5236, 5237, 5238, 5239, 5240, 5241, 5242, 5243, 5245, 5246, 5247, 5248, 5249, 5250, 5251, 5252, 5253, 5256, 5257, 5258, 5259, 5260, 5261, 5262, 5263, 5264, 5265, 5266, 5267, 5268, 5269, 5270, 5271, 5272, 5273, 5274, 5275, 5276, 5277, 5278, 5279, 5280, 5281, 5282, 5283, 5284, 5285, 5286, 5287, 5288, 5289, 5290, 5291, 5292, 5294, 5295, 5296, 5297, 5298, 5299, 5300, 5301, 5302, 5303, 5304, 5305, 5306, 5307, 5308, 5309, 5310, 5311, 5312, 5313, 5314, 5315, 5316, 5317, 5319, 5320, 5321, 5323, 5324, 5325, 5326, 5327, 5328, 5329, 5330, 5331, 5333, 5334, 5335, 5336, 5337, 5338, 5339, 5340, 5341, 5342, 5343, 5344, 5345, 5346, 5347, 5348, 5350, 5351, 5352, 5353, 5354, 5355, 5356, 5357, 5358, 5359, 5361, 5362, 5363, 5364, 5365, 5366, 5367, 5368, 5369, 5370, 5371, 5372, 5373, 5375, 5376, 5377, 5378, 5379, 5380, 5381, 5383, 5384, 5385, 5386, 5387, 5388, 5389, 5390, 5391, 5392, 5393, 5394, 5396, 5397, 5398, 5399, 5400, 5401, 5402, 5403, 5404, 5405, 5406, 5407, 5408, 5409, 5410, 5411, 5412, 5413, 5414, 5416, 5417, 5418, 5419, 5420, 5422, 5423, 5424, 5425, 5426, 5427, 5428, 5429, 5430, 5431, 5432, 5433, 5434, 5435, 5437, 5438, 5439, 5440, 5441, 5442, 5443, 5444, 5445, 5446, 5447, 5448, 5449, 5450, 5451, 5452, 5453, 5454, 5455, 5456, 5457, 5458, 5459, 5460, 5461, 5462, 5463, 5464, 5465, 5466, 5467, 5468, 5469, 5470, 5471, 5472, 5473, 5474, 5475, 5476, 5477, 5478, 5479, 5480, 5481, 5482, 5483, 5484, 5485, 5486, 5487, 5488, 5489, 5490, 5491, 5492, 5493, 5494, 5495, 5496, 5497, 5498, 5499, 5500, 5501, 5502, 5503, 5504, 5505, 5506, 5507, 5508, 5509, 5510, 5511, 5512, 5513, 5514, 5515, 5516, 5517, 5518, 5519, 5520, 5521, 5522, 5523, 5524, 5525, 5526, 5527, 5529, 5530, 5531, 5532, 5533, 5534, 5535, 5536, 5537, 5538, 5539, 5540, 5541, 5542, 5543, 5544, 5545, 5547, 5548, 5549, 5550, 5551, 5552, 5554, 5555, 5556, 5557, 5558, 5559, 5560, 5561, 5562, 5563, 5564, 5565, 5566, 5567, 5568, 5569, 5570, 5571, 5572, 5573, 5574, 5575, 5576, 5577, 5578, 5579, 5580, 5581, 5582, 5583, 5584, 5585, 5586, 5587, 5588, 5589, 5590, 5591, 5592, 5593, 5594, 5595, 5596, 5597, 5598, 5600, 5601, 5602, 5603, 5604, 5605, 5606, 5607, 5608, 5609, 5610, 5612, 5613, 5614, 5615, 5616, 5617, 5618, 5620, 5622, 5623, 5624, 5625, 5626, 5627, 5628, 5629, 5630, 5631, 5633, 5634, 5635, 5636, 5637, 5639, 5640, 5642, 5643, 5645, 5646, 5647, 5648, 5649, 5650, 5651, 5652, 5653, 5654, 5655, 5656, 5657, 5658, 5659, 5660, 5661, 5662, 5663, 5664, 5665, 5666, 5667, 5668, 5669, 5670, 5671, 5672, 5673, 5674, 5676, 5677, 5678, 5679, 5680, 5681, 5682, 5683, 5684, 5685, 5686, 5688, 5689, 5690, 5691, 5692, 5693, 5694, 5695, 5696, 5697, 5698, 5699, 5700, 5701, 5702, 5703, 5704, 5705, 5706, 5707, 5708, 5709, 5711, 5712, 5713, 5714, 5716, 5717, 5718, 5720, 5721, 5722, 5723, 5724, 5726, 5728, 5729, 5730, 5731, 5732, 5733, 5734, 5735, 5736, 5737, 5739, 5740, 5741, 5742, 5743, 5744, 5745, 5746, 5747, 5748, 5749, 5751, 5752, 5753, 5754, 5755, 5756, 5757, 5758, 5759, 5760, 5761, 5762, 5763, 5764, 5765, 5766, 5767, 5768, 5769, 5771, 5772, 5773, 5774, 5775, 5776, 5777, 5778, 5779, 5780, 5781, 5782, 5783, 5784, 5785, 5786, 5787, 5788, 5789, 5791, 5792, 5793, 5794, 5795, 5796, 5797, 5798, 5799, 5800, 5801, 5802, 5803, 5804, 5805, 5806, 5808, 5809, 5810, 5811, 5813, 5814, 5815, 5816, 5817, 5819, 5820, 5821, 5822, 5823, 5825, 5826, 5827, 5828, 5829, 5830, 5831, 5832, 5833, 5834, 5835, 5836, 5837, 5838, 5839, 5840, 5841, 5842, 5843, 5844, 5846, 5847, 5848, 5849, 5850, 5851, 5852, 5853, 5854, 5855, 5856, 5857, 5858, 5859, 5860, 5861, 5862, 5863, 5864, 5865, 5866, 5868, 5869, 5870, 5871, 5872, 5874, 5875, 5876, 5877, 5878, 5880, 5881, 5882, 5883, 5884, 5886, 5887, 5888, 5889, 5890, 5891, 5892, 5893, 5894, 5895, 5896, 5897, 5898, 5899, 5900, 5901, 5902, 5903, 5904, 5905, 5907, 5908, 5909, 5910, 5912, 5913, 5914, 5915, 5916, 5917, 5918, 5919, 5920, 5921, 5922, 5924, 5925, 5926, 5927, 5928, 5929, 5932, 5933, 5934, 5935, 5936, 5937, 5938, 5939, 5940, 5942, 5943, 5944, 5945, 5946, 5947, 5948, 5949, 5950, 5952, 5953, 5954, 5955, 5956, 5957, 5960, 5962, 5963, 5965, 5966, 5967, 5968, 5969, 5970, 5971, 5972, 5973, 5974, 5975, 5976, 5977, 5978, 5979, 5980, 5981, 5983, 5984, 5985, 5986, 5987, 5988, 5989, 5991, 5992, 5993, 5994, 5995, 5996, 5997, 5998, 5999, 6000, 6001, 6002, 6003, 6004, 6005, 6006, 6007, 6008, 6009, 6010, 6011, 6012, 6013, 6015, 6016, 6017, 6018, 6019, 6021, 6022, 6023, 6024, 6025, 6027, 6028, 6029, 6030, 6031, 6032, 6034, 6036, 6037, 6040, 6041, 6042, 6043, 6044, 6045, 6046, 6047, 6048, 6049, 6051, 6052, 6053, 6055, 6056, 6057, 6058, 6059, 6060, 6061, 6063, 6064, 6065, 6066, 6067, 6068, 6069, 6070, 6071, 6072, 6073, 6074, 6075, 6076, 6077, 6078, 6079, 6080, 6081, 6083, 6084, 6085, 6086, 6087, 6088, 6089, 6090, 6091, 6092, 6093, 6094, 6095, 6096, 6097, 6099, 6100, 6101, 6102, 6103, 6104, 6105, 6106, 6107, 6108, 6109, 6111, 6112, 6113, 6114, 6115, 6116, 6117, 6119, 6120, 6121, 6122, 6123, 6124, 6126, 6127, 6128, 6129, 6130, 6131, 6132, 6133, 6134, 6135, 6136, 6137, 6139, 6140, 6141, 6142, 6143, 6144, 6145, 6146, 6147, 6148, 6149, 6150, 6151, 6152, 6153, 6154, 6155, 6156, 6157, 6158, 6159, 6160, 6161, 6162, 6163, 6164, 6165, 6166, 6167, 6168, 6169, 6170, 6171, 6172, 6173, 6174, 6175, 6176, 6178, 6179, 6180, 6181, 6182, 6183, 6184, 6185, 6186, 6187, 6189, 6190, 6191, 6192, 6193, 6194, 6195, 6196, 6197, 6198, 6200, 6201, 6202, 6203, 6204, 6205, 6206, 6207, 6208, 6209, 6210, 6211, 6212, 6213, 6214, 6215, 6216, 6217, 6218, 6220, 6221, 6222, 6223, 6224, 6225, 6226, 6227, 6228, 6229, 6230, 6231, 6232, 6233, 6234, 6235, 6236, 6237, 6238, 6239, 6240, 6241, 6242, 6243, 6244, 6245, 6246, 6247, 6248, 6249, 6250, 6251, 6252, 6253, 6254, 6255, 6256, 6257, 6258, 6259, 6260, 6261, 6262, 6263, 6264, 6265, 6266, 6267, 6269, 6270, 6271, 6272, 6273, 6274, 6275, 6276, 6277, 6278, 6279, 6280, 6281, 6282, 6283, 6284, 6285, 6286, 6287, 6288, 6289, 6290, 6291, 6292, 6293, 6294, 6295, 6296, 6297, 6298, 6300, 6301, 6302, 6303, 6304, 6305, 6306, 6307, 6308, 6309, 6310, 6311, 6313, 6314, 6315, 6316, 6317, 6318, 6319, 6320, 6321, 6322, 6323, 6324, 6325, 6326, 6327, 6328, 6329, 6330, 6331, 6332, 6333, 6334, 6335, 6336, 6338, 6339, 6340, 6341, 6342, 6343, 6344, 6345, 6346, 6347, 6348, 6349, 6350, 6351, 6352, 6353, 6354, 6355, 6356, 6357, 6358, 6359, 6360, 6361, 6362, 6363, 6364, 6369, 6370, 6371, 6372, 6373, 6374, 6375, 6376, 6377, 6378, 6379, 6380, 6381, 6382, 6383, 6384, 6385, 6386, 6387, 6388, 6389, 6390, 6391, 6392, 6393, 6394, 6395, 6396, 6399, 6401, 6402, 6404, 6405, 6407, 6408, 6410, 6411, 6412, 6413, 6414, 6415, 6416, 6417, 6418, 6419, 6420, 6421, 6422, 6423, 6424, 6425, 6426, 6427, 6428, 6429, 6430, 6431, 6433, 6434, 6435, 6436, 6437, 6438, 6439, 6440, 6441, 6442, 6443, 6444, 6445, 6446, 6447, 6448, 6449, 6450, 6452, 6453, 6454, 6455, 6457, 6458, 6460, 6461, 6462, 6463, 6464, 6467, 6468, 6469, 6470, 6471, 6472, 6473, 6474, 6475, 6476, 6477, 6478, 6479, 6481, 6482, 6483, 6484, 6485, 6486, 6487, 6488, 6489, 6491, 6492, 6493, 6494, 6495, 6496, 6497, 6498, 6499, 6500, 6501, 6502, 6503, 6504, 6505, 6506, 6507, 6508, 6509, 6510, 6511, 6512, 6513, 6514, 6515, 6516, 6517, 6518, 6519, 6520, 6521, 6522, 6523, 6524, 6525, 6526, 6527, 6528, 6529, 6530, 6531, 6532, 6533, 6534, 6535, 6536, 6537, 6538, 6539, 6540, 6541, 6542, 6543, 6544, 6545, 6547, 6548, 6552, 6553, 6554, 6555, 6556, 6557, 6558, 6559, 6560, 6561, 6562, 6563, 6564, 6565, 6566, 6568, 6569, 6570, 6571, 6572, 6573, 6575, 6576, 6577, 6578, 6579, 6580, 6581, 6582, 6583, 6584, 6585, 6586, 6587, 6589, 6590, 6591, 6592, 6593, 6594, 6595, 6596, 6597, 6598, 6600, 6601, 6602, 6603, 6604, 6605, 6606, 6607, 6608, 6609, 6610, 6611, 6612, 6613, 6614, 6615, 6616, 6617, 6618, 6619, 6620, 6621, 6622, 6623, 6624, 6625, 6626, 6627, 6628, 6629, 6630, 6631, 6632, 6633, 6634, 6635, 6636, 6637, 6639, 6640, 6641, 6642, 6643, 6644, 6645, 6646, 6647, 6648, 6649, 6650, 6651, 6652, 6653, 6654, 6655, 6656, 6657, 6658, 6659, 6660, 6661, 6662, 6663, 6664, 6665, 6666, 6667, 6668, 6669, 6670, 6671, 6672, 6673, 6675, 6676, 6677, 6678, 6679, 6680, 6681, 6682, 6683, 6684, 6685, 6686, 6687, 6688, 6689, 6690, 6691, 6692, 6693, 6694, 6695, 6696, 6697, 6698, 6699, 6700, 6701, 6702, 6703, 6704, 6705, 6706, 6707, 6708, 6709, 6710, 6711, 6712, 6713, 6714, 6715, 6716, 6717, 6718, 6719, 6720, 6721, 6722, 6723, 6724, 6725, 6726, 6727, 6728, 6729, 6730, 6731, 6732, 6733, 6734, 6735, 6736, 6737, 6738, 6739, 6740, 6741, 6742, 6743, 6744, 6745, 6747, 6748, 6750, 6751, 6752, 6753, 6754, 6755, 6756, 6757, 6759, 6760, 6762, 6764, 6765, 6766, 6767, 6768, 6769, 6770, 6771, 6773, 6774, 6775, 6776, 6777, 6778, 6779, 6780, 6781, 6782, 6783, 6784, 6785, 6786, 6787, 6788, 6789, 6790, 6791, 6792, 6793}",6260,"{2051, 2056, 2057, 2058, 2060, 2061, 2062, 6158, 2066, 2067, 2070, 2071, 2073, 2075, 2077, 2079, 4130, 2082, 2083, 6179, 2087, 6190, 2097, 2098, 2100, 2108, 2111, 6207, 2125, 6226, 6232, 2139, 2154, 2155, 2160, 2164, 2166, 2168, 2169, 2171, 2173, 2174, 2176, 2177, 6278, 2184, 6283, 2188, 2189, 2191, 6289, 2194, 6295, 6297, 2209, 6307, 2213, 2214, 6317, 6323, 6325, 6328, 6336, 6340, 6355, 6357, 6363, 6373, 6374, 6379, 6382, 6383, 6386, 6387, 6390, 6391, 6392, 6394, 6399, 6410, 6414, 6416, 6417, 6418, 6424, 6425, 6428, 6430, 6431, 6435, 6437, 6439, 6441, 6442, 6445, 6448, 6449, 6458, 6461, 6462, 6463, 6467, 6469, 4422, 6470, 6471, 6472, 6473, 6475, 6476, 6477, 6478, 6481, 6484, 6489, 6491, 6493, 6500, 6502, 6503, 6504, 6505, 6507, 6510, 6511, 6514, 6518, 6519, 6520, 6521, 6522, 6523, 6524, 6525, 6526, 6527, 6530, 6545, 6547, 6548, 6552, 6553, 6554, 6555, 6556, 6557, 6562, 6565, 6568, 6569, 6571, 6573, 6575, 6576, 6577, 6578, 6580, 6581, 6582, 6583, 6584, 6585, 6589, 6590, 6593, 6594, 6595, 6596, 6598, 6600, 6601, 6602, 6604, 6605, 6606, 6607, 6608, 6609, 6610, 6612, 6613, 6614, 6618, 6619, 6620, 6621, 6622, 6626, 6627, 6628, 6630, 6631, 6635, 6636, 6637, 6644, 6648, 6650, 6658, 6662, 6664, 6666, 6669, 6670, 6671, 6683, 6685, 6686, 6687, 6688, 6689, 6694, 6696, 6697, 6702, 6708, 4817, 4838, 4861, 4884, 4906, 4925, 4933, 4934, 4937, 4938, 4939, 4953, 4961, 4962, 4968, 4994, 4999, 5002, 5011, 5012, 5013, 5016, 5025, 5028, 5039, 5040, 5066, 5067, 5068, 5072, 5073, 5074, 5078, 5080, 5081, 5082, 5085, 5091, 5092, 5093, 5096, 5097, 5098, 5099, 5102, 5107, 5108, 5109, 5110, 5117, 5121, 5122, 3133, 3139, 3222, 1178, 3227, 3232, 3233, 1192, 5294, 3251, 3259, 3263, 3277, 3284, 3286, 5336, 3292, 1245, 1249, 3298, 3299, 3310, 5361, 3317, 3322, 3329, 1286, 3338, 3339, 3340, 3344, 1299, 3350, 3351, 1306, 5405, 3359, 3360, 3364, 1316, 3366, 3370, 3371, 3372, 3375, 3376, 5424, 3381, 3382, 3383, 1343, 3396, 1350, 3399, 1352, 3402, 3403, 1356, 3406, 3411, 1364, 5465, 1372, 1379, 1381, 1383, 5482, 1400, 1401, 5498, 1407, 1408, 1410, 5508, 5509, 5510, 5512, 1419, 5516, 5520, 1429, 5527, 1433, 1435, 1439, 1440, 5540, 1446, 5544, 5545, 1452, 1453, 1454, 5551, 1456, 1457, 5556, 1460, 1461, 1462, 5560, 1464, 1470, 1471, 1472, 5570, 5572, 1478, 5578, 5581, 1496, 5594, 5609, 5616, 5620, 5630, 5631, 1536, 5652, 5658, 5662, 5663, 5667, 5668, 5670, 5677, 5680, 3651, 3668, 3693, 1648, 3700, 3710, 3717, 1676, 3729, 3736, 3738, 3764, 3776, 5825, 3778, 3779, 3785, 1737, 3789, 1742, 1743, 3792, 3794, 5846, 5847, 3801, 5850, 3803, 5852, 1759, 3809, 3812, 3814, 1775, 3825, 3827, 3828, 3829, 1782, 3836, 3841, 3847, 1799, 1801, 1802, 1803, 1804, 1805, 1808, 1810, 1811, 1812, 1814, 1817, 1819, 1824, 3874, 1826, 3879, 1832, 3886, 3887, 3888, 3889, 3890, 3891, 3892, 3893, 1839, 3896, 3897, 1850, 3900, 3901, 1852, 3905, 1857, 3908, 1865, 1866, 3915, 1867, 3917, 1871, 1872, 1874, 3926, 1879, 3928, 1880, 3930, 1881, 1883, 1890, 1891, 1894, 1895, 1897, 3946, 3947, 1898, 1899, 3950, 1900, 1903, 3953, 3954, 3956, 3959, 1911, 3963, 1916, 3966, 1918, 1922, 1923, 1924, 1925, 1926, 1930, 1931, 3980, 3981, 1932, 1934, 1937, 1939, 1941, 1945, 1946, 1951, 1952, 6053, 1958, 1962, 1963, 1966, 1967, 1970, 6066, 1975, 1981, 1982, 6080, 1984, 1990, 1991, 6089, 1994, 6090, 1997, 1999, 2001, 2003, 6099, 6100, 2006, 2009, 2016, 2018, 2019, 2023, 2024, 6120, 2027, 2028, 2034, 2040, 2043, 2045, 2046, 2047}",567,"{0, 1, 2, 3, 4, 5, 6, 7, 8, 9, 10, 11, 12, 14, 15, 16, 17, 18, 20, 21, 22, 23, 24, 25, 27, 28, 29, 30, 31, 32, 33, 34, 35, 36, 37, 38, 39, 42, 43, 44, 45, 46, 47, 48, 49, 50, 51, 52, 53, 54, 55, 56, 57, 58, 59, 60, 61, 62, 64, 65, 66, 67, 68, 69, 70, 71, 72, 73, 74, 75, 78, 79, 80, 81, 83, 84, 85, 86, 88, 89, 90, 91, 92, 93, 94, 95, 96, 97, 98, 99, 100, 101, 102, 103, 104, 105, 106, 107, 108, 109, 110, 111, 112, 113, 114, 116, 118, 123, 124, 125, 126, 127, 128, 129, 130, 131, 132, 133, 134, 135, 136, 137, 138, 139, 140, 141, 143, 144, 145, 146, 147, 148, 149, 150, 151, 153, 154, 155, 156, 158, 159, 160, 161, 162, 163, 164, 165, 166, 167, 168, 169, 171, 172, 175, 176, 179, 180, 181, 182, 183, 184, 185, 186, 187, 188, 189, 190, 191, 192, 193, 194, 195, 196, 198, 199, 200, 201, 202, 203, 204, 205, 206, 207, 208, 209, 210, 211, 212, 213, 214, 215, 216, 217, 218, 219, 220, 221, 222, 223, 224, 225, 226, 227, 228, 229, 230, 231, 232, 234, 235, 236, 237, 238, 239, 240, 241, 242, 243, 244, 245, 246, 247, 248, 249, 250, 251, 252, 253, 254, 256, 257, 258, 259, 260, 261, 262, 263, 264, 265, 266, 267, 268, 269, 271, 272, 273, 274, 275, 276, 277, 278, 279, 280, 281, 282, 283, 284, 285, 286, 287, 288, 289, 290, 291, 292, 293, 294, 295, 296, 297, 298, 300, 301, 302, 303, 305, 307, 310, 311, 312, 313, 314, 315, 316, 317, 318, 321, 322, 323, 324, 325, 326, 327, 331, 332, 333, 334, 335, 336, 337, 338, 339, 340, 341, 342, 343, 344, 345, 346, 348, 349, 350, 351, 352, 353, 356, 357, 358, 359, 360, 361, 362, 363, 364, 365, 366, 367, 368, 369, 370, 372, 373, 375, 376, 377, 378, 379, 380, 382, 383, 384, 385, 386, 387, 388, 389, 390, 391, 392, 393, 394, 395, 396, 397, 398, 399, 400, 401, 402, 403, 404, 405, 406, 407, 408, 409, 410, 411, 414, 415, 416, 417, 418, 419, 420, 421, 422, 423, 424, 425, 426, 427, 428, 429, 430, 431, 433, 434, 435, 436, 437, 438, 439, 440, 441, 443, 444, 445, 446, 447, 449, 450, 451, 452, 453, 454, 456, 457, 458, 459, 460, 461, 462, 463, 464, 466, 467, 468, 469, 470, 471, 473, 474, 475, 476, 477, 478, 479, 481, 482, 483, 484, 486, 487, 488, 489, 490, 491, 492, 493, 494, 495, 496, 497, 498, 499, 500, 501, 502, 503, 504, 505, 506, 508, 509, 510, 511, 512, 513, 514, 515, 516, 518, 519, 520, 521, 522, 523, 524, 525, 526, 527, 528, 530, 531, 533, 534, 535, 536, 537, 538, 539, 540, 541, 542, 543, 544, 545, 546, 547, 548, 549, 550, 551, 552, 553, 554, 555, 556, 557, 558, 559, 560, 561, 562, 563, 565, 566, 567, 568, 569, 570, 571, 572, 573, 574, 575, 576, 577, 578, 580, 582, 583, 584, 585, 586, 590, 591, 593, 594, 596, 597, 598, 599, 600, 601, 602, 603, 604, 605, 606, 607, 608, 610, 611, 612, 613, 614, 616, 617, 618, 620, 621, 622, 623, 624, 625, 626, 627, 628, 629, 631, 632, 633, 634, 635, 636, 637, 638, 639, 640, 641, 642, 643, 644, 645, 646, 647, 648, 649, 650, 651, 652, 653, 654, 655, 656, 657, 658, 659, 660, 661, 662, 663, 664, 665, 666, 667, 668, 669, 670, 671, 672, 673, 674, 675, 676, 677, 678, 679, 680, 681, 682, 683, 684, 685, 686, 687, 688, 689, 690, 693, 695, 696, 697, 698, 699, 700, 701, 702, 703, 704, 705, 706, 707, 708, 709, 710, 711, 712, 713, 714, 715, 716, 717, 718, 719, 720, 721, 722, 723, 724, 725, 726, 727, 728, 729, 730, 731, 732, 733, 734, 735, 736, 737, 738, 739, 740, 741, 742, 743, 744, 745, 746, 748, 749, 750, 751, 752, 753, 754, 755, 756, 757, 758, 759, 760, 761, 762, 763, 764, 765, 766, 767, 768, 769, 770, 771, 773, 774, 775, 776, 777, 778, 779, 780, 781, 782, 783, 784, 785, 786, 787, 788, 789, 790, 791, 792, 794, 795, 796, 797, 798, 799, 800, 801, 802, 803, 804, 805, 806, 807, 808, 809, 810, 811, 812, 813, 814, 815, 816, 817, 819, 820, 821, 824, 825, 826, 828, 829, 830, 831, 832, 833, 834, 835, 836, 837, 838, 839, 840, 841, 842, 843, 844, 845, 846, 847, 848, 849, 850, 851, 852, 854, 855, 856, 857, 858, 859, 860, 861, 862, 864, 865, 866, 867, 868, 869, 870, 871, 872, 873, 874, 875, 876, 877, 878, 879, 880, 881, 882, 883, 884, 885, 886, 887, 888, 889, 890, 891, 892, 893, 894, 895, 896, 897, 898, 899, 900, 901, 902, 903, 904, 905, 906, 907, 908, 909, 910, 911, 912, 913, 914, 915, 916, 917, 918, 919, 920, 921, 922, 923, 924, 925, 926, 927, 928, 929, 930, 931, 932, 933, 935, 936, 937, 939, 940, 941, 942, 943, 944, 945, 946, 947, 948, 949, 950, 951, 952, 953, 954, 955, 956, 957, 958, 959, 960, 961, 962, 963, 964, 965, 966, 967, 968, 969, 970, 971, 972, 973, 974, 975, 976, 977, 978, 979, 980, 981, 982, 983, 984, 985, 986, 987, 988, 989, 990, 991, 992, 993, 994, 996, 997, 999, 1000, 1001, 1002, 1003, 1004, 1005, 1006, 1007, 1008, 1009, 1010, 1011, 1012, 1013, 1014, 1015, 1016, 1017, 1018, 1019, 1020, 1021, 1022, 1023, 1024, 1025, 1026, 1028, 1029, 1030, 1031, 1032, 1033, 1034, 1036, 1037, 1038, 1039, 1040, 1041, 1042, 1043, 1044, 1045, 1046, 1047, 1048, 1050, 1051, 1052, 1053, 1054, 1055, 1056, 1057, 1058, 1059, 1060, 1061, 1063, 1064, 1065, 1066, 1067, 1069, 1070, 1071, 1073, 1074, 1075, 1076, 1077, 1078, 1079, 1080, 1081, 1082, 1083, 1085, 1086, 1087, 1088, 1089, 1090, 1092, 1093, 1094, 1095, 1096, 1097, 1098, 1099, 1100, 1101, 1103, 1104, 1105, 1106, 1107, 1108, 1109, 1110, 1111, 1112, 1113, 1114, 1115, 1116, 1117, 1118, 1119, 1120, 1121, 1122, 1123, 1124, 1125, 1126, 1127, 1128, 1129, 1130, 1131, 1132, 1133, 1134, 1135, 1136, 1137, 1138, 1140, 1141, 1142, 1143, 1144, 1145, 1146, 1147, 1148, 1149, 1150, 1151, 1152, 1153, 1154, 1155, 1156, 1157, 1158, 1159, 1160, 1161, 1162, 1163, 1165, 1166, 1167, 1168, 1169, 1170, 1171, 1172, 1173, 1174, 1175, 1176, 1177, 1179, 1180, 1181, 1182, 1183, 1184, 1185, 1186, 1187, 1188, 1189, 1190, 1191, 1193, 1194, 1195, 1196, 1197, 1198, 1199, 1200, 1201, 1202, 1203, 1204, 1205, 1206, 1207, 1208, 1209, 1210, 1211, 1212, 1213, 1214, 1215, 1216, 1217, 1218, 1219, 1220, 1221, 1222, 1223, 1224, 1225, 1226, 1227, 1228, 1229, 1230, 1231, 1232, 1233, 1234, 1235, 1236, 1237, 1238, 1239, 1240, 1241, 1242, 1243, 1244, 1246, 1247, 1248, 1250, 1251, 1252, 1253, 1254, 1255, 1258, 1259, 1260, 1262, 1263, 1264, 1265, 1267, 1268, 1269, 1270, 1271, 1272, 1273, 1274, 1275, 1276, 1277, 1278, 1279, 1280, 1281, 1282, 1283, 1284, 1285, 1287, 1288, 1289, 1290, 1291, 1292, 1293, 1294, 1295, 1298, 1300, 1301, 1302, 1303, 1304, 1305, 1307, 1308, 1309, 1310, 1311, 1313, 1314, 1315, 1317, 1318, 1320, 1321, 1323, 1324, 1325, 1326, 1327, 1328, 1329, 1330, 1331, 1332, 1333, 1334, 1335, 1336, 1337, 1338, 1339, 1340, 1342, 1344, 1345, 1346, 1347, 1348, 1349, 1351, 1353, 1354, 1355, 1357, 1358, 1359, 1360, 1361, 1362, 1365, 1366, 1367, 1368, 1369, 1370, 1371, 1373, 1374, 1375, 1376, 1377, 1378, 1380, 1382, 1384, 1385, 1386, 1387, 1388, 1389, 1390, 1391, 1392, 1393, 1394, 1395, 1396, 1397, 1399, 1402, 1403, 1404, 1405, 1406, 1409, 1411, 1412, 1413, 1414, 1415, 1416, 1418, 1420, 1421, 1422, 1423, 1424, 1426, 1427, 1428, 1430, 1431, 1432, 1434, 1436, 1437, 1441, 1442, 1443, 1445, 1447, 1448, 1449, 1450, 1451, 1455, 1458, 1459, 1465, 1466, 1467, 1468, 1469, 1473, 1474, 1475, 1476, 1477, 1479, 1481, 1482, 1483, 1484, 1485, 1487, 1488, 1489, 1491, 1492, 1493, 1494, 1495, 1499, 1500, 1501, 1502, 1503, 1504, 1505, 1506, 1507, 1508, 1509, 1510, 1511, 1512, 1513, 1514, 1515, 1516, 1517, 1518, 1519, 1520, 1521, 1522, 1523, 1524, 1525, 1526, 1527, 1528, 1529, 1530, 1531, 1532, 1533, 1534, 1535, 1538, 1539, 1540, 1541, 1542, 1543, 1544, 1545, 1546, 1548, 1549, 1550, 1551, 1552, 1553, 1554, 1556, 1557, 1558, 1559, 1560, 1561, 1562, 1563, 1564, 1565, 1566, 1567, 1568, 1569, 1570, 1571, 1572, 1573, 1574, 1575, 1576, 1577, 1578, 1579, 1580, 1581, 1582, 1583, 1584, 1585, 1586, 1587, 1588, 1589, 1590, 1591, 1592, 1593, 1594, 1595, 1596, 1597, 1598, 1599, 1600, 1601, 1602, 1603, 1604, 1605, 1606, 1607, 1608, 1609, 1610, 1612, 1613, 1614, 1615, 1616, 1617, 1618, 1619, 1620, 1621, 1622, 1623, 1624, 1625, 1626, 1627, 1628, 1629, 1630, 1631, 1632, 1633, 1634, 1635, 1636, 1637, 1638, 1639, 1640, 1641, 1642, 1643, 1644, 1645, 1646, 1647, 1649, 1650, 1651, 1652, 1653, 1654, 1655, 1656, 1657, 1658, 1659, 1660, 1661, 1662, 1663, 1664, 1665, 1666, 1667, 1668, 1669, 1670, 1671, 1672, 1673, 1674, 1675, 1678, 1679, 1680, 1681, 1682, 1683, 1684, 1685, 1686, 1687, 1688, 1689, 1690, 1691, 1692, 1693, 1694, 1695, 1696, 1697, 1698, 1699, 1700, 1701, 1702, 1703, 1704, 1705, 1706, 1707, 1708, 1709, 1710, 1711, 1712, 1713, 1714, 1715, 1716, 1717, 1718, 1719, 1720, 1721, 1722, 1723, 1724, 1725, 1726, 1727, 1728, 1729, 1730, 1731, 1732, 1734, 1735, 1736, 1738, 1739, 1740, 1741, 1744, 1745, 1746, 1747, 1748, 1749, 1752, 1753, 1754, 1755, 1756, 1757, 1758, 1760, 1761, 1762, 1764, 1765, 1766, 1767, 1768, 1769, 1770, 1771, 1772, 1773, 1774, 1776, 1778, 1779, 1780, 1781, 1783, 1784, 1785, 1786, 1787, 1788, 1789, 1790, 1791, 1792, 1793, 1795, 1796, 1797, 1798, 1800, 1806, 1807, 1809, 1813, 1815, 1816, 1818, 1820, 1821, 1822, 1823, 1825, 1827, 1828, 1829, 1830, 1831, 1833, 1834, 1835, 1836, 1837, 1838, 1840, 1841, 1842, 1843, 1844, 1845, 1846, 1847, 1848, 1849, 1851, 1853, 1854, 1855, 1858, 1859, 1860, 1861, 1862, 1863, 1864, 1868, 1869, 1870, 1873, 1875, 1876, 1877, 1878, 1882, 1884, 1885, 1886, 1887, 1888, 1889, 1892, 1893, 1896, 1901, 1902, 1904, 1905, 1907, 1908, 1909, 1910, 1912, 1914, 1915, 1919, 1920, 1921, 1927, 1928, 1929, 1936, 1938, 1940, 1942, 1943, 1944, 1947, 1948, 1949, 1950, 1954, 1955, 1956, 1957, 1959, 1960, 1961, 1964, 1965, 1968, 1969, 1971, 1972, 1973, 1974, 1976, 1977, 1978, 1979, 1980, 1983, 1985, 1986, 1987, 1988, 1992, 1993, 1995, 1996, 1998, 2000, 2002, 2004, 2005, 2007, 2008, 2010, 2011, 2012, 2014, 2015, 2017, 2020, 2021, 2022, 2025, 2026, 2029, 2030, 2031, 2032, 2033, 2035, 2036, 2037, 2038, 2039, 2041, 2042, 2044, 2049, 2050, 2052, 2053, 2055, 2059, 2063, 2064, 2065, 2068, 2069, 2074, 2076, 2080, 2081, 2084, 2085, 2086, 2088, 2089, 2090, 2091, 2092, 2094, 2095, 2096, 2099, 2101, 2102, 2103, 2104, 2106, 2107, 2109, 2110, 2112, 2113, 2114, 2115, 2116, 2117, 2118, 2119, 2120, 2121, 2122, 2123, 2124, 2126, 2128, 2129, 2130, 2131, 2132, 2133, 2134, 2135, 2137, 2138, 2140, 2141, 2142, 2143, 2144, 2146, 2147, 2148, 2149, 2150, 2151, 2152, 2153, 2156, 2157, 2158, 2159, 2161, 2162, 2163, 2167, 2170, 2172, 2175, 2178, 2179, 2180, 2181, 2182, 2183, 2185, 2186, 2187, 2190, 2192, 2193, 2195, 2196, 2197, 2198, 2200, 2201, 2202, 2203, 2204, 2205, 2206, 2207, 2208, 2210, 2211, 2212, 2215, 2216, 2217, 2218, 2219, 2220, 2221, 2222, 2223, 2224, 2225, 2226, 2228, 2229, 2230, 2231, 2232, 2233, 2234, 2235, 2236, 2237, 2239, 2240, 2241, 2242, 2243, 2244, 2245, 2246, 2247, 2248, 2249, 2250, 2251, 2252, 2253, 2254, 2255, 2259, 2260, 2261, 2262, 2263, 2264, 2265, 2266, 2267, 2268, 2269, 2270, 2271, 2272, 2273, 2274, 2275, 2276, 2277, 2280, 2281, 2282, 2283, 2284, 2285, 2287, 2288, 2289, 2290, 2291, 2292, 2293, 2294, 2295, 2296, 2297, 2298, 2299, 2300, 2301, 2302, 2303, 2304, 2305, 2306, 2307, 2309, 2310, 2311, 2312, 2313, 2315, 2316, 2317, 2318, 2319, 2320, 2321, 2322, 2323, 2324, 2325, 2327, 2328, 2329, 2330, 2331, 2332, 2333, 2334, 2335, 2336, 2337, 2338, 2339, 2340, 2341, 2342, 2344, 2345, 2346, 2347, 2348, 2349, 2350, 2351, 2352, 2353, 2354, 2355, 2356, 2357, 2358, 2359, 2360, 2361, 2362, 2363, 2364, 2365, 2366, 2367, 2368, 2369, 2370, 2371, 2373, 2374, 2375, 2376, 2377, 2378, 2379, 2380, 2381, 2382, 2383, 2384, 2385, 2386, 2387, 2388, 2389, 2390, 2391, 2392, 2393, 2394, 2395, 2396, 2397, 2398, 2399, 2401, 2402, 2403, 2404, 2405, 2406, 2407, 2408, 2409, 2410, 2411, 2412, 2413, 2414, 2415, 2416, 2419, 2420, 2421, 2422, 2423, 2424, 2425, 2426, 2427, 2428, 2429, 2430, 2431, 2432, 2433, 2434, 2435, 2436, 2437, 2438, 2439, 2440, 2441, 2442, 2443, 2444, 2445, 2448, 2449, 2450, 2452, 2453, 2454, 2455, 2456, 2457, 2458, 2459, 2460, 2461, 2462, 2463, 2464, 2465, 2466, 2467, 2469, 2470, 2471, 2472, 2473, 2474, 2475, 2476, 2477, 2478, 2479, 2480, 2481, 2482, 2483, 2484, 2485, 2486, 2487, 2488, 2489, 2490, 2491, 2492, 2494, 2495, 2496, 2497, 2499, 2500, 2501, 2503, 2504, 2505, 2506, 2508, 2509, 2510, 2511, 2512, 2513, 2514, 2515, 2516, 2517, 2518, 2519, 2520, 2521, 2522, 2523, 2524, 2525, 2526, 2527, 2528, 2529, 2530, 2531, 2532, 2533, 2534, 2535, 2536, 2537, 2538, 2540, 2541, 2543, 2544, 2546, 2547, 2548, 2549, 2550, 2551, 2552, 2553, 2554, 2555, 2556, 2557, 2558, 2559, 2560, 2561, 2562, 2563, 2564, 2566, 2567, 2568, 2569, 2570, 2572, 2574, 2575, 2576, 2577, 2578, 2579, 2580, 2581, 2582, 2583, 2584, 2585, 2586, 2587, 2590, 2591, 2592, 2593, 2594, 2595, 2596, 2597, 2598, 2599, 2600, 2601, 2603, 2604, 2605, 2606, 2607, 2608, 2609, 2610, 2611, 2612, 2613, 2614, 2615, 2616, 2617, 2620, 2621, 2622, 2623, 2624, 2625, 2626, 2627, 2628, 2629, 2630, 2631, 2632, 2633, 2635, 2636, 2637, 2639, 2640, 2641, 2642, 2643, 2644, 2645, 2646, 2647, 2648, 2649, 2650, 2652, 2653, 2654, 2655, 2656, 2657, 2658, 2659, 2660, 2662, 2664, 2666, 2667, 2668, 2669, 2671, 2672, 2673, 2674, 2677, 2679, 2680, 2681, 2682, 2683, 2684, 2685, 2686, 2687, 2688, 2689, 2690, 2691, 2692, 2693, 2694, 2695, 2696, 2697, 2698, 2699, 2700, 2701, 2703, 2704, 2705, 2706, 2707, 2708, 2709, 2710, 2711, 2712, 2713, 2715, 2716, 2717, 2718, 2720, 2721, 2723, 2724, 2725, 2726, 2727, 2728, 2729, 2730, 2731, 2732, 2733, 2734, 2735, 2736, 2737, 2738, 2739, 2740, 2741, 2744, 2745, 2746, 2747, 2748, 2749, 2750, 2751, 2753, 2754, 2755, 2756, 2757, 2758, 2759, 2760, 2761, 2762, 2763, 2764, 2765, 2766, 2768, 2769, 2770, 2771, 2772, 2773, 2774, 2775, 2776, 2777, 2779, 2780, 2782, 2783, 2784, 2785, 2786, 2787, 2789, 2790, 2791, 2792, 2793, 2794, 2795, 2796, 2797, 2798, 2799, 2800, 2801, 2802, 2803, 2804, 2805, 2806, 2807, 2808, 2809, 2811, 2812, 2813, 2814, 2815, 2816, 2817, 2818, 2819, 2820, 2821, 2822, 2823, 2825, 2826, 2827, 2828, 2830, 2831, 2832, 2833, 2834, 2835, 2836, 2837, 2838, 2839, 2840, 2841, 2842, 2843, 2844, 2845, 2846, 2847, 2848, 2849, 2850, 2851, 2852, 2853, 2854, 2855, 2856, 2857, 2858, 2859, 2860, 2861, 2862, 2863, 2865, 2866, 2867, 2868, 2869, 2870, 2871, 2872, 2873, 2874, 2875, 2877, 2878, 2880, 2883, 2884, 2886, 2887, 2888, 2889, 2890, 2891, 2892, 2893, 2894, 2895, 2896, 2897, 2898, 2899, 2900, 2901, 2902, 2903, 2904, 2905, 2906, 2907, 2908, 2909, 2910, 2911, 2912, 2914, 2915, 2916, 2917, 2918, 2919, 2920, 2921, 2923, 2924, 2925, 2926, 2927, 2930, 2931, 2932, 2933, 2934, 2935, 2937, 2938, 2939, 2940, 2941, 2942, 2943, 2944, 2945, 2946, 2947, 2949, 2950, 2951, 2952, 2953, 2955, 2956, 2957, 2959, 2960, 2961, 2962, 2963, 2965, 2966, 2967, 2968, 2969, 2970, 2971, 2972, 2973, 2974, 2975, 2976, 2977, 2978, 2979, 2980, 2981, 2982, 2983, 2984, 2985, 2986, 2987, 2988, 2989, 2990, 2991, 2992, 2993, 2994, 2995, 2996, 2997, 2998, 2999, 3000, 3001, 3002, 3003, 3004, 3005, 3006, 3007, 3008, 3009, 3010, 3011, 3012, 3014, 3015, 3016, 3017, 3018, 3019, 3020, 3022, 3023, 3024, 3025, 3026, 3027, 3028, 3029, 3030, 3031, 3032, 3033, 3034, 3035, 3036, 3037, 3038, 3039, 3040, 3042, 3043, 3044, 3045, 3046, 3047, 3048, 3049, 3050, 3051, 3052, 3053, 3054, 3055, 3057, 3058, 3059, 3060, 3061, 3062, 3063, 3064, 3065, 3066, 3067, 3068, 3070, 3071, 3072, 3073, 3074, 3075, 3076, 3077, 3079, 3080, 3081, 3082, 3083, 3084, 3086, 3087, 3088, 3089, 3090, 3091, 3093, 3094, 3095, 3096, 3097, 3098, 3099, 3100, 3101, 3102, 3103, 3104, 3105, 3106, 3107, 3108, 3109, 3110, 3111, 3112, 3113, 3114, 3115, 3116, 3118, 3119, 3120, 3121, 3122, 3123, 3124, 3125, 3126, 3127, 3128, 3131, 3132, 3134, 3135, 3136, 3137, 3138, 3142, 3143, 3144, 3146, 3147, 3149, 3150, 3151, 3152, 3153, 3155, 3156, 3157, 3158, 3159, 3160, 3162, 3163, 3164, 3165, 3166, 3167, 3169, 3170, 3171, 3172, 3173, 3174, 3175, 3176, 3177, 3178, 3179, 3180, 3181, 3182, 3183, 3184, 3185, 3186, 3187, 3188, 3189, 3190, 3191, 3192, 3193, 3194, 3195, 3196, 3197, 3198, 3199, 3200, 3201, 3202, 3203, 3204, 3205, 3206, 3207, 3208, 3209, 3210, 3211, 3212, 3213, 3214, 3215, 3216, 3217, 3218, 3219, 3223, 3224, 3225, 3226, 3228, 3229, 3231, 3234, 3236, 3240, 3241, 3242, 3243, 3244, 3245, 3247, 3248, 3249, 3250, 3252, 3253, 3254, 3255, 3256, 3258, 3260, 3261, 3262, 3265, 3269, 3270, 3271, 3272, 3273, 3276, 3279, 3280, 3281, 3282, 3283, 3285, 3287, 3288, 3289, 3291, 3293, 3294, 3295, 3296, 3300, 3301, 3302, 3303, 3304, 3305, 3306, 3307, 3311, 3312, 3313, 3314, 3316, 3318, 3319, 3320, 3321, 3323, 3325, 3326, 3327, 3328, 3330, 3331, 3332, 3333, 3334, 3335, 3337, 3341, 3342, 3343, 3345, 3346, 3347, 3349, 3352, 3353, 3354, 3355, 3356, 3357, 3358, 3362, 3363, 3367, 3368, 3369, 3373, 3374, 3377, 3378, 3379, 3380, 3384, 3386, 3387, 3388, 3389, 3390, 3391, 3392, 3393, 3394, 3397, 3398, 3400, 3401, 3404, 3405, 3407, 3408, 3410, 3412, 3413, 3414, 3415, 3416, 3417, 3418, 3419, 3421, 3422, 3423, 3424, 3426, 3427, 3428, 3429, 3430, 3431, 3432, 3433, 3434, 3435, 3436, 3437, 3438, 3439, 3440, 3441, 3442, 3443, 3444, 3445, 3446, 3447, 3448, 3449, 3450, 3451, 3452, 3453, 3454, 3455, 3456, 3457, 3459, 3460, 3461, 3462, 3465, 3466, 3467, 3468, 3469, 3470, 3471, 3472, 3473, 3474, 3476, 3477, 3480, 3481, 3482, 3483, 3484, 3485, 3486, 3487, 3488, 3489, 3490, 3491, 3492, 3493, 3494, 3495, 3497, 3498, 3499, 3500, 3501, 3502, 3503, 3504, 3505, 3506, 3507, 3509, 3510, 3511, 3512, 3513, 3514, 3515, 3516, 3519, 3520, 3521, 3522, 3523, 3525, 3526, 3527, 3528, 3529, 3530, 3531, 3532, 3533, 3534, 3535, 3536, 3538, 3539, 3540, 3541, 3542, 3543, 3544, 3545, 3546, 3547, 3548, 3549, 3550, 3551, 3552, 3553, 3556, 3557, 3558, 3562, 3563, 3564, 3565, 3566, 3567, 3568, 3569, 3570, 3571, 3572, 3573, 3574, 3575, 3576, 3577, 3578, 3580, 3581, 3582, 3583, 3584, 3585, 3586, 3588, 3589, 3591, 3592, 3593, 3594, 3595, 3596, 3598, 3599, 3600, 3601, 3602, 3603, 3604, 3605, 3606, 3607, 3608, 3609, 3610, 3611, 3612, 3613, 3614, 3615, 3616, 3617, 3618, 3620, 3621, 3622, 3623, 3624, 3625, 3626, 3627, 3628, 3629, 3630, 3631, 3632, 3633, 3634, 3635, 3636, 3637, 3638, 3639, 3640, 3642, 3644, 3645, 3646, 3647, 3648, 3649, 3650, 3652, 3653, 3655, 3656, 3657, 3658, 3660, 3661, 3662, 3663, 3664, 3665, 3666, 3667, 3669, 3670, 3671, 3672, 3673, 3674, 3675, 3676, 3677, 3678, 3679, 3680, 3681, 3682, 3683, 3684, 3685, 3686, 3687, 3688, 3689, 3690, 3691, 3692, 3694, 3696, 3697, 3698, 3699, 3701, 3702, 3703, 3704, 3705, 3706, 3707, 3708, 3709, 3711, 3712, 3713, 3716, 3718, 3719, 3721, 3722, 3724, 3728, 3730, 3731, 3732, 3733, 3734, 3735, 3737, 3739, 3740, 3743, 3744, 3748, 3749, 3750, 3751, 3752, 3753, 3754, 3756, 3757, 3758, 3759, 3760, 3761, 3762, 3763, 3765, 3766, 3767, 3768, 3769, 3770, 3772, 3773, 3774, 3775, 3777, 3781, 3782, 3783, 3784, 3786, 3787, 3788, 3790, 3791, 3793, 3795, 3796, 3797, 3798, 3799, 3800, 3802, 3804, 3805, 3806, 3807, 3808, 3810, 3811, 3813, 3815, 3817, 3818, 3819, 3820, 3821, 3822, 3823, 3826, 3830, 3831, 3832, 3833, 3834, 3835, 3837, 3838, 3839, 3840, 3843, 3844, 3845, 3846, 3848, 3849, 3850, 3851, 3852, 3853, 3854, 3855, 3856, 3857, 3858, 3859, 3860, 3861, 3862, 3863, 3864, 3866, 3867, 3868, 3869, 3870, 3871, 3872, 3873, 3875, 3877, 3878, 3880, 3884, 3894, 3895, 3898, 3899, 3902, 3903, 3904, 3906, 3907, 3910, 3912, 3913, 3918, 3919, 3920, 3921, 3922, 3923, 3924, 3925, 3927, 3929, 3932, 3933, 3934, 3935, 3936, 3937, 3938, 3939, 3940, 3941, 3943, 3944, 3945, 3948, 3949, 3951, 3952, 3955, 3957, 3958, 3960, 3962, 3964, 3965, 3967, 3969, 3972, 3973, 3974, 3975, 3976, 3977, 3978, 3979, 3982, 3983, 3984, 3985, 3986, 3987, 3988, 3989, 3990, 3991, 3992, 3993, 3994, 3995, 3996, 3997, 3998, 3999, 4000, 4001, 4002, 4003, 4004, 4005, 4006, 4007, 4008, 4009, 4010, 4011, 4012, 4013, 4014, 4016, 4017, 4018, 4019, 4020, 4021, 4022, 4023, 4024, 4025, 4026, 4027, 4028, 4029, 4030, 4031, 4032, 4033, 4034, 4037, 4038, 4039, 4040, 4041, 4042, 4043, 4044, 4045, 4046, 4047, 4049, 4050, 4053, 4054, 4055, 4056, 4057, 4058, 4059, 4060, 4061, 4062, 4063, 4067, 4068, 4069, 4070, 4071, 4072, 4073, 4074, 4075, 4076, 4077, 4078, 4079, 4080, 4081, 4082, 4083, 4084, 4085, 4086, 4087, 4088, 4089, 4090, 4091, 4092, 4093, 4094, 4095, 4096, 4097, 4098, 4099, 4100, 4101, 4102, 4103, 4104, 4105, 4106, 4107, 4108, 4109, 4111, 4112, 4113, 4114, 4115, 4116, 4117, 4118, 4119, 4120, 4121, 4122, 4123, 4124, 4125, 4126, 4127, 4128, 4129, 4131, 4132, 4133, 4134, 4135, 4136, 4137, 4138, 4139, 4140, 4141, 4142, 4143, 4144, 4145, 4147, 4148, 4149, 4150, 4151, 4152, 4153, 4154, 4155, 4156, 4157, 4158, 4159, 4160, 4161, 4163, 4164, 4165, 4166, 4167, 4168, 4169, 4170, 4171, 4172, 4173, 4174, 4175, 4176, 4177, 4178, 4179, 4181, 4182, 4183, 4184, 4185, 4186, 4187, 4188, 4189, 4190, 4191, 4192, 4193, 4194, 4195, 4196, 4197, 4198, 4200, 4201, 4202, 4203, 4204, 4205, 4206, 4207, 4208, 4209, 4210, 4211, 4212, 4213, 4214, 4215, 4216, 4217, 4218, 4219, 4221, 4222, 4223, 4224, 4225, 4226, 4227, 4228, 4229, 4230, 4231, 4232, 4233, 4234, 4235, 4237, 4238, 4239, 4240, 4241, 4242, 4243, 4244, 4245, 4246, 4247, 4248, 4249, 4250, 4251, 4252, 4253, 4254, 4255, 4256, 4257, 4258, 4259, 4260, 4261, 4262, 4263, 4264, 4265, 4266, 4267, 4269, 4270, 4271, 4272, 4273, 4275, 4276, 4277, 4278, 4279, 4280, 4281, 4283, 4284, 4286, 4287, 4288, 4289, 4290, 4292, 4293, 4294, 4295, 4297, 4298, 4299, 4300, 4301, 4302, 4303, 4304, 4305, 4306, 4307, 4308, 4309, 4310, 4311, 4312, 4313, 4314, 4315, 4316, 4317, 4318, 4319, 4320, 4321, 4322, 4323, 4325, 4326, 4327, 4328, 4329, 4330, 4331, 4332, 4333, 4334, 4335, 4336, 4337, 4339, 4340, 4341, 4342, 4343, 4344, 4345, 4346, 4347, 4348, 4349, 4350, 4351, 4352, 4353, 4354, 4356, 4357, 4358, 4359, 4361, 4362, 4363, 4364, 4365, 4366, 4367, 4368, 4369, 4370, 4371, 4372, 4373, 4374, 4375, 4376, 4377, 4378, 4379, 4380, 4381, 4382, 4383, 4384, 4385, 4386, 4387, 4388, 4389, 4390, 4391, 4392, 4393, 4394, 4395, 4396, 4397, 4398, 4399, 4400, 4401, 4402, 4403, 4404, 4405, 4406, 4407, 4408, 4409, 4410, 4411, 4412, 4413, 4414, 4415, 4416, 4417, 4418, 4419, 4420, 4421, 4423, 4424, 4425, 4426, 4427, 4428, 4429, 4430, 4432, 4433, 4434, 4435, 4436, 4437, 4438, 4439, 4440, 4441, 4442, 4443, 4444, 4445, 4446, 4447, 4448, 4449, 4450, 4451, 4452, 4453, 4455, 4456, 4457, 4458, 4459, 4460, 4461, 4463, 4465, 4466, 4467, 4468, 4469, 4471, 4472, 4473, 4474, 4477, 4478, 4479, 4480, 4481, 4482, 4483, 4484, 4485, 4486, 4487, 4488, 4489, 4490, 4491, 4492, 4493, 4494, 4495, 4496, 4497, 4498, 4499, 4500, 4501, 4502, 4503, 4504, 4505, 4506, 4507, 4508, 4509, 4510, 4511, 4512, 4513, 4514, 4515, 4516, 4517, 4518, 4519, 4520, 4521, 4522, 4523, 4524, 4525, 4526, 4527, 4528, 4529, 4530, 4531, 4532, 4533, 4534, 4535, 4536, 4537, 4538, 4539, 4540, 4541, 4542, 4543, 4544, 4545, 4546, 4547, 4548, 4549, 4551, 4552, 4553, 4554, 4555, 4556, 4557, 4558, 4559, 4560, 4561, 4562, 4563, 4564, 4565, 4566, 4567, 4568, 4569, 4570, 4571, 4572, 4573, 4574, 4575, 4576, 4577, 4578, 4579, 4580, 4581, 4582, 4583, 4584, 4585, 4586, 4587, 4588, 4589, 4590, 4591, 4593, 4594, 4595, 4596, 4597, 4598, 4599, 4600, 4601, 4602, 4603, 4604, 4605, 4606, 4607, 4608, 4610, 4611, 4612, 4613, 4614, 4615, 4616, 4618, 4619, 4620, 4621, 4622, 4623, 4624, 4625, 4626, 4627, 4628, 4629, 4630, 4632, 4633, 4634, 4635, 4636, 4637, 4639, 4640, 4641, 4642, 4643, 4644, 4645, 4646, 4647, 4648, 4650, 4651, 4652, 4653, 4654, 4655, 4656, 4657, 4658, 4659, 4660, 4661, 4662, 4663, 4664, 4665, 4666, 4667, 4668, 4669, 4670, 4671, 4672, 4673, 4674, 4675, 4676, 4677, 4678, 4679, 4680, 4681, 4682, 4683, 4684, 4685, 4686, 4687, 4688, 4689, 4690, 4691, 4692, 4693, 4694, 4695, 4696, 4697, 4698, 4699, 4700, 4701, 4702, 4703, 4704, 4705, 4706, 4707, 4708, 4709, 4710, 4711, 4712, 4713, 4715, 4716, 4717, 4718, 4719, 4720, 4722, 4723, 4724, 4725, 4726, 4727, 4728, 4729, 4730, 4731, 4732, 4733, 4734, 4735, 4736, 4737, 4738, 4739, 4740, 4741, 4742, 4743, 4744, 4745, 4746, 4747, 4748, 4749, 4750, 4751, 4752, 4753, 4754, 4755, 4756, 4757, 4758, 4759, 4760, 4761, 4762, 4763, 4764, 4765, 4767, 4768, 4770, 4771, 4772, 4773, 4774, 4775, 4776, 4777, 4778, 4779, 4780, 4781, 4783, 4784, 4785, 4788, 4789, 4790, 4791, 4792, 4793, 4794, 4795, 4796, 4797, 4798, 4799, 4800, 4801, 4802, 4803, 4804, 4805, 4806, 4807, 4808, 4809, 4810, 4811, 4813, 4814, 4815, 4816, 4818, 4819, 4820, 4821, 4822, 4823, 4826, 4827, 4828, 4829, 4831, 4832, 4833, 4834, 4835, 4836, 4837, 4839, 4840, 4841, 4842, 4843, 4844, 4845, 4846, 4847, 4848, 4849, 4850, 4851, 4852, 4853, 4854, 4855, 4856, 4857, 4858, 4859, 4860, 4862, 4863, 4864, 4865, 4866, 4867, 4868, 4869, 4871, 4872, 4873, 4874, 4875, 4876, 4877, 4878, 4879, 4880, 4881, 4882, 4883, 4885, 4887, 4888, 4889, 4890, 4891, 4892, 4893, 4894, 4895, 4897, 4898, 4899, 4900, 4901, 4902, 4903, 4904, 4905, 4907, 4908, 4909, 4910, 4911, 4912, 4914, 4915, 4916, 4917, 4918, 4919, 4920, 4921, 4922, 4923, 4926, 4927, 4928, 4929, 4930, 4931, 4932, 4935, 4936, 4940, 4942, 4943, 4944, 4945, 4946, 4947, 4948, 4949, 4950, 4951, 4952, 4954, 4955, 4956, 4957, 4958, 4959, 4960, 4963, 4964, 4965, 4967, 4969, 4970, 4971, 4972, 4973, 4974, 4975, 4977, 4978, 4979, 4980, 4981, 4982, 4983, 4984, 4986, 4987, 4988, 4989, 4990, 4991, 4993, 4995, 4996, 4997, 4998, 5000, 5001, 5003, 5004, 5005, 5006, 5007, 5009, 5010, 5014, 5015, 5017, 5018, 5019, 5020, 5021, 5022, 5023, 5024, 5026, 5027, 5029, 5031, 5032, 5033, 5034, 5035, 5036, 5037, 5038, 5041, 5042, 5043, 5044, 5045, 5046, 5047, 5048, 5049, 5050, 5051, 5052, 5055, 5056, 5057, 5058, 5059, 5060, 5061, 5062, 5063, 5064, 5065, 5069, 5070, 5071, 5075, 5076, 5077, 5079, 5083, 5084, 5086, 5087, 5090, 5095, 5100, 5101, 5103, 5104, 5105, 5106, 5111, 5112, 5113, 5114, 5115, 5116, 5118, 5119, 5120, 5123, 5124, 5125, 5126, 5127, 5128, 5129, 5130, 5131, 5132, 5133, 5134, 5135, 5136, 5137, 5138, 5139, 5140, 5141, 5142, 5143, 5144, 5145, 5148, 5149, 5150, 5151, 5152, 5155, 5156, 5157, 5158, 5159, 5160, 5161, 5162, 5163, 5164, 5165, 5166, 5167, 5168, 5169, 5170, 5171, 5172, 5174, 5175, 5176, 5178, 5179, 5181, 5182, 5183, 5185, 5186, 5187, 5188, 5190, 5191, 5192, 5193, 5194, 5195, 5196, 5197, 5198, 5199, 5200, 5201, 5202, 5203, 5204, 5205, 5206, 5207, 5208, 5209, 5210, 5211, 5212, 5213, 5214, 5215, 5216, 5217, 5218, 5219, 5220, 5221, 5224, 5225, 5226, 5229, 5230, 5231, 5232, 5233, 5236, 5237, 5238, 5239, 5240, 5241, 5242, 5243, 5245, 5246, 5247, 5248, 5249, 5250, 5251, 5252, 5253, 5256, 5257, 5258, 5259, 5260, 5261, 5262, 5263, 5264, 5265, 5266, 5267, 5268, 5269, 5270, 5271, 5272, 5273, 5274, 5275, 5276, 5277, 5278, 5279, 5280, 5281, 5282, 5283, 5284, 5285, 5286, 5287, 5288, 5289, 5290, 5291, 5292, 5295, 5296, 5297, 5298, 5299, 5300, 5301, 5302, 5303, 5304, 5305, 5306, 5307, 5308, 5309, 5310, 5311, 5312, 5313, 5314, 5315, 5316, 5317, 5319, 5320, 5321, 5323, 5324, 5325, 5326, 5327, 5328, 5329, 5330, 5331, 5333, 5334, 5335, 5337, 5338, 5339, 5340, 5341, 5342, 5343, 5344, 5345, 5346, 5347, 5348, 5350, 5351, 5352, 5353, 5354, 5355, 5356, 5357, 5358, 5359, 5362, 5363, 5364, 5365, 5366, 5367, 5368, 5369, 5370, 5371, 5372, 5373, 5375, 5376, 5377, 5378, 5379, 5380, 5381, 5383, 5384, 5385, 5386, 5387, 5388, 5389, 5390, 5391, 5392, 5393, 5394, 5396, 5397, 5398, 5399, 5400, 5401, 5402, 5403, 5404, 5406, 5407, 5408, 5409, 5410, 5411, 5412, 5413, 5414, 5416, 5417, 5418, 5419, 5420, 5422, 5423, 5425, 5426, 5427, 5428, 5429, 5430, 5431, 5432, 5433, 5434, 5435, 5437, 5438, 5439, 5440, 5441, 5442, 5443, 5444, 5445, 5446, 5447, 5448, 5449, 5450, 5451, 5452, 5453, 5454, 5455, 5456, 5457, 5458, 5459, 5460, 5461, 5462, 5463, 5464, 5466, 5467, 5468, 5469, 5470, 5471, 5472, 5473, 5474, 5475, 5476, 5477, 5478, 5479, 5480, 5481, 5483, 5484, 5485, 5486, 5487, 5488, 5489, 5490, 5491, 5492, 5493, 5494, 5495, 5496, 5497, 5499, 5500, 5501, 5502, 5503, 5504, 5505, 5506, 5507, 5511, 5513, 5514, 5515, 5517, 5518, 5519, 5521, 5522, 5523, 5524, 5525, 5526, 5529, 5530, 5531, 5532, 5533, 5534, 5535, 5536, 5537, 5538, 5539, 5541, 5542, 5543, 5547, 5548, 5549, 5550, 5552, 5554, 5555, 5557, 5558, 5559, 5561, 5562, 5563, 5564, 5565, 5566, 5567, 5568, 5569, 5571, 5573, 5574, 5575, 5576, 5577, 5579, 5580, 5582, 5583, 5584, 5585, 5586, 5587, 5588, 5589, 5590, 5591, 5592, 5593, 5595, 5596, 5597, 5598, 5600, 5601, 5602, 5603, 5604, 5605, 5606, 5607, 5608, 5610, 5612, 5613, 5614, 5615, 5617, 5618, 5622, 5623, 5624, 5625, 5626, 5627, 5628, 5629, 5633, 5634, 5635, 5636, 5637, 5639, 5640, 5642, 5643, 5645, 5646, 5647, 5648, 5649, 5650, 5651, 5653, 5654, 5655, 5656, 5657, 5659, 5660, 5661, 5664, 5665, 5666, 5669, 5671, 5672, 5673, 5674, 5676, 5678, 5679, 5681, 5682, 5683, 5684, 5685, 5686, 5688, 5689, 5690, 5691, 5692, 5693, 5694, 5695, 5696, 5697, 5698, 5699, 5700, 5701, 5702, 5703, 5704, 5705, 5706, 5707, 5708, 5709, 5711, 5712, 5713, 5714, 5716, 5717, 5718, 5720, 5721, 5722, 5723, 5724, 5726, 5728, 5729, 5730, 5731, 5732, 5733, 5734, 5735, 5736, 5737, 5739, 5740, 5741, 5742, 5743, 5744, 5745, 5746, 5747, 5748, 5749, 5751, 5752, 5753, 5754, 5755, 5756, 5757, 5758, 5759, 5760, 5761, 5762, 5763, 5764, 5765, 5766, 5767, 5768, 5769, 5771, 5772, 5773, 5774, 5775, 5776, 5777, 5778, 5779, 5780, 5781, 5782, 5783, 5784, 5785, 5786, 5787, 5788, 5789, 5791, 5792, 5793, 5794, 5795, 5796, 5797, 5798, 5799, 5800, 5801, 5802, 5803, 5804, 5805, 5806, 5808, 5809, 5810, 5811, 5813, 5814, 5815, 5816, 5817, 5819, 5820, 5821, 5822, 5823, 5826, 5827, 5828, 5829, 5830, 5831, 5832, 5833, 5834, 5835, 5836, 5837, 5838, 5839, 5840, 5841, 5842, 5843, 5844, 5848, 5849, 5851, 5853, 5854, 5855, 5856, 5857, 5858, 5859, 5860, 5861, 5862, 5863, 5864, 5865, 5866, 5868, 5869, 5870, 5871, 5872, 5874, 5875, 5876, 5877, 5878, 5880, 5881, 5882, 5883, 5884, 5886, 5887, 5888, 5889, 5890, 5891, 5892, 5893, 5894, 5895, 5896, 5897, 5898, 5899, 5900, 5901, 5902, 5903, 5904, 5905, 5907, 5908, 5909, 5910, 5912, 5913, 5914, 5915, 5916, 5917, 5918, 5919, 5920, 5921, 5922, 5924, 5925, 5926, 5927, 5928, 5929, 5932, 5933, 5934, 5935, 5936, 5937, 5938, 5939, 5940, 5942, 5943, 5944, 5945, 5946, 5947, 5948, 5949, 5950, 5952, 5953, 5954, 5955, 5956, 5957, 5960, 5962, 5963, 5965, 5966, 5967, 5968, 5969, 5970, 5971, 5972, 5973, 5974, 5975, 5976, 5977, 5978, 5979, 5980, 5981, 5983, 5984, 5985, 5986, 5987, 5988, 5989, 5991, 5992, 5993, 5994, 5995, 5996, 5997, 5998, 5999, 6000, 6001, 6002, 6003, 6004, 6005, 6006, 6007, 6008, 6009, 6010, 6011, 6012, 6013, 6015, 6016, 6017, 6018, 6019, 6021, 6022, 6023, 6024, 6025, 6027, 6028, 6029, 6030, 6031, 6032, 6034, 6036, 6037, 6040, 6041, 6042, 6043, 6044, 6045, 6046, 6047, 6048, 6049, 6051, 6052, 6055, 6056, 6057, 6058, 6059, 6060, 6061, 6063, 6064, 6065, 6067, 6068, 6069, 6070, 6071, 6072, 6073, 6074, 6075, 6076, 6077, 6078, 6079, 6081, 6083, 6084, 6085, 6086, 6087, 6088, 6091, 6092, 6093, 6094, 6095, 6096, 6097, 6101, 6102, 6103, 6104, 6105, 6106, 6107, 6108, 6109, 6111, 6112, 6113, 6114, 6115, 6116, 6117, 6119, 6121, 6122, 6123, 6124, 6126, 6127, 6128, 6129, 6130, 6131, 6132, 6133, 6134, 6135, 6136, 6137, 6139, 6140, 6141, 6142, 6143, 6144, 6145, 6146, 6147, 6148, 6149, 6150, 6151, 6152, 6153, 6154, 6155, 6156, 6157, 6159, 6160, 6161, 6162, 6163, 6164, 6165, 6166, 6167, 6168, 6169, 6170, 6171, 6172, 6173, 6174, 6175, 6176, 6178, 6180, 6181, 6182, 6183, 6184, 6185, 6186, 6187, 6189, 6191, 6192, 6193, 6194, 6195, 6196, 6197, 6198, 6200, 6201, 6202, 6203, 6204, 6205, 6206, 6208, 6209, 6210, 6211, 6212, 6213, 6214, 6215, 6216, 6217, 6218, 6220, 6221, 6222, 6223, 6224, 6225, 6227, 6228, 6229, 6230, 6231, 6233, 6234, 6235, 6236, 6237, 6238, 6239, 6240, 6241, 6242, 6243, 6244, 6245, 6246, 6247, 6248, 6249, 6250, 6251, 6252, 6253, 6254, 6255, 6256, 6257, 6258, 6259, 6260, 6261, 6262, 6263, 6264, 6265, 6266, 6267, 6269, 6270, 6271, 6272, 6273, 6274, 6275, 6276, 6277, 6279, 6280, 6281, 6282, 6284, 6285, 6286, 6287, 6288, 6290, 6291, 6292, 6293, 6294, 6296, 6298, 6300, 6301, 6302, 6303, 6304, 6305, 6306, 6308, 6309, 6310, 6311, 6313, 6314, 6315, 6316, 6318, 6319, 6320, 6321, 6322, 6324, 6326, 6327, 6329, 6330, 6331, 6332, 6333, 6334, 6335, 6338, 6339, 6341, 6342, 6343, 6344, 6345, 6346, 6347, 6348, 6349, 6350, 6351, 6352, 6353, 6354, 6356, 6358, 6359, 6360, 6361, 6362, 6364, 6369, 6370, 6371, 6372, 6375, 6376, 6377, 6378, 6380, 6381, 6384, 6385, 6388, 6389, 6393, 6395, 6396, 6401, 6402, 6404, 6405, 6407, 6408, 6411, 6412, 6413, 6415, 6419, 6420, 6421, 6422, 6423, 6426, 6427, 6429, 6433, 6434, 6436, 6438, 6440, 6443, 6444, 6446, 6447, 6450, 6452, 6453, 6454, 6455, 6457, 6460, 6464, 6468, 6474, 6479, 6482, 6483, 6485, 6486, 6487, 6488, 6492, 6494, 6495, 6496, 6497, 6498, 6499, 6501, 6506, 6508, 6509, 6512, 6513, 6515, 6516, 6517, 6528, 6529, 6531, 6532, 6533, 6534, 6535, 6536, 6537, 6538, 6539, 6540, 6541, 6542, 6543, 6544, 6558, 6559, 6560, 6561, 6563, 6564, 6566, 6570, 6572, 6579, 6586, 6587, 6591, 6592, 6597, 6603, 6611, 6615, 6616, 6617, 6623, 6624, 6625, 6629, 6632, 6633, 6634, 6639, 6640, 6641, 6642, 6643, 6645, 6646, 6647, 6649, 6651, 6652, 6653, 6654, 6655, 6656, 6657, 6659, 6660, 6661, 6663, 6665, 6667, 6668, 6672, 6673, 6675, 6676, 6677, 6678, 6679, 6680, 6681, 6682, 6684, 6690, 6691, 6692, 6693, 6695, 6698, 6699, 6700, 6701, 6703, 6704, 6705, 6706, 6707, 6709, 6710, 6711, 6712, 6713, 6714, 6715, 6716, 6717, 6718, 6719, 6720, 6721, 6722, 6723, 6724, 6725, 6726, 6727, 6728, 6729, 6730, 6731, 6732, 6733, 6734, 6735, 6736, 6737, 6738, 6739, 6740, 6741, 6742, 6743, 6744, 6745, 6747, 6748, 6750, 6751, 6752, 6753, 6754, 6755, 6756, 6757, 6759, 6760, 6762, 6764, 6765, 6766, 6767, 6768, 6769, 6770, 6771, 6773, 6774, 6775, 6776, 6777, 6778, 6779, 6780, 6781, 6782, 6783, 6784, 6785, 6786, 6787, 6788, 6789, 6790, 6791, 6792, 6793}",5693
12,"(('enter', ('Request For Payment SUBMITTED by EMPLOYEE', 'Request For Payment APPROVED by ADMINISTRATION')),)",1,12,"{989, 1078, 1081, 1084, 1085, 1086, 1087, 1088, 1089, 1090, 1092, 1093, 1094, 1095, 1096, 1097, 1098, 1099, 1100, 1101, 1103, 1104, 1105, 1106, 1107, 1108, 1109, 1110, 1111, 1112, 1113, 1114, 1115, 1116, 1117, 1118, 1119, 1120, 1121, 1122, 1123, 1124, 1125, 1126, 1127, 1128, 1129, 1130, 1131, 1132, 1133, 1134, 1135, 1136, 1137, 1138, 1139, 1140, 1141, 1142, 1143, 1144, 1145, 1146, 1147, 1148, 1149, 1150, 1151, 1152, 1153, 1154, 1155, 1156, 1157, 1158, 1159, 1160, 1161, 1162, 1163, 1164, 1165, 1166, 1167, 1168, 1169, 1170, 1171, 1172, 1173, 1174, 1175, 1176, 1177, 1178, 1179, 1180, 1181, 1182, 1183, 1184, 1185, 1186, 1187, 1188, 1189, 1190, 1191, 1192, 1193, 1194, 1195, 1196, 1197, 1198, 1199, 1200, 1201, 1202, 1203, 1204, 1205, 1206, 1207, 1208, 1209, 1210, 1211, 1212, 1213, 1214, 1215, 1216, 1217, 1218, 1219, 1220, 1221, 1222, 1223, 1224, 1225, 1226, 1227, 1228, 1229, 1230, 1231, 1232, 1233, 1234, 1235, 1236, 1237, 1238, 1239, 1240, 1241, 1242, 1243, 1244, 1245, 1246, 1247, 1248, 1249, 1250, 1251, 1252, 1253, 1254, 1255, 1258, 1259, 1260, 1262, 1263, 1264, 1265, 1267, 1268, 1269, 1270, 1271, 1272, 1273, 1274, 1275, 1276, 1277, 1278, 1279, 1280, 1281, 1282, 1283, 1284, 1285, 1286, 1287, 1288, 1289, 1290, 1291, 1292, 1293, 1294, 1295, 1296, 1297, 1298, 1299, 1300, 1301, 1302, 1303, 1304, 1305, 1306, 1307, 1308, 1309, 1310, 1311, 1313, 1314, 1315, 1316, 1317, 1318, 1320, 1321, 1323, 1324, 1325, 1326, 1327, 1328, 1329, 1330, 1331, 1332, 1333, 1334, 1335, 1336, 1337, 1338, 1339, 1340, 1342, 1343, 1344, 1345, 1346, 1347, 1348, 1349, 1350, 1351, 1352, 1353, 1354, 1355, 1356, 1357, 1358, 1359, 1360, 1361, 1362, 1363, 1364, 1365, 1366, 1367, 1368, 1369, 1370, 1371, 1372, 1373, 1374, 1375, 1376, 1377, 1378, 1379, 1380, 1381, 1382, 1383, 1384, 1385, 1386, 1387, 1388, 1389, 1390, 1391, 1392, 1393, 1394, 1395, 1396, 1397, 1399, 1400, 1401, 1402, 1403, 1404, 1405, 1406, 1407, 1408, 1409, 1410, 1411, 1412, 1413, 1414, 1415, 1416, 1418, 1419, 1420, 1421, 1422, 1423, 1424, 1426, 1427, 1428, 1429, 1430, 1431, 1432, 1433, 1434, 1435, 1436, 1437, 1439, 1440, 1441, 1442, 1443, 1445, 1446, 1447, 1448, 1449, 1450, 1451, 1452, 1453, 1454, 1455, 1456, 1457, 1458, 1459, 1460, 1461, 1462, 1463, 1464, 1465, 1466, 1467, 1468, 1469, 1470, 1471, 1472, 1473, 1474, 1475, 1476, 1477, 1478, 1479, 1480, 1481, 1482, 1483, 1484, 1485, 1487, 1488, 1489, 1490, 1491, 1492, 1493, 1494, 1495, 1496, 1497, 1499, 1500, 1501, 1502, 1503, 1504, 1505, 1506, 1507, 1508, 1509, 1510, 1511, 1512, 1513, 1514, 1515, 1516, 1517, 1518, 1519, 1520, 1521, 1522, 1523, 1524, 1525, 1526, 1527, 1528, 1529, 1530, 1531, 1532, 1533, 1534, 1535, 1536, 1537, 1538, 1539, 1540, 1541, 1542, 1543, 1544, 1545, 1546, 1548, 1549, 1550, 1551, 1552, 1553, 1554, 1556, 1557, 1558, 1559, 1560, 1561, 1562, 1563, 1564, 1565, 1566, 1567, 1568, 1569, 1570, 1571, 1572, 1573, 1574, 1575, 1576, 1577, 1578, 1579, 1580, 1581, 1582, 1583, 1584, 1585, 1586, 1587, 1588, 1589, 1590, 1591, 1592, 1593, 1594, 1595, 1596, 1597, 1598, 1599, 1600, 1601, 1602, 1603, 1604, 1605, 1606, 1607, 1608, 1609, 1610, 1612, 1613, 1614, 1615, 1616, 1617, 1618, 1619, 1620, 1621, 1622, 1623, 1624, 1625, 1626, 1627, 1628, 1629, 1630, 1631, 1632, 1633, 1634, 1635, 1636, 1637, 1638, 1639, 1640, 1641, 1642, 1643, 1644, 1645, 1646, 1647, 1648, 1649, 1650, 1651, 1652, 1653, 1654, 1655, 1656, 1657, 1658, 1659, 1660, 1661, 1662, 1663, 1664, 1665, 1666, 1667, 1668, 1669, 1670, 1671, 1672, 1673, 1674, 1675, 1676, 1677, 1678, 1679, 1680, 1681, 1682, 1683, 1684, 1685, 1686, 1687, 1688, 1689, 1690, 1691, 1692, 1693, 1694, 1695, 1696, 1697, 1698, 1699, 1700, 1701, 1702, 1703, 1704, 1705, 1706, 1707, 1708, 1709, 1710, 1711, 1712, 1713, 1714, 1715, 1716, 1717, 1718, 1719, 1720, 1721, 1722, 1723, 1724, 1725, 1726, 1727, 1728, 1729, 1730, 1731, 1732, 1734, 1735, 1736, 1737, 1738, 1739, 1740, 1741, 1742, 1743, 1744, 1745, 1746, 1747, 1748, 1749, 1752, 1753, 1754, 1755, 1756, 1757, 1758, 1759, 1760, 1761, 1762, 1764, 1765, 1766, 1767, 1768, 1769, 1770, 1771, 1772, 1773, 1774, 1775, 1776, 1778, 1779, 1780, 1781, 1782, 1783, 1784, 1785, 1786, 1787, 1788, 1789, 1790, 1791, 1792, 1793, 1795, 1796, 1797, 1798, 1799, 1800, 1801, 1802, 1803, 1804, 1805, 1806, 1807, 1808, 1809, 1810, 1811, 1812, 1813, 1814, 1815, 1816, 1817, 1818, 1819, 1820, 1821, 1822, 1823, 1824, 1825, 1826, 1827, 1828, 1829, 1830, 1831, 1832, 1833, 1834, 1835, 1836, 1837, 1838, 1839, 1840, 1841, 1842, 1843, 1844, 1845, 1846, 1847, 1848, 1849, 1850, 1851, 1852, 1853, 1854, 1855, 1857, 1858, 1859, 1860, 1861, 1862, 1863, 1864, 1865, 1866, 1867, 1868, 1869, 1870, 1871, 1872, 1873, 1874, 1875, 1876, 1877, 1878, 1879, 1880, 1881, 1882, 1883, 1884, 1885, 1886, 1887, 1888, 1889, 1890, 1891, 1892, 1893, 1894, 1895, 1896, 1897, 1898, 1899, 1900, 1901, 1902, 1903, 1904, 1905, 1907, 1908, 1909, 1910, 1911, 1912, 1914, 1915, 1916, 1918, 1919, 1920, 1921, 1922, 1923, 1924, 1925, 1926, 1927, 1928, 1929, 1930, 1931, 1932, 1934, 1936, 1937, 1938, 1939, 1940, 1941, 1942, 1943, 1944, 1945, 1946, 1947, 1948, 1949, 1950, 1951, 1952, 1954, 1955, 1956, 1957, 1958, 1959, 1960, 1961, 1962, 1963, 1964, 1965, 1966, 1967, 1968, 1969, 1970, 1971, 1972, 1973, 1974, 1975, 1976, 1977, 1978, 1979, 1980, 1981, 1982, 1983, 1984, 1985, 1986, 1987, 1988, 1990, 1991, 1992, 1993, 1994, 1995, 1996, 1997, 1998, 1999, 2000, 2001, 2002, 2003, 2004, 2005, 2006, 2007, 2008, 2009, 2010, 2011, 2012, 2014, 2015, 2016, 2017, 2018, 2019, 2020, 2021, 2022, 2023, 2024, 2025, 2026, 2027, 2028, 2029, 2030, 2031, 2032, 2033, 2034, 2035, 2036, 2037, 2038, 2039, 2040, 2041, 2042, 2043, 2044, 2045, 2046, 2047, 2048, 2049, 2050, 2051, 2052, 2053, 2055, 2056, 2057, 2058, 2059, 2060, 2061, 2062, 2063, 2064, 2065, 2066, 2067, 2068, 2069, 2070, 2071, 2073, 2074, 2075, 2076, 2077, 2079, 2080, 2081, 2082, 2083, 2084, 2085, 2086, 2087, 2088, 2089, 2090, 2091, 2092, 2094, 2095, 2096, 2097, 2098, 2099, 2100, 2101, 2102, 2103, 2104, 2106, 2107, 2108, 2109, 2110, 2111, 2112, 2113, 2114, 2115, 2116, 2117, 2118, 2119, 2120, 2121, 2122, 2123, 2124, 2125, 2126, 2128, 2129, 2130, 2131, 2132, 2133, 2134, 2135, 2137, 2138, 2139, 2140, 2141, 2142, 2143, 2144, 2145, 2146, 2147, 2148, 2149, 2150, 2151, 2152, 2153, 2154, 2155, 2156, 2157, 2158, 2159, 2160, 2161, 2162, 2163, 2164, 2166, 2167, 2168, 2169, 2170, 2171, 2172, 2173, 2174, 2175, 2176, 2177, 2178, 2179, 2180, 2181, 2182, 2183, 2184, 2185, 2186, 2187, 2188, 2189, 2190, 2191, 2192, 2193, 2194, 2195, 2196, 2197, 2198, 2200, 2201, 2202, 2203, 2204, 2205, 2206, 2207, 2208, 2209, 2210, 2211, 2212, 2213, 2214, 2215, 2216, 2217, 2218, 2219, 2220, 2221, 2222, 2223, 2224, 2225, 2226, 2228, 2229, 2230, 2231, 2232, 2233, 2234, 2235, 2236, 2237, 2239, 2240, 2241, 2242, 2243, 2244, 2245, 2246, 2247, 2248, 2249, 2250, 2251, 2252, 2253, 2254, 2255, 2259, 2260, 2261, 2262, 2263, 2264, 2265, 2266, 2267, 2268, 2269, 2270, 2271, 2272, 2273, 2274, 2275, 2276, 2277, 2280, 2281, 2282, 2283, 2284, 2285, 2287, 2288, 2289, 2290, 2291, 2292, 2293, 2294, 2295, 2296, 2297, 2298, 2299, 2300, 2301, 2302, 2303, 2304, 2305, 2306, 2307, 2309, 2310, 2311, 2312, 2313, 2314, 2315, 2316, 2317, 2318, 2319, 2320, 2321, 2322, 2323, 2324, 2325, 2327, 2328, 2329, 2330, 2331, 2332, 2333, 2334, 2335, 2336, 2337, 2338, 2339, 2340, 2341, 2342, 2344, 2345, 2346, 2347, 2348, 2349, 2350, 2351, 2352, 2353, 2354, 2355, 2356, 2357, 2358, 2359, 2360, 2361, 2362, 2363, 2364, 2365, 2366, 2367, 2368, 2369, 2370, 2371, 2373, 2374, 2375, 2376, 2377, 2378, 2379, 2380, 2381, 2382, 2383, 2384, 2385, 2386, 2387, 2388, 2389, 2390, 2391, 2392, 2393, 2394, 2395, 2396, 2397, 2398, 2399, 2401, 2402, 2403, 2404, 2405, 2406, 2407, 2408, 2409, 2410, 2411, 2412, 2413, 2414, 2415, 2416, 2419, 2420, 2421, 2422, 2423, 2424, 2425, 2426, 2427, 2428, 2429, 2430, 2431, 2432, 2433, 2434, 2435, 2436, 2437, 2438, 2439, 2440, 2441, 2442, 2443, 2444, 2445, 2446, 2447, 2448, 2449, 2450, 2452, 2453, 2454, 2455, 2456, 2457, 2458, 2459, 2460, 2461, 2462, 2463, 2464, 2465, 2466, 2467, 2469, 2470, 2471, 2472, 2473, 2474, 2475, 2476, 2477, 2478, 2479, 2480, 2481, 2482, 2483, 2484, 2485, 2486, 2487, 2488, 2489, 2490, 2491, 2492, 2494, 2495, 2496, 2497, 2498, 2499, 2500, 2501, 2502, 2503, 2504, 2505, 2506, 2508, 2509, 2510, 2511, 2512, 2513, 2514, 2515, 2516, 2517, 2518, 2519, 2520, 2521, 2522, 2523, 2524, 2525, 2526, 2527, 2528, 2529, 2530, 2531, 2532, 2533, 2534, 2535, 2536, 2537, 2538, 2540, 2541, 2542, 2543, 2544, 2545, 2546, 2547, 2548, 2549, 2550, 2551, 2552, 2553, 2554, 2555, 2556, 2557, 2558, 2559, 2560, 2561, 2562, 2563, 2564, 2566, 2567, 2568, 2569, 2570, 2572, 2573, 2574, 2575, 2576, 2577, 2578, 2579, 2580, 2581, 2582, 2583, 2584, 2585, 2586, 2587, 2590, 2591, 2592, 2593, 2594, 2595, 2596, 2597, 2598, 2599, 2600, 2601, 2603, 2604, 2605, 2606, 2607, 2608, 2609, 2610, 2611, 2612, 2613, 2614, 2615, 2616, 2617, 2620, 2621, 2622, 2623, 2624, 2625, 2626, 2627, 2628, 2629, 2630, 2631, 2632, 2633, 2635, 2636, 2637, 2638, 2639, 2640, 2641, 2642, 2643, 2644, 2645, 2646, 2647, 2648, 2649, 2650, 2652, 2653, 2654, 2655, 2656, 2657, 2658, 2659, 2660, 2662, 2664, 2665, 2666, 2667, 2668, 2669, 2671, 2672, 2673, 2674, 2677, 2679, 2680, 2681, 2682, 2683, 2684, 2685, 2686, 2687, 2688, 2689, 2690, 2691, 2692, 2693, 2694, 2695, 2696, 2697, 2698, 2699, 2700, 2701, 2703, 2704, 2705, 2706, 2707, 2708, 2709, 2710, 2711, 2712, 2713, 2715, 2716, 2717, 2718, 2720, 2721, 2723, 2724, 2725, 2726, 2727, 2728, 2729, 2730, 2731, 2732, 2733, 2734, 2735, 2736, 2737, 2738, 2739, 2740, 2741, 2744, 2745, 2746, 2747, 2748, 2749, 2750, 2751, 2753, 2754, 2755, 2756, 2757, 2758, 2759, 2760, 2761, 2762, 2763, 2764, 2765, 2766, 2768, 2769, 2770, 2771, 2772, 2773, 2774, 2775, 2776, 2777, 2778, 2779, 2780, 2782, 2783, 2784, 2785, 2786, 2787, 2789, 2790, 2791, 2792, 2793, 2794, 2795, 2796, 2797, 2798, 2799, 2800, 2801, 2802, 2803, 2804, 2805, 2806, 2807, 2808, 2809, 2811, 2812, 2813, 2814, 2815, 2816, 2817, 2818, 2819, 2820, 2821, 2822, 2823, 2825, 2826, 2827, 2828, 2830, 2831, 2832, 2833, 2834, 2835, 2836, 2837, 2838, 2839, 2840, 2841, 2842, 2843, 2844, 2845, 2846, 2847, 2848, 2849, 2850, 2851, 2852, 2853, 2854, 2855, 2856, 2857, 2858, 2859, 2860, 2861, 2862, 2863, 2865, 2866, 2867, 2868, 2869, 2870, 2871, 2872, 2873, 2874, 2875, 2877, 2878, 2880, 2883, 2884, 2886, 2887, 2888, 2889, 2890, 2891, 2892, 2893, 2894, 2895, 2896, 2897, 2898, 2899, 2900, 2901, 2902, 2903, 2904, 2905, 2906, 2907, 2908, 2909, 2910, 2911, 2912, 2914, 2915, 2916, 2917, 2918, 2919, 2920, 2921, 2923, 2924, 2925, 2926, 2927, 2930, 2931, 2932, 2933, 2934, 2935, 2937, 2938, 2939, 2940, 2941, 2942, 2943, 2944, 2945, 2946, 2947, 2949, 2950, 2951, 2952, 2953, 2955, 2956, 2957, 2959, 2960, 2961, 2962, 2963, 2965, 2966, 2967, 2968, 2969, 2970, 2971, 2972, 2973, 2974, 2975, 2976, 2977, 2978, 2979, 2980, 2981, 2982, 2983, 2984, 2985, 2986, 2987, 2988, 2989, 2990, 2991, 2992, 2993, 2994, 2995, 2996, 2997, 2998, 2999, 3000, 3001, 3002, 3003, 3004, 3005, 3006, 3007, 3008, 3009, 3010, 3011, 3012, 3014, 3015, 3016, 3017, 3018, 3019, 3020, 3022, 3023, 3024, 3025, 3026, 3027, 3028, 3029, 3030, 3031, 3032, 3033, 3034, 3035, 3036, 3037, 3038, 3039, 3040, 3042, 3043, 3044, 3045, 3046, 3047, 3048, 3049, 3050, 3051, 3052, 3053, 3054, 3055, 3057, 3058, 3059, 3060, 3061, 3062, 3063, 3064, 3065, 3066, 3067, 3068, 3070, 3071, 3072, 3073, 3074, 3075, 3076, 3077, 3079, 3080, 3081, 3082, 3083, 3084, 3086, 3087, 3088, 3089, 3090, 3091, 3093, 3094, 3095, 3096, 3097, 3098, 3099, 3100, 3101, 3102, 3103, 3104, 3105, 3106, 3107, 3108, 3109, 3110, 3111, 3112, 3113, 3114, 3115, 3116, 3118, 3119, 3120, 3121, 3122, 3123, 3124, 3125, 3126, 3127, 3128, 3131, 3132, 3133, 3134, 3135, 3136, 3137, 3138, 3139, 3141, 3142, 3143, 3144, 3146, 3147, 3149, 3150, 3151, 3152, 3153, 3154, 3155, 3156, 3157, 3158, 3159, 3160, 3162, 3163, 3164, 3165, 3166, 3167, 3168, 3169, 3170, 3171, 3172, 3173, 3174, 3175, 3176, 3177, 3178, 3179, 3180, 3181, 3182, 3183, 3184, 3185, 3186, 3187, 3188, 3189, 3190, 3191, 3192, 3193, 3194, 3195, 3196, 3197, 3198, 3199, 3200, 3201, 3202, 3203, 3204, 3205, 3206, 3207, 3208, 3209, 3210, 3211, 3212, 3213, 3214, 3215, 3216, 3217, 3218, 3219, 3222, 3223, 3224, 3225, 3226, 3227, 3228, 3229, 3231, 3232, 3233, 3234, 3236, 3240, 3241, 3242, 3243, 3244, 3245, 3247, 3248, 3249, 3250, 3251, 3252, 3253, 3254, 3255, 3256, 3257, 3258, 3259, 3260, 3261, 3262, 3263, 3265, 3269, 3270, 3271, 3272, 3273, 3276, 3277, 3279, 3280, 3281, 3282, 3283, 3284, 3285, 3286, 3287, 3288, 3289, 3291, 3292, 3293, 3294, 3295, 3296, 3298, 3299, 3300, 3301, 3302, 3303, 3304, 3305, 3306, 3307, 3308, 3310, 3311, 3312, 3313, 3314, 3316, 3317, 3318, 3319, 3320, 3321, 3322, 3323, 3325, 3326, 3327, 3328, 3329, 3330, 3331, 3332, 3333, 3334, 3335, 3336, 3337, 3338, 3339, 3340, 3341, 3342, 3343, 3344, 3345, 3346, 3347, 3349, 3350, 3351, 3352, 3353, 3354, 3355, 3356, 3357, 3358, 3359, 3360, 3362, 3363, 3364, 3365, 3366, 3367, 3368, 3369, 3370, 3371, 3372, 3373, 3374, 3375, 3376, 3377, 3378, 3379, 3380, 3381, 3382, 3383, 3384, 3386, 3387, 3388, 3389, 3390, 3391, 3392, 3393, 3394, 3396, 3397, 3398, 3399, 3400, 3401, 3402, 3403, 3404, 3405, 3406, 3407, 3408, 3410, 3411, 3412, 3413, 3414, 3415, 3416, 3417, 3418, 3419, 3421, 3422, 3423, 3424, 3426, 3427, 3428, 3429, 3430, 3431, 3432, 3433, 3434, 3435, 3436, 3437, 3438, 3439, 3440, 3441, 3442, 3443, 3444, 3445, 3446, 3447, 3448, 3449, 3450, 3451, 3452, 3453, 3454, 3455, 3456, 3457, 3459, 3460, 3461, 3462, 3463, 3465, 3466, 3467, 3468, 3469, 3470, 3471, 3472, 3473, 3474, 3475, 3476, 3477, 3480, 3481, 3482, 3483, 3484, 3485, 3486, 3487, 3488, 3489, 3490, 3491, 3492, 3493, 3494, 3495, 3497, 3498, 3499, 3500, 3501, 3502, 3503, 3504, 3505, 3506, 3507, 3509, 3510, 3511, 3512, 3513, 3514, 3515, 3516, 3519, 3520, 3521, 3522, 3523, 3525, 3526, 3527, 3528, 3529, 3530, 3531, 3532, 3533, 3534, 3535, 3536, 3538, 3539, 3540, 3541, 3542, 3543, 3544, 3545, 3546, 3547, 3548, 3549, 3550, 3551, 3552, 3553, 3554, 3556, 3557, 3558, 3559, 3562, 3563, 3564, 3565, 3566, 3567, 3568, 3569, 3570, 3571, 3572, 3573, 3574, 3575, 3576, 3577, 3578, 3580, 3581, 3582, 3583, 3584, 3585, 3586, 3588, 3589, 3591, 3592, 3593, 3594, 3595, 3596, 3598, 3599, 3600, 3601, 3602, 3603, 3604, 3605, 3606, 3607, 3608, 3609, 3610, 3611, 3612, 3613, 3614, 3615, 3616, 3617, 3618, 3620, 3621, 3622, 3623, 3624, 3625, 3626, 3627, 3628, 3629, 3630, 3631, 3632, 3633, 3634, 3635, 3636, 3637, 3638, 3639, 3640, 3642, 3644, 3645, 3646, 3647, 3648, 3649, 3650, 3651, 3652, 3653, 3655, 3656, 3657, 3658, 3660, 3661, 3662, 3663, 3664, 3665, 3666, 3667, 3668, 3669, 3670, 3671, 3672, 3673, 3674, 3675, 3676, 3677, 3678, 3679, 3680, 3681, 3682, 3683, 3684, 3685, 3686, 3687, 3688, 3689, 3690, 3691, 3692, 3693, 3694, 3696, 3697, 3698, 3699, 3700, 3701, 3702, 3703, 3704, 3705, 3706, 3707, 3708, 3709, 3710, 3711, 3712, 3713, 3716, 3717, 3718, 3719, 3721, 3722, 3724, 3728, 3729, 3730, 3731, 3732, 3733, 3734, 3735, 3736, 3737, 3738, 3739, 3740, 3743, 3744, 3748, 3749, 3750, 3751, 3752, 3753, 3754, 3756, 3757, 3758, 3759, 3760, 3761, 3762, 3763, 3764, 3765, 3766, 3767, 3768, 3769, 3770, 3772, 3773, 3774, 3775, 3776, 3777, 3778, 3779, 3781, 3782, 3783, 3784, 3785, 3786, 3787, 3788, 3789, 3790, 3791, 3792, 3793, 3794, 3795, 3796, 3797, 3798, 3799, 3800, 3801, 3802, 3803, 3804, 3805, 3806, 3807, 3808, 3809, 3810, 3811, 3812, 3813, 3814, 3815, 3817, 3818, 3819, 3820, 3821, 3822, 3823, 3825, 3826, 3827, 3828, 3829, 3830, 3831, 3832, 3833, 3834, 3835, 3836, 3837, 3838, 3839, 3840, 3841, 3843, 3844, 3845, 3846, 3847, 3848, 3849, 3850, 3851, 3852, 3853, 3854, 3855, 3856, 3857, 3858, 3859, 3860, 3861, 3862, 3863, 3864, 3866, 3867, 3868, 3869, 3870, 3871, 3872, 3873, 3874, 3875, 3877, 3878, 3879, 3880, 3884, 3886, 3887, 3888, 3889, 3890, 3891, 3892, 3893, 3894, 3895, 3896, 3897, 3898, 3899, 3900, 3901, 3902, 3903, 3904, 3905, 3906, 3907, 3908, 3910, 3912, 3913, 3915, 3917, 3918, 3919, 3920, 3921, 3922, 3923, 3924, 3925, 3926, 3927, 3928, 3929, 3930, 3932, 3933, 3934, 3935, 3936, 3937, 3938, 3939, 3940, 3941, 3943, 3944, 3945, 3946, 3947, 3948, 3949, 3950, 3951, 3952, 3953, 3954, 3955, 3956, 3957, 3958, 3959, 3960, 3962, 3963, 3964, 3965, 3966, 3967, 3969, 3972, 3973, 3974, 3975, 3976, 3977, 3978, 3979, 3980, 3981, 3982, 3983, 3984, 3985, 3986, 3987, 3988, 3989, 3990, 3991, 3992, 3993, 3994, 3995, 3996, 3997, 3998, 3999, 4000, 4001, 4002, 4003, 4004, 4005, 4006, 4007, 4008, 4009, 4010, 4011, 4012, 4013, 4014, 4016, 4017, 4018, 4019, 4020, 4021, 4022, 4023, 4024, 4025, 4026, 4027, 4028, 4029, 4030, 4031, 4032, 4033, 4034, 4037, 4038, 4039, 4040, 4041, 4042, 4043, 4044, 4045, 4046, 4047, 4049, 4050, 4053, 4054, 4055, 4056, 4057, 4058, 4059, 4060, 4061, 4062, 4063, 4066, 4067, 4068, 4069, 4070, 4071, 4072, 4073, 4074, 4075, 4076, 4077, 4078, 4079, 4080, 4081, 4082, 4083, 4084, 4085, 4086, 4087, 4088, 4089, 4090, 4091, 4092, 4093, 4094, 4095, 4096, 4097, 4098, 4099, 4100, 4101, 4102, 4103, 4104, 4105, 4106, 4107, 4108, 4109, 4110, 4111, 4112, 4113, 4114, 4115, 4116, 4117, 4118, 4119, 4120, 4121, 4122, 4123, 4124, 4125, 4126, 4127, 4128, 4129, 4130, 4131, 4132, 4133, 4134, 4135, 4136, 4137, 4138, 4139, 4140, 4141, 4142, 4143, 4144, 4145, 4147, 4148, 4149, 4150, 4151, 4152, 4153, 4154, 4155, 4156, 4157, 4158, 4159, 4160, 4161, 4163, 4164, 4165, 4166, 4167, 4168, 4169, 4170, 4171, 4172, 4173, 4174, 4175, 4176, 4177, 4178, 4179, 4181, 4182, 4183, 4184, 4185, 4186, 4187, 4188, 4189, 4190, 4191, 4192, 4193, 4194, 4195, 4196, 4197, 4198, 4200, 4201, 4202, 4203, 4204, 4205, 4206, 4207, 4208, 4209, 4210, 4211, 4212, 4213, 4214, 4215, 4216, 4217, 4218, 4219, 4221, 4222, 4223, 4224, 4225, 4226, 4227, 4228, 4229, 4230, 4231, 4232, 4233, 4234, 4235, 4237, 4238, 4239, 4240, 4241, 4242, 4243, 4244, 4245, 4246, 4247, 4248, 4249, 4250, 4251, 4252, 4253, 4254, 4255, 4256, 4257, 4258, 4259, 4260, 4261, 4262, 4263, 4264, 4265, 4266, 4267, 4269, 4270, 4271, 4272, 4273, 4274, 4275, 4276, 4277, 4278, 4279, 4280, 4281, 4282, 4283, 4284, 4286, 4287, 4288, 4289, 4290, 4292, 4293, 4294, 4295, 4297, 4298, 4299, 4300, 4301, 4302, 4303, 4304, 4305, 4306, 4307, 4308, 4309, 4310, 4311, 4312, 4313, 4314, 4315, 4316, 4317, 4318, 4319, 4320, 4321, 4322, 4323, 4325, 4326, 4327, 4328, 4329, 4330, 4331, 4332, 4333, 4334, 4335, 4336, 4337, 4339, 4340, 4341, 4342, 4343, 4344, 4345, 4346, 4347, 4348, 4349, 4350, 4351, 4352, 4353, 4354, 4355, 4356, 4357, 4358, 4359, 4361, 4362, 4363, 4364, 4365, 4366, 4367, 4368, 4369, 4370, 4371, 4372, 4373, 4374, 4375, 4376, 4377, 4378, 4379, 4380, 4381, 4382, 4383, 4384, 4385, 4386, 4387, 4388, 4389, 4390, 4391, 4392, 4393, 4394, 4395, 4396, 4397, 4398, 4399, 4400, 4401, 4402, 4403, 4404, 4405, 4406, 4407, 4408, 4409, 4410, 4411, 4412, 4413, 4414, 4415, 4416, 4417, 4418, 4419, 4420, 4421, 4422, 4423, 4424, 4425, 4426, 4427, 4428, 4429, 4430, 4432, 4433, 4434, 4435, 4436, 4437, 4438, 4439, 4440, 4441, 4442, 4443, 4444, 4445, 4446, 4447, 4448, 4449, 4450, 4451, 4452, 4453, 4455, 4456, 4457, 4458, 4459, 4460, 4461, 4463, 4465, 4466, 4467, 4468, 4469, 4471, 4472, 4473, 4474, 4477, 4478, 4479, 4480, 4481, 4482, 4483, 4484, 4485, 4486, 4487, 4488, 4489, 4490, 4491, 4492, 4493, 4494, 4495, 4496, 4497, 4498, 4499, 4500, 4501, 4502, 4503, 4504, 4505, 4506, 4507, 4508, 4509, 4510, 4511, 4512, 4513, 4514, 4515, 4516, 4517, 4518, 4519, 4520, 4521, 4522, 4523, 4524, 4525, 4526, 4527, 4528, 4529, 4530, 4531, 4532, 4533, 4534, 4535, 4536, 4537, 4538, 4539, 4540, 4541, 4542, 4543, 4544, 4545, 4546, 4547, 4548, 4549, 4551, 4552, 4553, 4554, 4555, 4556, 4557, 4558, 4559, 4560, 4561, 4562, 4563, 4564, 4565, 4566, 4567, 4568, 4569, 4570, 4571, 4572, 4573, 4574, 4575, 4576, 4577, 4578, 4579, 4580, 4581, 4582, 4583, 4584, 4585, 4586, 4587, 4588, 4589, 4590, 4591, 4593, 4594, 4595, 4596, 4597, 4598, 4599, 4600, 4601, 4602, 4603, 4604, 4605, 4606, 4607, 4608, 4610, 4611, 4612, 4613, 4614, 4615, 4616, 4618, 4619, 4620, 4621, 4622, 4623, 4624, 4625, 4626, 4627, 4628, 4629, 4630, 4632, 4633, 4634, 4635, 4636, 4637, 4639, 4640, 4641, 4642, 4643, 4644, 4645, 4646, 4647, 4648, 4650, 4651, 4652, 4653, 4654, 4655, 4656, 4657, 4658, 4659, 4660, 4661, 4662, 4663, 4664, 4665, 4666, 4667, 4668, 4669, 4670, 4671, 4672, 4673, 4674, 4675, 4676, 4677, 4678, 4679, 4680, 4681, 4682, 4683, 4684, 4685, 4686, 4687, 4688, 4689, 4690, 4691, 4692, 4693, 4694, 4695, 4696, 4697, 4698, 4699, 4700, 4701, 4702, 4703, 4704, 4705, 4706, 4707, 4708, 4709, 4710, 4711, 4712, 4713, 4714, 4715, 4716, 4717, 4718, 4719, 4720, 4722, 4723, 4724, 4725, 4726, 4727, 4728, 4729, 4730, 4731, 4732, 4733, 4734, 4735, 4736, 4737, 4738, 4739, 4740, 4741, 4742, 4743, 4744, 4745, 4746, 4747, 4748, 4749, 4750, 4751, 4752, 4753, 4754, 4755, 4756, 4757, 4758, 4759, 4760, 4761, 4762, 4763, 4764, 4765, 4767, 4768, 4770, 4771, 4772, 4773, 4774, 4775, 4776, 4777, 4778, 4779, 4780, 4781, 4782, 4783, 4784, 4785, 4788, 4789, 4790, 4791, 4792, 4793, 4794, 4795, 4796, 4797, 4798, 4799, 4800, 4801, 4802, 4803, 4804, 4805, 4806, 4807, 4808, 4809, 4810, 4811, 4813, 4814, 4815, 4816, 4817, 4818, 4819, 4820, 4821, 4822, 4823, 4825, 4826, 4827, 4828, 4829, 4830, 4831, 4832, 4833, 4834, 4835, 4836, 4837, 4838, 4839, 4840, 4841, 4842, 4843, 4844, 4845, 4846, 4847, 4848, 4849, 4850, 4851, 4852, 4853, 4854, 4855, 4856, 4857, 4858, 4859, 4860, 4861, 4862, 4863, 4864, 4865, 4866, 4867, 4868, 4869, 4871, 4872, 4873, 4874, 4875, 4876, 4877, 4878, 4879, 4880, 4881, 4882, 4883, 4884, 4885, 4887, 4888, 4889, 4890, 4891, 4892, 4893, 4894, 4895, 4897, 4898, 4899, 4900, 4901, 4902, 4903, 4904, 4905, 4906, 4907, 4908, 4909, 4910, 4911, 4912, 4914, 4915, 4916, 4917, 4918, 4919, 4920, 4921, 4922, 4923, 4924, 4925, 4926, 4927, 4928, 4929, 4930, 4931, 4932, 4933, 4934, 4935, 4936, 4937, 4938, 4939, 4940, 4942, 4943, 4944, 4945, 4946, 4947, 4948, 4949, 4950, 4951, 4952, 4953, 4954, 4955, 4956, 4957, 4958, 4959, 4960, 4961, 4962, 4963, 4964, 4965, 4967, 4968, 4969, 4970, 4971, 4972, 4973, 4974, 4975, 4977, 4978, 4979, 4980, 4981, 4982, 4983, 4984, 4986, 4987, 4988, 4989, 4990, 4991, 4993, 4994, 4995, 4996, 4997, 4998, 4999, 5000, 5001, 5002, 5003, 5004, 5005, 5006, 5007, 5009, 5010, 5011, 5012, 5013, 5014, 5015, 5016, 5017, 5018, 5019, 5020, 5021, 5022, 5023, 5024, 5025, 5026, 5027, 5028, 5029, 5031, 5032, 5033, 5034, 5035, 5036, 5037, 5038, 5039, 5040, 5041, 5042, 5043, 5044, 5045, 5046, 5047, 5048, 5049, 5050, 5051, 5052, 5053, 5055, 5056, 5057, 5058, 5059, 5060, 5061, 5062, 5063, 5064, 5065, 5066, 5067, 5068, 5069, 5070, 5071, 5072, 5073, 5074, 5075, 5076, 5077, 5078, 5079, 5080, 5081, 5082, 5083, 5084, 5085, 5086, 5087, 5090, 5091, 5092, 5093, 5094, 5095, 5096, 5097, 5098, 5099, 5100, 5101, 5102, 5103, 5104, 5105, 5106, 5107, 5108, 5109, 5110, 5111, 5112, 5113, 5114, 5115, 5116, 5117, 5118, 5119, 5120, 5121, 5122, 5123, 5124, 5125, 5126, 5127, 5128, 5129, 5130, 5131, 5132, 5133, 5134, 5135, 5136, 5137, 5138, 5139, 5140, 5141, 5142, 5143, 5144, 5145, 5147, 5148, 5149, 5150, 5151, 5152, 5153, 5155, 5156, 5157, 5158, 5159, 5160, 5161, 5162, 5163, 5164, 5165, 5166, 5167, 5168, 5169, 5170, 5171, 5172, 5174, 5175, 5176, 5178, 5179, 5181, 5182, 5183, 5185, 5186, 5187, 5188, 5190, 5191, 5192, 5193, 5194, 5195, 5196, 5197, 5198, 5199, 5200, 5201, 5202, 5203, 5204, 5205, 5206, 5207, 5208, 5209, 5210, 5211, 5212, 5213, 5214, 5215, 5216, 5217, 5218, 5219, 5220, 5221, 5224, 5225, 5226, 5229, 5230, 5231, 5232, 5233, 5234, 5236, 5237, 5238, 5239, 5240, 5241, 5242, 5243, 5245, 5246, 5247, 5248, 5249, 5250, 5251, 5252, 5253, 5254, 5256, 5257, 5258, 5259, 5260, 5261, 5262, 5263, 5264, 5265, 5266, 5267, 5268, 5269, 5270, 5271, 5272, 5273, 5274, 5275, 5276, 5277, 5278, 5279, 5280, 5281, 5282, 5283, 5284, 5285, 5286, 5287, 5288, 5289, 5290, 5291, 5292, 5294, 5295, 5296, 5297, 5298, 5299, 5300, 5301, 5302, 5303, 5304, 5305, 5306, 5307, 5308, 5309, 5310, 5311, 5312, 5313, 5314, 5315, 5316, 5317, 5319, 5320, 5321, 5323, 5324, 5325, 5326, 5327, 5328, 5329, 5330, 5331, 5332, 5333, 5334, 5335, 5336, 5337, 5338, 5339, 5340, 5341, 5342, 5343, 5344, 5345, 5346, 5347, 5348, 5349, 5350, 5351, 5352, 5353, 5354, 5355, 5356, 5357, 5358, 5359, 5361, 5362, 5363, 5364, 5365, 5366, 5367, 5368, 5369, 5370, 5371, 5372, 5373, 5375, 5376, 5377, 5378, 5379, 5380, 5381, 5383, 5384, 5385, 5386, 5387, 5388, 5389, 5390, 5391, 5392, 5393, 5394, 5396, 5397, 5398, 5399, 5400, 5401, 5402, 5403, 5404, 5405, 5406, 5407, 5408, 5409, 5410, 5411, 5412, 5413, 5414, 5416, 5417, 5418, 5419, 5420, 5422, 5423, 5424, 5425, 5426, 5427, 5428, 5429, 5430, 5431, 5432, 5433, 5434, 5435, 5437, 5438, 5439, 5440, 5441, 5442, 5443, 5444, 5445, 5446, 5447, 5448, 5449, 5450, 5451, 5452, 5453, 5454, 5455, 5456, 5457, 5458, 5459, 5460, 5461, 5462, 5463, 5464, 5465, 5466, 5467, 5468, 5469, 5470, 5471, 5472, 5473, 5474, 5475, 5476, 5477, 5478, 5479, 5480, 5481, 5482, 5483, 5484, 5485, 5486, 5487, 5488, 5489, 5490, 5491, 5492, 5493, 5494, 5495, 5496, 5497, 5498, 5499, 5500, 5501, 5502, 5503, 5504, 5505, 5506, 5507, 5508, 5509, 5510, 5511, 5512, 5513, 5514, 5515, 5516, 5517, 5518, 5519, 5520, 5521, 5522, 5523, 5524, 5525, 5526, 5527, 5529, 5530, 5531, 5532, 5533, 5534, 5535, 5536, 5537, 5538, 5539, 5540, 5541, 5542, 5543, 5544, 5545, 5546, 5547, 5548, 5549, 5550, 5551, 5552, 5554, 5555, 5556, 5557, 5558, 5559, 5560, 5561, 5562, 5563, 5564, 5565, 5566, 5567, 5568, 5569, 5570, 5571, 5572, 5573, 5574, 5575, 5576, 5577, 5578, 5579, 5580, 5581, 5582, 5583, 5584, 5585, 5586, 5587, 5588, 5589, 5590, 5591, 5592, 5593, 5594, 5595, 5596, 5597, 5598, 5600, 5601, 5602, 5603, 5604, 5605, 5606, 5607, 5608, 5609, 5610, 5612, 5613, 5614, 5615, 5616, 5617, 5618, 5620, 5621, 5622, 5623, 5624, 5625, 5626, 5627, 5628, 5629, 5630, 5631, 5632, 5633, 5634, 5635, 5636, 5637, 5638, 5639, 5640, 5642, 5643, 5645, 5646, 5647, 5648, 5649, 5650, 5651, 5652, 5653, 5654, 5655, 5656, 5657, 5658, 5659, 5660, 5661, 5662, 5663, 5664, 5665, 5666, 5667, 5668, 5669, 5670, 5671, 5672, 5673, 5674, 5676, 5677, 5678, 5679, 5680, 5681, 5682, 5683, 5684, 5685, 5686, 5688, 5689, 5690, 5691, 5692, 5693, 5694, 5695, 5696, 5697, 5698, 5699, 5700, 5701, 5702, 5703, 5704, 5705, 5706, 5707, 5708, 5709, 5711, 5712, 5713, 5714, 5716, 5717, 5718, 5720, 5721, 5722, 5723, 5724, 5726, 5728, 5729, 5730, 5731, 5732, 5733, 5734, 5735, 5736, 5737, 5739, 5740, 5741, 5742, 5743, 5744, 5745, 5746, 5747, 5748, 5749, 5751, 5752, 5753, 5754, 5755, 5756, 5757, 5758, 5759, 5760, 5761, 5762, 5763, 5764, 5765, 5766, 5767, 5768, 5769, 5771, 5772, 5773, 5774, 5775, 5776, 5777, 5778, 5779, 5780, 5781, 5782, 5783, 5784, 5785, 5786, 5787, 5788, 5789, 5791, 5792, 5793, 5794, 5795, 5796, 5797, 5798, 5799, 5800, 5801, 5802, 5803, 5804, 5805, 5806, 5808, 5809, 5810, 5811, 5813, 5814, 5815, 5816, 5817, 5819, 5820, 5821, 5822, 5823, 5825, 5826, 5827, 5828, 5829, 5830, 5831, 5832, 5833, 5834, 5835, 5836, 5837, 5838, 5839, 5840, 5841, 5842, 5843, 5844, 5846, 5847, 5848, 5849, 5850, 5851, 5852, 5853, 5854, 5855, 5856, 5857, 5858, 5859, 5860, 5861, 5862, 5863, 5864, 5865, 5866, 5868, 5869, 5870, 5871, 5872, 5874, 5875, 5876, 5877, 5878, 5880, 5881, 5882, 5883, 5884, 5886, 5887, 5888, 5889, 5890, 5891, 5892, 5893, 5894, 5895, 5896, 5897, 5898, 5899, 5900, 5901, 5902, 5903, 5904, 5905, 5906, 5907, 5908, 5909, 5910, 5912, 5913, 5914, 5915, 5916, 5917, 5918, 5919, 5920, 5921, 5922, 5924, 5925, 5926, 5927, 5928, 5929, 5932, 5933, 5934, 5935, 5936, 5937, 5938, 5939, 5940, 5942, 5943, 5944, 5945, 5946, 5947, 5948, 5949, 5950, 5952, 5953, 5954, 5955, 5956, 5957, 5960, 5962, 5963, 5965, 5966, 5967, 5968, 5969, 5970, 5971, 5972, 5973, 5974, 5975, 5976, 5977, 5978, 5979, 5980, 5981, 5983, 5984, 5985, 5986, 5987, 5988, 5989, 5990, 5991, 5992, 5993, 5994, 5995, 5996, 5997, 5998, 5999, 6000, 6001, 6002, 6003, 6004, 6005, 6006, 6007, 6008, 6009, 6010, 6011, 6012, 6013, 6015, 6016, 6017, 6018, 6019, 6021, 6022, 6023, 6024, 6025, 6027, 6028, 6029, 6030, 6031, 6032, 6034, 6036, 6037, 6038, 6039, 6040, 6041, 6042, 6043, 6044, 6045, 6046, 6047, 6048, 6049, 6051, 6052, 6053, 6055, 6056, 6057, 6058, 6059, 6060, 6061, 6063, 6064, 6065, 6066, 6067, 6068, 6069, 6070, 6071, 6072, 6073, 6074, 6075, 6076, 6077, 6078, 6079, 6080, 6081, 6083, 6084, 6085, 6086, 6087, 6088, 6089, 6090, 6091, 6092, 6093, 6094, 6095, 6096, 6097, 6099, 6100, 6101, 6102, 6103, 6104, 6105, 6106, 6107, 6108, 6109, 6111, 6112, 6113, 6114, 6115, 6116, 6117, 6118, 6119, 6120, 6121, 6122, 6123, 6124, 6126, 6127, 6128, 6129, 6130, 6131, 6132, 6133, 6134, 6135, 6136, 6137, 6139, 6140, 6141, 6142, 6143, 6144, 6145, 6146, 6147, 6148, 6149, 6150, 6151, 6152, 6153, 6154, 6155, 6156, 6157, 6158, 6159, 6160, 6161, 6162, 6163, 6164, 6165, 6166, 6167, 6168, 6169, 6170, 6171, 6172, 6173, 6174, 6175, 6176, 6178, 6179, 6180, 6181, 6182, 6183, 6184, 6185, 6186, 6187, 6189, 6190, 6191, 6192, 6193, 6194, 6195, 6196, 6197, 6198, 6200, 6201, 6202, 6203, 6204, 6205, 6206, 6207, 6208, 6209, 6210, 6211, 6212, 6213, 6214, 6215, 6216, 6217, 6218, 6219, 6220, 6221, 6222, 6223, 6224, 6225, 6226, 6227, 6228, 6229, 6230, 6231, 6232, 6233, 6234, 6235, 6236, 6237, 6238, 6239, 6240, 6241, 6242, 6243, 6244, 6245, 6246, 6247, 6248, 6249, 6250, 6251, 6252, 6253, 6254, 6255, 6256, 6257, 6258, 6259, 6260, 6261, 6262, 6263, 6264, 6265, 6266, 6267, 6269, 6270, 6271, 6272, 6273, 6274, 6275, 6276, 6277, 6278, 6279, 6280, 6281, 6282, 6283, 6284, 6285, 6286, 6287, 6288, 6289, 6290, 6291, 6292, 6293, 6294, 6295, 6296, 6297, 6298, 6299, 6300, 6301, 6302, 6303, 6304, 6305, 6306, 6307, 6308, 6309, 6310, 6311, 6313, 6314, 6315, 6316, 6317, 6318, 6319, 6320, 6321, 6322, 6323, 6324, 6325, 6326, 6327, 6328, 6329, 6330, 6331, 6332, 6333, 6334, 6335, 6336, 6337, 6338, 6339, 6340, 6341, 6342, 6343, 6344, 6345, 6346, 6347, 6348, 6349, 6350, 6351, 6352, 6353, 6354, 6355, 6356, 6357, 6358, 6359, 6360, 6361, 6362, 6363, 6364, 6365, 6369, 6370, 6371, 6372, 6373, 6374, 6375, 6376, 6377, 6378, 6379, 6380, 6381, 6382, 6383, 6384, 6385, 6386, 6387, 6388, 6389, 6390, 6391, 6392, 6393, 6394, 6395, 6396, 6398, 6399, 6401, 6402, 6404, 6405, 6407, 6408, 6410, 6411, 6412, 6413, 6414, 6415, 6416, 6417, 6418, 6419, 6420, 6421, 6422, 6423, 6424, 6425, 6426, 6427, 6428, 6429, 6430, 6431, 6433, 6434, 6435, 6436, 6437, 6438, 6439, 6440, 6441, 6442, 6443, 6444, 6445, 6446, 6447, 6448, 6449, 6450, 6452, 6453, 6454, 6455, 6457, 6458, 6460, 6461, 6462, 6463, 6464, 6466, 6467, 6468, 6469, 6470, 6471, 6472, 6473, 6474, 6475, 6476, 6477, 6478, 6479, 6480, 6481, 6482, 6483, 6484, 6485, 6486, 6487, 6488, 6489, 6491, 6492, 6493, 6494, 6495, 6496, 6497, 6498, 6499, 6500, 6501, 6502, 6503, 6504, 6505, 6506, 6507, 6508, 6509, 6510, 6511, 6512, 6513, 6514, 6515, 6516, 6517, 6518, 6519, 6520, 6521, 6522, 6523, 6524, 6525, 6526, 6527, 6528, 6529, 6530, 6531, 6532, 6533, 6534, 6535, 6536, 6537, 6538, 6539, 6540, 6541, 6542, 6543, 6544, 6545, 6547, 6548, 6552, 6553, 6554, 6555, 6556, 6557, 6558, 6559, 6560, 6561, 6562, 6563, 6564, 6565, 6566, 6567, 6568, 6569, 6570, 6571, 6572, 6573, 6575, 6576, 6577, 6578, 6579, 6580, 6581, 6582, 6583, 6584, 6585, 6586, 6587, 6589, 6590, 6591, 6592, 6593, 6594, 6595, 6596, 6597, 6598, 6600, 6601, 6602, 6603, 6604, 6605, 6606, 6607, 6608, 6609, 6610, 6611, 6612, 6613, 6614, 6615, 6616, 6617, 6618, 6619, 6620, 6621, 6622, 6623, 6624, 6625, 6626, 6627, 6628, 6629, 6630, 6631, 6632, 6633, 6634, 6635, 6636, 6637, 6639, 6640, 6641, 6642, 6643, 6644, 6645, 6646, 6647, 6648, 6649, 6650, 6651, 6652, 6653, 6654, 6655, 6656, 6657, 6658, 6659, 6660, 6661, 6662, 6663, 6664, 6665, 6666, 6667, 6668, 6669, 6670, 6671, 6672, 6673, 6675, 6676, 6677, 6678, 6679, 6680, 6681, 6682, 6683, 6684, 6685, 6686, 6687, 6688, 6689, 6690, 6691, 6692, 6693, 6694, 6695, 6696, 6697, 6698, 6699, 6700, 6701, 6702, 6703, 6704, 6705, 6706, 6707, 6708, 6709, 6710, 6711, 6712, 6713, 6714, 6715, 6716, 6717, 6718, 6719, 6720, 6721, 6722, 6723, 6724, 6725, 6726, 6727, 6728, 6729, 6730, 6731, 6732, 6733, 6734, 6735, 6736, 6737, 6738, 6739, 6740, 6741, 6742, 6743, 6744, 6745, 6747, 6748, 6750, 6751, 6752, 6753, 6754, 6755, 6756, 6757, 6758, 6759, 6760, 6762, 6764, 6765, 6766, 6767, 6768, 6769, 6770, 6771, 6772, 6773, 6774, 6775, 6776, 6777, 6778, 6779, 6780, 6781, 6782, 6783, 6784, 6785, 6786, 6787, 6788, 6789, 6790, 6791, 6792, 6793}",5344,"{2040, 5250, 2287, 2288, 2289, 2290, 2291, 2292, 2293, 2294, 2295, 2296, 2297, 2298, 2299, 2300, 2301, 2302, 2303, 2304, 6394, 2306, 2307, 2309, 2310, 2311, 2312, 2313, 2314, 2315, 2316, 2317, 5539, 5540, 5541, 5542, 5543, 5544, 5545, 5546, 5547, 5548, 5549, 5550, 5551, 5552, 5554, 5555, 5556, 5557, 5558, 5559, 5560, 5561, 5563, 5564, 5565, 5566, 5567, 5568, 5569, 5570, 6595, 6594, 6597, 6598, 6630, 6600, 6601, 6602, 6603, 6604, 6605, 6606, 6607, 6608, 6609, 6610, 6611, 6612, 6613, 6614, 6615, 6616, 6617, 6618, 6619, 6620, 6621, 6622, 4575, 6623, 6624, 5602, 5603, 5604, 5605, 6625, 5607, 5608, 5609, 5610, 6626, 5612, 5613, 5614, 5615, 5616, 5617, 6635, 6636, 5620, 5621, 5622, 5623, 5624, 5625, 5626, 5627, 5628, 5629, 5630, 5631, 5632, 5633, 1556, 1557, 1558, 1559, 1560, 1561, 1562, 1563, 1564, 1565, 1566, 3615, 1567, 1568, 1569, 1570, 1571, 1572, 1573, 1574, 1575, 1576, 1577, 1578, 1579, 1580, 1581, 1582, 4655, 1583, 1584, 1942, 4667, 6627, 6629, 1613, 1614, 1615, 1616, 1617, 1618, 1619, 1620, 1621, 1622, 1623, 1624, 1625, 1626, 1627, 1628, 1629, 1630, 1631, 1632, 1633, 1634, 4707, 1635, 1636, 1637, 3687, 1638, 1639, 1640, 1641, 1642, 1643, 4718, 6637, 4725, 4763, 3769, 4796, 4797, 4798, 4799, 4800, 4801, 4802, 4803, 4804, 4805, 4806, 4807, 4808, 4809, 4810, 4811, 4813, 3790, 4814, 4815, 4816, 4817, 3795, 4818, 4819, 4820, 1760, 1796, 1797, 1798, 1799, 1800, 1801, 1802, 1803, 1804, 3853, 1805, 1806, 1807, 1808, 1809, 1810, 1811, 1812, 1813, 1814, 1815, 1816, 1817, 1818, 1819, 1820, 1821, 1822, 1823, 1824, 1826, 1827, 1828, 1890, 3945, 3946, 3947, 3948, 3949, 3950, 3951, 3952, 3953, 3954, 3955, 3956, 3957, 3958, 3959, 3960, 1904, 3962, 3963, 3964, 3965, 3966, 3967, 3969, 3972, 3973, 3974, 3975, 3976, 3977, 3978, 3979, 3980, 3981, 3982, 3983, 3984, 3985, 3986, 3987, 3988, 3989, 3990, 3991, 3992, 3993, 3994, 3995, 3996, 3997, 3998, 3999, 4000, 4001, 5026, 4003, 4004, 6631, 1979, 1980, 1981, 1982, 6632, 1983, 1984, 1985, 1986, 1987, 1988, 1990, 1991, 1992, 1993, 1994, 1995, 1996, 1997, 1998, 1999, 2000, 2001, 2002, 2003, 2004, 2005, 2006, 2007, 6633, 2008, 2009, 2010, 2011, 2012, 2014, 2016, 2017, 2018, 2019, 2020, 2021, 2022, 2023, 2024, 2025, 2026, 2027, 2028, 2029, 2030, 2031, 2032, 6634, 2033, 2034, 2035, 2036, 2037, 2039, 2038, 2041, 2042}",380,"{989, 1078, 1081, 1084, 1085, 1086, 1087, 1088, 1089, 1090, 1092, 1093, 1094, 1095, 1096, 1097, 1098, 1099, 1100, 1101, 1103, 1104, 1105, 1106, 1107, 1108, 1109, 1110, 1111, 1112, 1113, 1114, 1115, 1116, 1117, 1118, 1119, 1120, 1121, 1122, 1123, 1124, 1125, 1126, 1127, 1128, 1129, 1130, 1131, 1132, 1133, 1134, 1135, 1136, 1137, 1138, 1139, 1140, 1141, 1142, 1143, 1144, 1145, 1146, 1147, 1148, 1149, 1150, 1151, 1152, 1153, 1154, 1155, 1156, 1157, 1158, 1159, 1160, 1161, 1162, 1163, 1164, 1165, 1166, 1167, 1168, 1169, 1170, 1171, 1172, 1173, 1174, 1175, 1176, 1177, 1178, 1179, 1180, 1181, 1182, 1183, 1184, 1185, 1186, 1187, 1188, 1189, 1190, 1191, 1192, 1193, 1194, 1195, 1196, 1197, 1198, 1199, 1200, 1201, 1202, 1203, 1204, 1205, 1206, 1207, 1208, 1209, 1210, 1211, 1212, 1213, 1214, 1215, 1216, 1217, 1218, 1219, 1220, 1221, 1222, 1223, 1224, 1225, 1226, 1227, 1228, 1229, 1230, 1231, 1232, 1233, 1234, 1235, 1236, 1237, 1238, 1239, 1240, 1241, 1242, 1243, 1244, 1245, 1246, 1247, 1248, 1249, 1250, 1251, 1252, 1253, 1254, 1255, 1258, 1259, 1260, 1262, 1263, 1264, 1265, 1267, 1268, 1269, 1270, 1271, 1272, 1273, 1274, 1275, 1276, 1277, 1278, 1279, 1280, 1281, 1282, 1283, 1284, 1285, 1286, 1287, 1288, 1289, 1290, 1291, 1292, 1293, 1294, 1295, 1296, 1297, 1298, 1299, 1300, 1301, 1302, 1303, 1304, 1305, 1306, 1307, 1308, 1309, 1310, 1311, 1313, 1314, 1315, 1316, 1317, 1318, 1320, 1321, 1323, 1324, 1325, 1326, 1327, 1328, 1329, 1330, 1331, 1332, 1333, 1334, 1335, 1336, 1337, 1338, 1339, 1340, 1342, 1343, 1344, 1345, 1346, 1347, 1348, 1349, 1350, 1351, 1352, 1353, 1354, 1355, 1356, 1357, 1358, 1359, 1360, 1361, 1362, 1363, 1364, 1365, 1366, 1367, 1368, 1369, 1370, 1371, 1372, 1373, 1374, 1375, 1376, 1377, 1378, 1379, 1380, 1381, 1382, 1383, 1384, 1385, 1386, 1387, 1388, 1389, 1390, 1391, 1392, 1393, 1394, 1395, 1396, 1397, 1399, 1400, 1401, 1402, 1403, 1404, 1405, 1406, 1407, 1408, 1409, 1410, 1411, 1412, 1413, 1414, 1415, 1416, 1418, 1419, 1420, 1421, 1422, 1423, 1424, 1426, 1427, 1428, 1429, 1430, 1431, 1432, 1433, 1434, 1435, 1436, 1437, 1439, 1440, 1441, 1442, 1443, 1445, 1446, 1447, 1448, 1449, 1450, 1451, 1452, 1453, 1454, 1455, 1456, 1457, 1458, 1459, 1460, 1461, 1462, 1463, 1464, 1465, 1466, 1467, 1468, 1469, 1470, 1471, 1472, 1473, 1474, 1475, 1476, 1477, 1478, 1479, 1480, 1481, 1482, 1483, 1484, 1485, 1487, 1488, 1489, 1490, 1491, 1492, 1493, 1494, 1495, 1496, 1497, 1499, 1500, 1501, 1502, 1503, 1504, 1505, 1506, 1507, 1508, 1509, 1510, 1511, 1512, 1513, 1514, 1515, 1516, 1517, 1518, 1519, 1520, 1521, 1522, 1523, 1524, 1525, 1526, 1527, 1528, 1529, 1530, 1531, 1532, 1533, 1534, 1535, 1536, 1537, 1538, 1539, 1540, 1541, 1542, 1543, 1544, 1545, 1546, 1548, 1549, 1550, 1551, 1552, 1553, 1554, 1585, 1586, 1587, 1588, 1589, 1590, 1591, 1592, 1593, 1594, 1595, 1596, 1597, 1598, 1599, 1600, 1601, 1602, 1603, 1604, 1605, 1606, 1607, 1608, 1609, 1610, 1612, 1644, 1645, 1646, 1647, 1648, 1649, 1650, 1651, 1652, 1653, 1654, 1655, 1656, 1657, 1658, 1659, 1660, 1661, 1662, 1663, 1664, 1665, 1666, 1667, 1668, 1669, 1670, 1671, 1672, 1673, 1674, 1675, 1676, 1677, 1678, 1679, 1680, 1681, 1682, 1683, 1684, 1685, 1686, 1687, 1688, 1689, 1690, 1691, 1692, 1693, 1694, 1695, 1696, 1697, 1698, 1699, 1700, 1701, 1702, 1703, 1704, 1705, 1706, 1707, 1708, 1709, 1710, 1711, 1712, 1713, 1714, 1715, 1716, 1717, 1718, 1719, 1720, 1721, 1722, 1723, 1724, 1725, 1726, 1727, 1728, 1729, 1730, 1731, 1732, 1734, 1735, 1736, 1737, 1738, 1739, 1740, 1741, 1742, 1743, 1744, 1745, 1746, 1747, 1748, 1749, 1752, 1753, 1754, 1755, 1756, 1757, 1758, 1759, 1761, 1762, 1764, 1765, 1766, 1767, 1768, 1769, 1770, 1771, 1772, 1773, 1774, 1775, 1776, 1778, 1779, 1780, 1781, 1782, 1783, 1784, 1785, 1786, 1787, 1788, 1789, 1790, 1791, 1792, 1793, 1795, 1825, 1829, 1830, 1831, 1832, 1833, 1834, 1835, 1836, 1837, 1838, 1839, 1840, 1841, 1842, 1843, 1844, 1845, 1846, 1847, 1848, 1849, 1850, 1851, 1852, 1853, 1854, 1855, 1857, 1858, 1859, 1860, 1861, 1862, 1863, 1864, 1865, 1866, 1867, 1868, 1869, 1870, 1871, 1872, 1873, 1874, 1875, 1876, 1877, 1878, 1879, 1880, 1881, 1882, 1883, 1884, 1885, 1886, 1887, 1888, 1889, 1891, 1892, 1893, 1894, 1895, 1896, 1897, 1898, 1899, 1900, 1901, 1902, 1903, 1905, 1907, 1908, 1909, 1910, 1911, 1912, 1914, 1915, 1916, 1918, 1919, 1920, 1921, 1922, 1923, 1924, 1925, 1926, 1927, 1928, 1929, 1930, 1931, 1932, 1934, 1936, 1937, 1938, 1939, 1940, 1941, 1943, 1944, 1945, 1946, 1947, 1948, 1949, 1950, 1951, 1952, 1954, 1955, 1956, 1957, 1958, 1959, 1960, 1961, 1962, 1963, 1964, 1965, 1966, 1967, 1968, 1969, 1970, 1971, 1972, 1973, 1974, 1975, 1976, 1977, 1978, 2015, 2043, 2044, 2045, 2046, 2047, 2048, 2049, 2050, 2051, 2052, 2053, 2055, 2056, 2057, 2058, 2059, 2060, 2061, 2062, 2063, 2064, 2065, 2066, 2067, 2068, 2069, 2070, 2071, 2073, 2074, 2075, 2076, 2077, 2079, 2080, 2081, 2082, 2083, 2084, 2085, 2086, 2087, 2088, 2089, 2090, 2091, 2092, 2094, 2095, 2096, 2097, 2098, 2099, 2100, 2101, 2102, 2103, 2104, 2106, 2107, 2108, 2109, 2110, 2111, 2112, 2113, 2114, 2115, 2116, 2117, 2118, 2119, 2120, 2121, 2122, 2123, 2124, 2125, 2126, 2128, 2129, 2130, 2131, 2132, 2133, 2134, 2135, 2137, 2138, 2139, 2140, 2141, 2142, 2143, 2144, 2145, 2146, 2147, 2148, 2149, 2150, 2151, 2152, 2153, 2154, 2155, 2156, 2157, 2158, 2159, 2160, 2161, 2162, 2163, 2164, 2166, 2167, 2168, 2169, 2170, 2171, 2172, 2173, 2174, 2175, 2176, 2177, 2178, 2179, 2180, 2181, 2182, 2183, 2184, 2185, 2186, 2187, 2188, 2189, 2190, 2191, 2192, 2193, 2194, 2195, 2196, 2197, 2198, 2200, 2201, 2202, 2203, 2204, 2205, 2206, 2207, 2208, 2209, 2210, 2211, 2212, 2213, 2214, 2215, 2216, 2217, 2218, 2219, 2220, 2221, 2222, 2223, 2224, 2225, 2226, 2228, 2229, 2230, 2231, 2232, 2233, 2234, 2235, 2236, 2237, 2239, 2240, 2241, 2242, 2243, 2244, 2245, 2246, 2247, 2248, 2249, 2250, 2251, 2252, 2253, 2254, 2255, 2259, 2260, 2261, 2262, 2263, 2264, 2265, 2266, 2267, 2268, 2269, 2270, 2271, 2272, 2273, 2274, 2275, 2276, 2277, 2280, 2281, 2282, 2283, 2284, 2285, 2305, 2318, 2319, 2320, 2321, 2322, 2323, 2324, 2325, 2327, 2328, 2329, 2330, 2331, 2332, 2333, 2334, 2335, 2336, 2337, 2338, 2339, 2340, 2341, 2342, 2344, 2345, 2346, 2347, 2348, 2349, 2350, 2351, 2352, 2353, 2354, 2355, 2356, 2357, 2358, 2359, 2360, 2361, 2362, 2363, 2364, 2365, 2366, 2367, 2368, 2369, 2370, 2371, 2373, 2374, 2375, 2376, 2377, 2378, 2379, 2380, 2381, 2382, 2383, 2384, 2385, 2386, 2387, 2388, 2389, 2390, 2391, 2392, 2393, 2394, 2395, 2396, 2397, 2398, 2399, 2401, 2402, 2403, 2404, 2405, 2406, 2407, 2408, 2409, 2410, 2411, 2412, 2413, 2414, 2415, 2416, 2419, 2420, 2421, 2422, 2423, 2424, 2425, 2426, 2427, 2428, 2429, 2430, 2431, 2432, 2433, 2434, 2435, 2436, 2437, 2438, 2439, 2440, 2441, 2442, 2443, 2444, 2445, 2446, 2447, 2448, 2449, 2450, 2452, 2453, 2454, 2455, 2456, 2457, 2458, 2459, 2460, 2461, 2462, 2463, 2464, 2465, 2466, 2467, 2469, 2470, 2471, 2472, 2473, 2474, 2475, 2476, 2477, 2478, 2479, 2480, 2481, 2482, 2483, 2484, 2485, 2486, 2487, 2488, 2489, 2490, 2491, 2492, 2494, 2495, 2496, 2497, 2498, 2499, 2500, 2501, 2502, 2503, 2504, 2505, 2506, 2508, 2509, 2510, 2511, 2512, 2513, 2514, 2515, 2516, 2517, 2518, 2519, 2520, 2521, 2522, 2523, 2524, 2525, 2526, 2527, 2528, 2529, 2530, 2531, 2532, 2533, 2534, 2535, 2536, 2537, 2538, 2540, 2541, 2542, 2543, 2544, 2545, 2546, 2547, 2548, 2549, 2550, 2551, 2552, 2553, 2554, 2555, 2556, 2557, 2558, 2559, 2560, 2561, 2562, 2563, 2564, 2566, 2567, 2568, 2569, 2570, 2572, 2573, 2574, 2575, 2576, 2577, 2578, 2579, 2580, 2581, 2582, 2583, 2584, 2585, 2586, 2587, 2590, 2591, 2592, 2593, 2594, 2595, 2596, 2597, 2598, 2599, 2600, 2601, 2603, 2604, 2605, 2606, 2607, 2608, 2609, 2610, 2611, 2612, 2613, 2614, 2615, 2616, 2617, 2620, 2621, 2622, 2623, 2624, 2625, 2626, 2627, 2628, 2629, 2630, 2631, 2632, 2633, 2635, 2636, 2637, 2638, 2639, 2640, 2641, 2642, 2643, 2644, 2645, 2646, 2647, 2648, 2649, 2650, 2652, 2653, 2654, 2655, 2656, 2657, 2658, 2659, 2660, 2662, 2664, 2665, 2666, 2667, 2668, 2669, 2671, 2672, 2673, 2674, 2677, 2679, 2680, 2681, 2682, 2683, 2684, 2685, 2686, 2687, 2688, 2689, 2690, 2691, 2692, 2693, 2694, 2695, 2696, 2697, 2698, 2699, 2700, 2701, 2703, 2704, 2705, 2706, 2707, 2708, 2709, 2710, 2711, 2712, 2713, 2715, 2716, 2717, 2718, 2720, 2721, 2723, 2724, 2725, 2726, 2727, 2728, 2729, 2730, 2731, 2732, 2733, 2734, 2735, 2736, 2737, 2738, 2739, 2740, 2741, 2744, 2745, 2746, 2747, 2748, 2749, 2750, 2751, 2753, 2754, 2755, 2756, 2757, 2758, 2759, 2760, 2761, 2762, 2763, 2764, 2765, 2766, 2768, 2769, 2770, 2771, 2772, 2773, 2774, 2775, 2776, 2777, 2778, 2779, 2780, 2782, 2783, 2784, 2785, 2786, 2787, 2789, 2790, 2791, 2792, 2793, 2794, 2795, 2796, 2797, 2798, 2799, 2800, 2801, 2802, 2803, 2804, 2805, 2806, 2807, 2808, 2809, 2811, 2812, 2813, 2814, 2815, 2816, 2817, 2818, 2819, 2820, 2821, 2822, 2823, 2825, 2826, 2827, 2828, 2830, 2831, 2832, 2833, 2834, 2835, 2836, 2837, 2838, 2839, 2840, 2841, 2842, 2843, 2844, 2845, 2846, 2847, 2848, 2849, 2850, 2851, 2852, 2853, 2854, 2855, 2856, 2857, 2858, 2859, 2860, 2861, 2862, 2863, 2865, 2866, 2867, 2868, 2869, 2870, 2871, 2872, 2873, 2874, 2875, 2877, 2878, 2880, 2883, 2884, 2886, 2887, 2888, 2889, 2890, 2891, 2892, 2893, 2894, 2895, 2896, 2897, 2898, 2899, 2900, 2901, 2902, 2903, 2904, 2905, 2906, 2907, 2908, 2909, 2910, 2911, 2912, 2914, 2915, 2916, 2917, 2918, 2919, 2920, 2921, 2923, 2924, 2925, 2926, 2927, 2930, 2931, 2932, 2933, 2934, 2935, 2937, 2938, 2939, 2940, 2941, 2942, 2943, 2944, 2945, 2946, 2947, 2949, 2950, 2951, 2952, 2953, 2955, 2956, 2957, 2959, 2960, 2961, 2962, 2963, 2965, 2966, 2967, 2968, 2969, 2970, 2971, 2972, 2973, 2974, 2975, 2976, 2977, 2978, 2979, 2980, 2981, 2982, 2983, 2984, 2985, 2986, 2987, 2988, 2989, 2990, 2991, 2992, 2993, 2994, 2995, 2996, 2997, 2998, 2999, 3000, 3001, 3002, 3003, 3004, 3005, 3006, 3007, 3008, 3009, 3010, 3011, 3012, 3014, 3015, 3016, 3017, 3018, 3019, 3020, 3022, 3023, 3024, 3025, 3026, 3027, 3028, 3029, 3030, 3031, 3032, 3033, 3034, 3035, 3036, 3037, 3038, 3039, 3040, 3042, 3043, 3044, 3045, 3046, 3047, 3048, 3049, 3050, 3051, 3052, 3053, 3054, 3055, 3057, 3058, 3059, 3060, 3061, 3062, 3063, 3064, 3065, 3066, 3067, 3068, 3070, 3071, 3072, 3073, 3074, 3075, 3076, 3077, 3079, 3080, 3081, 3082, 3083, 3084, 3086, 3087, 3088, 3089, 3090, 3091, 3093, 3094, 3095, 3096, 3097, 3098, 3099, 3100, 3101, 3102, 3103, 3104, 3105, 3106, 3107, 3108, 3109, 3110, 3111, 3112, 3113, 3114, 3115, 3116, 3118, 3119, 3120, 3121, 3122, 3123, 3124, 3125, 3126, 3127, 3128, 3131, 3132, 3133, 3134, 3135, 3136, 3137, 3138, 3139, 3141, 3142, 3143, 3144, 3146, 3147, 3149, 3150, 3151, 3152, 3153, 3154, 3155, 3156, 3157, 3158, 3159, 3160, 3162, 3163, 3164, 3165, 3166, 3167, 3168, 3169, 3170, 3171, 3172, 3173, 3174, 3175, 3176, 3177, 3178, 3179, 3180, 3181, 3182, 3183, 3184, 3185, 3186, 3187, 3188, 3189, 3190, 3191, 3192, 3193, 3194, 3195, 3196, 3197, 3198, 3199, 3200, 3201, 3202, 3203, 3204, 3205, 3206, 3207, 3208, 3209, 3210, 3211, 3212, 3213, 3214, 3215, 3216, 3217, 3218, 3219, 3222, 3223, 3224, 3225, 3226, 3227, 3228, 3229, 3231, 3232, 3233, 3234, 3236, 3240, 3241, 3242, 3243, 3244, 3245, 3247, 3248, 3249, 3250, 3251, 3252, 3253, 3254, 3255, 3256, 3257, 3258, 3259, 3260, 3261, 3262, 3263, 3265, 3269, 3270, 3271, 3272, 3273, 3276, 3277, 3279, 3280, 3281, 3282, 3283, 3284, 3285, 3286, 3287, 3288, 3289, 3291, 3292, 3293, 3294, 3295, 3296, 3298, 3299, 3300, 3301, 3302, 3303, 3304, 3305, 3306, 3307, 3308, 3310, 3311, 3312, 3313, 3314, 3316, 3317, 3318, 3319, 3320, 3321, 3322, 3323, 3325, 3326, 3327, 3328, 3329, 3330, 3331, 3332, 3333, 3334, 3335, 3336, 3337, 3338, 3339, 3340, 3341, 3342, 3343, 3344, 3345, 3346, 3347, 3349, 3350, 3351, 3352, 3353, 3354, 3355, 3356, 3357, 3358, 3359, 3360, 3362, 3363, 3364, 3365, 3366, 3367, 3368, 3369, 3370, 3371, 3372, 3373, 3374, 3375, 3376, 3377, 3378, 3379, 3380, 3381, 3382, 3383, 3384, 3386, 3387, 3388, 3389, 3390, 3391, 3392, 3393, 3394, 3396, 3397, 3398, 3399, 3400, 3401, 3402, 3403, 3404, 3405, 3406, 3407, 3408, 3410, 3411, 3412, 3413, 3414, 3415, 3416, 3417, 3418, 3419, 3421, 3422, 3423, 3424, 3426, 3427, 3428, 3429, 3430, 3431, 3432, 3433, 3434, 3435, 3436, 3437, 3438, 3439, 3440, 3441, 3442, 3443, 3444, 3445, 3446, 3447, 3448, 3449, 3450, 3451, 3452, 3453, 3454, 3455, 3456, 3457, 3459, 3460, 3461, 3462, 3463, 3465, 3466, 3467, 3468, 3469, 3470, 3471, 3472, 3473, 3474, 3475, 3476, 3477, 3480, 3481, 3482, 3483, 3484, 3485, 3486, 3487, 3488, 3489, 3490, 3491, 3492, 3493, 3494, 3495, 3497, 3498, 3499, 3500, 3501, 3502, 3503, 3504, 3505, 3506, 3507, 3509, 3510, 3511, 3512, 3513, 3514, 3515, 3516, 3519, 3520, 3521, 3522, 3523, 3525, 3526, 3527, 3528, 3529, 3530, 3531, 3532, 3533, 3534, 3535, 3536, 3538, 3539, 3540, 3541, 3542, 3543, 3544, 3545, 3546, 3547, 3548, 3549, 3550, 3551, 3552, 3553, 3554, 3556, 3557, 3558, 3559, 3562, 3563, 3564, 3565, 3566, 3567, 3568, 3569, 3570, 3571, 3572, 3573, 3574, 3575, 3576, 3577, 3578, 3580, 3581, 3582, 3583, 3584, 3585, 3586, 3588, 3589, 3591, 3592, 3593, 3594, 3595, 3596, 3598, 3599, 3600, 3601, 3602, 3603, 3604, 3605, 3606, 3607, 3608, 3609, 3610, 3611, 3612, 3613, 3614, 3616, 3617, 3618, 3620, 3621, 3622, 3623, 3624, 3625, 3626, 3627, 3628, 3629, 3630, 3631, 3632, 3633, 3634, 3635, 3636, 3637, 3638, 3639, 3640, 3642, 3644, 3645, 3646, 3647, 3648, 3649, 3650, 3651, 3652, 3653, 3655, 3656, 3657, 3658, 3660, 3661, 3662, 3663, 3664, 3665, 3666, 3667, 3668, 3669, 3670, 3671, 3672, 3673, 3674, 3675, 3676, 3677, 3678, 3679, 3680, 3681, 3682, 3683, 3684, 3685, 3686, 3688, 3689, 3690, 3691, 3692, 3693, 3694, 3696, 3697, 3698, 3699, 3700, 3701, 3702, 3703, 3704, 3705, 3706, 3707, 3708, 3709, 3710, 3711, 3712, 3713, 3716, 3717, 3718, 3719, 3721, 3722, 3724, 3728, 3729, 3730, 3731, 3732, 3733, 3734, 3735, 3736, 3737, 3738, 3739, 3740, 3743, 3744, 3748, 3749, 3750, 3751, 3752, 3753, 3754, 3756, 3757, 3758, 3759, 3760, 3761, 3762, 3763, 3764, 3765, 3766, 3767, 3768, 3770, 3772, 3773, 3774, 3775, 3776, 3777, 3778, 3779, 3781, 3782, 3783, 3784, 3785, 3786, 3787, 3788, 3789, 3791, 3792, 3793, 3794, 3796, 3797, 3798, 3799, 3800, 3801, 3802, 3803, 3804, 3805, 3806, 3807, 3808, 3809, 3810, 3811, 3812, 3813, 3814, 3815, 3817, 3818, 3819, 3820, 3821, 3822, 3823, 3825, 3826, 3827, 3828, 3829, 3830, 3831, 3832, 3833, 3834, 3835, 3836, 3837, 3838, 3839, 3840, 3841, 3843, 3844, 3845, 3846, 3847, 3848, 3849, 3850, 3851, 3852, 3854, 3855, 3856, 3857, 3858, 3859, 3860, 3861, 3862, 3863, 3864, 3866, 3867, 3868, 3869, 3870, 3871, 3872, 3873, 3874, 3875, 3877, 3878, 3879, 3880, 3884, 3886, 3887, 3888, 3889, 3890, 3891, 3892, 3893, 3894, 3895, 3896, 3897, 3898, 3899, 3900, 3901, 3902, 3903, 3904, 3905, 3906, 3907, 3908, 3910, 3912, 3913, 3915, 3917, 3918, 3919, 3920, 3921, 3922, 3923, 3924, 3925, 3926, 3927, 3928, 3929, 3930, 3932, 3933, 3934, 3935, 3936, 3937, 3938, 3939, 3940, 3941, 3943, 3944, 4002, 4005, 4006, 4007, 4008, 4009, 4010, 4011, 4012, 4013, 4014, 4016, 4017, 4018, 4019, 4020, 4021, 4022, 4023, 4024, 4025, 4026, 4027, 4028, 4029, 4030, 4031, 4032, 4033, 4034, 4037, 4038, 4039, 4040, 4041, 4042, 4043, 4044, 4045, 4046, 4047, 4049, 4050, 4053, 4054, 4055, 4056, 4057, 4058, 4059, 4060, 4061, 4062, 4063, 4066, 4067, 4068, 4069, 4070, 4071, 4072, 4073, 4074, 4075, 4076, 4077, 4078, 4079, 4080, 4081, 4082, 4083, 4084, 4085, 4086, 4087, 4088, 4089, 4090, 4091, 4092, 4093, 4094, 4095, 4096, 4097, 4098, 4099, 4100, 4101, 4102, 4103, 4104, 4105, 4106, 4107, 4108, 4109, 4110, 4111, 4112, 4113, 4114, 4115, 4116, 4117, 4118, 4119, 4120, 4121, 4122, 4123, 4124, 4125, 4126, 4127, 4128, 4129, 4130, 4131, 4132, 4133, 4134, 4135, 4136, 4137, 4138, 4139, 4140, 4141, 4142, 4143, 4144, 4145, 4147, 4148, 4149, 4150, 4151, 4152, 4153, 4154, 4155, 4156, 4157, 4158, 4159, 4160, 4161, 4163, 4164, 4165, 4166, 4167, 4168, 4169, 4170, 4171, 4172, 4173, 4174, 4175, 4176, 4177, 4178, 4179, 4181, 4182, 4183, 4184, 4185, 4186, 4187, 4188, 4189, 4190, 4191, 4192, 4193, 4194, 4195, 4196, 4197, 4198, 4200, 4201, 4202, 4203, 4204, 4205, 4206, 4207, 4208, 4209, 4210, 4211, 4212, 4213, 4214, 4215, 4216, 4217, 4218, 4219, 4221, 4222, 4223, 4224, 4225, 4226, 4227, 4228, 4229, 4230, 4231, 4232, 4233, 4234, 4235, 4237, 4238, 4239, 4240, 4241, 4242, 4243, 4244, 4245, 4246, 4247, 4248, 4249, 4250, 4251, 4252, 4253, 4254, 4255, 4256, 4257, 4258, 4259, 4260, 4261, 4262, 4263, 4264, 4265, 4266, 4267, 4269, 4270, 4271, 4272, 4273, 4274, 4275, 4276, 4277, 4278, 4279, 4280, 4281, 4282, 4283, 4284, 4286, 4287, 4288, 4289, 4290, 4292, 4293, 4294, 4295, 4297, 4298, 4299, 4300, 4301, 4302, 4303, 4304, 4305, 4306, 4307, 4308, 4309, 4310, 4311, 4312, 4313, 4314, 4315, 4316, 4317, 4318, 4319, 4320, 4321, 4322, 4323, 4325, 4326, 4327, 4328, 4329, 4330, 4331, 4332, 4333, 4334, 4335, 4336, 4337, 4339, 4340, 4341, 4342, 4343, 4344, 4345, 4346, 4347, 4348, 4349, 4350, 4351, 4352, 4353, 4354, 4355, 4356, 4357, 4358, 4359, 4361, 4362, 4363, 4364, 4365, 4366, 4367, 4368, 4369, 4370, 4371, 4372, 4373, 4374, 4375, 4376, 4377, 4378, 4379, 4380, 4381, 4382, 4383, 4384, 4385, 4386, 4387, 4388, 4389, 4390, 4391, 4392, 4393, 4394, 4395, 4396, 4397, 4398, 4399, 4400, 4401, 4402, 4403, 4404, 4405, 4406, 4407, 4408, 4409, 4410, 4411, 4412, 4413, 4414, 4415, 4416, 4417, 4418, 4419, 4420, 4421, 4422, 4423, 4424, 4425, 4426, 4427, 4428, 4429, 4430, 4432, 4433, 4434, 4435, 4436, 4437, 4438, 4439, 4440, 4441, 4442, 4443, 4444, 4445, 4446, 4447, 4448, 4449, 4450, 4451, 4452, 4453, 4455, 4456, 4457, 4458, 4459, 4460, 4461, 4463, 4465, 4466, 4467, 4468, 4469, 4471, 4472, 4473, 4474, 4477, 4478, 4479, 4480, 4481, 4482, 4483, 4484, 4485, 4486, 4487, 4488, 4489, 4490, 4491, 4492, 4493, 4494, 4495, 4496, 4497, 4498, 4499, 4500, 4501, 4502, 4503, 4504, 4505, 4506, 4507, 4508, 4509, 4510, 4511, 4512, 4513, 4514, 4515, 4516, 4517, 4518, 4519, 4520, 4521, 4522, 4523, 4524, 4525, 4526, 4527, 4528, 4529, 4530, 4531, 4532, 4533, 4534, 4535, 4536, 4537, 4538, 4539, 4540, 4541, 4542, 4543, 4544, 4545, 4546, 4547, 4548, 4549, 4551, 4552, 4553, 4554, 4555, 4556, 4557, 4558, 4559, 4560, 4561, 4562, 4563, 4564, 4565, 4566, 4567, 4568, 4569, 4570, 4571, 4572, 4573, 4574, 4576, 4577, 4578, 4579, 4580, 4581, 4582, 4583, 4584, 4585, 4586, 4587, 4588, 4589, 4590, 4591, 4593, 4594, 4595, 4596, 4597, 4598, 4599, 4600, 4601, 4602, 4603, 4604, 4605, 4606, 4607, 4608, 4610, 4611, 4612, 4613, 4614, 4615, 4616, 4618, 4619, 4620, 4621, 4622, 4623, 4624, 4625, 4626, 4627, 4628, 4629, 4630, 4632, 4633, 4634, 4635, 4636, 4637, 4639, 4640, 4641, 4642, 4643, 4644, 4645, 4646, 4647, 4648, 4650, 4651, 4652, 4653, 4654, 4656, 4657, 4658, 4659, 4660, 4661, 4662, 4663, 4664, 4665, 4666, 4668, 4669, 4670, 4671, 4672, 4673, 4674, 4675, 4676, 4677, 4678, 4679, 4680, 4681, 4682, 4683, 4684, 4685, 4686, 4687, 4688, 4689, 4690, 4691, 4692, 4693, 4694, 4695, 4696, 4697, 4698, 4699, 4700, 4701, 4702, 4703, 4704, 4705, 4706, 4708, 4709, 4710, 4711, 4712, 4713, 4714, 4715, 4716, 4717, 4719, 4720, 4722, 4723, 4724, 4726, 4727, 4728, 4729, 4730, 4731, 4732, 4733, 4734, 4735, 4736, 4737, 4738, 4739, 4740, 4741, 4742, 4743, 4744, 4745, 4746, 4747, 4748, 4749, 4750, 4751, 4752, 4753, 4754, 4755, 4756, 4757, 4758, 4759, 4760, 4761, 4762, 4764, 4765, 4767, 4768, 4770, 4771, 4772, 4773, 4774, 4775, 4776, 4777, 4778, 4779, 4780, 4781, 4782, 4783, 4784, 4785, 4788, 4789, 4790, 4791, 4792, 4793, 4794, 4795, 4821, 4822, 4823, 4825, 4826, 4827, 4828, 4829, 4830, 4831, 4832, 4833, 4834, 4835, 4836, 4837, 4838, 4839, 4840, 4841, 4842, 4843, 4844, 4845, 4846, 4847, 4848, 4849, 4850, 4851, 4852, 4853, 4854, 4855, 4856, 4857, 4858, 4859, 4860, 4861, 4862, 4863, 4864, 4865, 4866, 4867, 4868, 4869, 4871, 4872, 4873, 4874, 4875, 4876, 4877, 4878, 4879, 4880, 4881, 4882, 4883, 4884, 4885, 4887, 4888, 4889, 4890, 4891, 4892, 4893, 4894, 4895, 4897, 4898, 4899, 4900, 4901, 4902, 4903, 4904, 4905, 4906, 4907, 4908, 4909, 4910, 4911, 4912, 4914, 4915, 4916, 4917, 4918, 4919, 4920, 4921, 4922, 4923, 4924, 4925, 4926, 4927, 4928, 4929, 4930, 4931, 4932, 4933, 4934, 4935, 4936, 4937, 4938, 4939, 4940, 4942, 4943, 4944, 4945, 4946, 4947, 4948, 4949, 4950, 4951, 4952, 4953, 4954, 4955, 4956, 4957, 4958, 4959, 4960, 4961, 4962, 4963, 4964, 4965, 4967, 4968, 4969, 4970, 4971, 4972, 4973, 4974, 4975, 4977, 4978, 4979, 4980, 4981, 4982, 4983, 4984, 4986, 4987, 4988, 4989, 4990, 4991, 4993, 4994, 4995, 4996, 4997, 4998, 4999, 5000, 5001, 5002, 5003, 5004, 5005, 5006, 5007, 5009, 5010, 5011, 5012, 5013, 5014, 5015, 5016, 5017, 5018, 5019, 5020, 5021, 5022, 5023, 5024, 5025, 5027, 5028, 5029, 5031, 5032, 5033, 5034, 5035, 5036, 5037, 5038, 5039, 5040, 5041, 5042, 5043, 5044, 5045, 5046, 5047, 5048, 5049, 5050, 5051, 5052, 5053, 5055, 5056, 5057, 5058, 5059, 5060, 5061, 5062, 5063, 5064, 5065, 5066, 5067, 5068, 5069, 5070, 5071, 5072, 5073, 5074, 5075, 5076, 5077, 5078, 5079, 5080, 5081, 5082, 5083, 5084, 5085, 5086, 5087, 5090, 5091, 5092, 5093, 5094, 5095, 5096, 5097, 5098, 5099, 5100, 5101, 5102, 5103, 5104, 5105, 5106, 5107, 5108, 5109, 5110, 5111, 5112, 5113, 5114, 5115, 5116, 5117, 5118, 5119, 5120, 5121, 5122, 5123, 5124, 5125, 5126, 5127, 5128, 5129, 5130, 5131, 5132, 5133, 5134, 5135, 5136, 5137, 5138, 5139, 5140, 5141, 5142, 5143, 5144, 5145, 5147, 5148, 5149, 5150, 5151, 5152, 5153, 5155, 5156, 5157, 5158, 5159, 5160, 5161, 5162, 5163, 5164, 5165, 5166, 5167, 5168, 5169, 5170, 5171, 5172, 5174, 5175, 5176, 5178, 5179, 5181, 5182, 5183, 5185, 5186, 5187, 5188, 5190, 5191, 5192, 5193, 5194, 5195, 5196, 5197, 5198, 5199, 5200, 5201, 5202, 5203, 5204, 5205, 5206, 5207, 5208, 5209, 5210, 5211, 5212, 5213, 5214, 5215, 5216, 5217, 5218, 5219, 5220, 5221, 5224, 5225, 5226, 5229, 5230, 5231, 5232, 5233, 5234, 5236, 5237, 5238, 5239, 5240, 5241, 5242, 5243, 5245, 5246, 5247, 5248, 5249, 5251, 5252, 5253, 5254, 5256, 5257, 5258, 5259, 5260, 5261, 5262, 5263, 5264, 5265, 5266, 5267, 5268, 5269, 5270, 5271, 5272, 5273, 5274, 5275, 5276, 5277, 5278, 5279, 5280, 5281, 5282, 5283, 5284, 5285, 5286, 5287, 5288, 5289, 5290, 5291, 5292, 5294, 5295, 5296, 5297, 5298, 5299, 5300, 5301, 5302, 5303, 5304, 5305, 5306, 5307, 5308, 5309, 5310, 5311, 5312, 5313, 5314, 5315, 5316, 5317, 5319, 5320, 5321, 5323, 5324, 5325, 5326, 5327, 5328, 5329, 5330, 5331, 5332, 5333, 5334, 5335, 5336, 5337, 5338, 5339, 5340, 5341, 5342, 5343, 5344, 5345, 5346, 5347, 5348, 5349, 5350, 5351, 5352, 5353, 5354, 5355, 5356, 5357, 5358, 5359, 5361, 5362, 5363, 5364, 5365, 5366, 5367, 5368, 5369, 5370, 5371, 5372, 5373, 5375, 5376, 5377, 5378, 5379, 5380, 5381, 5383, 5384, 5385, 5386, 5387, 5388, 5389, 5390, 5391, 5392, 5393, 5394, 5396, 5397, 5398, 5399, 5400, 5401, 5402, 5403, 5404, 5405, 5406, 5407, 5408, 5409, 5410, 5411, 5412, 5413, 5414, 5416, 5417, 5418, 5419, 5420, 5422, 5423, 5424, 5425, 5426, 5427, 5428, 5429, 5430, 5431, 5432, 5433, 5434, 5435, 5437, 5438, 5439, 5440, 5441, 5442, 5443, 5444, 5445, 5446, 5447, 5448, 5449, 5450, 5451, 5452, 5453, 5454, 5455, 5456, 5457, 5458, 5459, 5460, 5461, 5462, 5463, 5464, 5465, 5466, 5467, 5468, 5469, 5470, 5471, 5472, 5473, 5474, 5475, 5476, 5477, 5478, 5479, 5480, 5481, 5482, 5483, 5484, 5485, 5486, 5487, 5488, 5489, 5490, 5491, 5492, 5493, 5494, 5495, 5496, 5497, 5498, 5499, 5500, 5501, 5502, 5503, 5504, 5505, 5506, 5507, 5508, 5509, 5510, 5511, 5512, 5513, 5514, 5515, 5516, 5517, 5518, 5519, 5520, 5521, 5522, 5523, 5524, 5525, 5526, 5527, 5529, 5530, 5531, 5532, 5533, 5534, 5535, 5536, 5537, 5538, 5562, 5571, 5572, 5573, 5574, 5575, 5576, 5577, 5578, 5579, 5580, 5581, 5582, 5583, 5584, 5585, 5586, 5587, 5588, 5589, 5590, 5591, 5592, 5593, 5594, 5595, 5596, 5597, 5598, 5600, 5601, 5606, 5618, 5634, 5635, 5636, 5637, 5638, 5639, 5640, 5642, 5643, 5645, 5646, 5647, 5648, 5649, 5650, 5651, 5652, 5653, 5654, 5655, 5656, 5657, 5658, 5659, 5660, 5661, 5662, 5663, 5664, 5665, 5666, 5667, 5668, 5669, 5670, 5671, 5672, 5673, 5674, 5676, 5677, 5678, 5679, 5680, 5681, 5682, 5683, 5684, 5685, 5686, 5688, 5689, 5690, 5691, 5692, 5693, 5694, 5695, 5696, 5697, 5698, 5699, 5700, 5701, 5702, 5703, 5704, 5705, 5706, 5707, 5708, 5709, 5711, 5712, 5713, 5714, 5716, 5717, 5718, 5720, 5721, 5722, 5723, 5724, 5726, 5728, 5729, 5730, 5731, 5732, 5733, 5734, 5735, 5736, 5737, 5739, 5740, 5741, 5742, 5743, 5744, 5745, 5746, 5747, 5748, 5749, 5751, 5752, 5753, 5754, 5755, 5756, 5757, 5758, 5759, 5760, 5761, 5762, 5763, 5764, 5765, 5766, 5767, 5768, 5769, 5771, 5772, 5773, 5774, 5775, 5776, 5777, 5778, 5779, 5780, 5781, 5782, 5783, 5784, 5785, 5786, 5787, 5788, 5789, 5791, 5792, 5793, 5794, 5795, 5796, 5797, 5798, 5799, 5800, 5801, 5802, 5803, 5804, 5805, 5806, 5808, 5809, 5810, 5811, 5813, 5814, 5815, 5816, 5817, 5819, 5820, 5821, 5822, 5823, 5825, 5826, 5827, 5828, 5829, 5830, 5831, 5832, 5833, 5834, 5835, 5836, 5837, 5838, 5839, 5840, 5841, 5842, 5843, 5844, 5846, 5847, 5848, 5849, 5850, 5851, 5852, 5853, 5854, 5855, 5856, 5857, 5858, 5859, 5860, 5861, 5862, 5863, 5864, 5865, 5866, 5868, 5869, 5870, 5871, 5872, 5874, 5875, 5876, 5877, 5878, 5880, 5881, 5882, 5883, 5884, 5886, 5887, 5888, 5889, 5890, 5891, 5892, 5893, 5894, 5895, 5896, 5897, 5898, 5899, 5900, 5901, 5902, 5903, 5904, 5905, 5906, 5907, 5908, 5909, 5910, 5912, 5913, 5914, 5915, 5916, 5917, 5918, 5919, 5920, 5921, 5922, 5924, 5925, 5926, 5927, 5928, 5929, 5932, 5933, 5934, 5935, 5936, 5937, 5938, 5939, 5940, 5942, 5943, 5944, 5945, 5946, 5947, 5948, 5949, 5950, 5952, 5953, 5954, 5955, 5956, 5957, 5960, 5962, 5963, 5965, 5966, 5967, 5968, 5969, 5970, 5971, 5972, 5973, 5974, 5975, 5976, 5977, 5978, 5979, 5980, 5981, 5983, 5984, 5985, 5986, 5987, 5988, 5989, 5990, 5991, 5992, 5993, 5994, 5995, 5996, 5997, 5998, 5999, 6000, 6001, 6002, 6003, 6004, 6005, 6006, 6007, 6008, 6009, 6010, 6011, 6012, 6013, 6015, 6016, 6017, 6018, 6019, 6021, 6022, 6023, 6024, 6025, 6027, 6028, 6029, 6030, 6031, 6032, 6034, 6036, 6037, 6038, 6039, 6040, 6041, 6042, 6043, 6044, 6045, 6046, 6047, 6048, 6049, 6051, 6052, 6053, 6055, 6056, 6057, 6058, 6059, 6060, 6061, 6063, 6064, 6065, 6066, 6067, 6068, 6069, 6070, 6071, 6072, 6073, 6074, 6075, 6076, 6077, 6078, 6079, 6080, 6081, 6083, 6084, 6085, 6086, 6087, 6088, 6089, 6090, 6091, 6092, 6093, 6094, 6095, 6096, 6097, 6099, 6100, 6101, 6102, 6103, 6104, 6105, 6106, 6107, 6108, 6109, 6111, 6112, 6113, 6114, 6115, 6116, 6117, 6118, 6119, 6120, 6121, 6122, 6123, 6124, 6126, 6127, 6128, 6129, 6130, 6131, 6132, 6133, 6134, 6135, 6136, 6137, 6139, 6140, 6141, 6142, 6143, 6144, 6145, 6146, 6147, 6148, 6149, 6150, 6151, 6152, 6153, 6154, 6155, 6156, 6157, 6158, 6159, 6160, 6161, 6162, 6163, 6164, 6165, 6166, 6167, 6168, 6169, 6170, 6171, 6172, 6173, 6174, 6175, 6176, 6178, 6179, 6180, 6181, 6182, 6183, 6184, 6185, 6186, 6187, 6189, 6190, 6191, 6192, 6193, 6194, 6195, 6196, 6197, 6198, 6200, 6201, 6202, 6203, 6204, 6205, 6206, 6207, 6208, 6209, 6210, 6211, 6212, 6213, 6214, 6215, 6216, 6217, 6218, 6219, 6220, 6221, 6222, 6223, 6224, 6225, 6226, 6227, 6228, 6229, 6230, 6231, 6232, 6233, 6234, 6235, 6236, 6237, 6238, 6239, 6240, 6241, 6242, 6243, 6244, 6245, 6246, 6247, 6248, 6249, 6250, 6251, 6252, 6253, 6254, 6255, 6256, 6257, 6258, 6259, 6260, 6261, 6262, 6263, 6264, 6265, 6266, 6267, 6269, 6270, 6271, 6272, 6273, 6274, 6275, 6276, 6277, 6278, 6279, 6280, 6281, 6282, 6283, 6284, 6285, 6286, 6287, 6288, 6289, 6290, 6291, 6292, 6293, 6294, 6295, 6296, 6297, 6298, 6299, 6300, 6301, 6302, 6303, 6304, 6305, 6306, 6307, 6308, 6309, 6310, 6311, 6313, 6314, 6315, 6316, 6317, 6318, 6319, 6320, 6321, 6322, 6323, 6324, 6325, 6326, 6327, 6328, 6329, 6330, 6331, 6332, 6333, 6334, 6335, 6336, 6337, 6338, 6339, 6340, 6341, 6342, 6343, 6344, 6345, 6346, 6347, 6348, 6349, 6350, 6351, 6352, 6353, 6354, 6355, 6356, 6357, 6358, 6359, 6360, 6361, 6362, 6363, 6364, 6365, 6369, 6370, 6371, 6372, 6373, 6374, 6375, 6376, 6377, 6378, 6379, 6380, 6381, 6382, 6383, 6384, 6385, 6386, 6387, 6388, 6389, 6390, 6391, 6392, 6393, 6395, 6396, 6398, 6399, 6401, 6402, 6404, 6405, 6407, 6408, 6410, 6411, 6412, 6413, 6414, 6415, 6416, 6417, 6418, 6419, 6420, 6421, 6422, 6423, 6424, 6425, 6426, 6427, 6428, 6429, 6430, 6431, 6433, 6434, 6435, 6436, 6437, 6438, 6439, 6440, 6441, 6442, 6443, 6444, 6445, 6446, 6447, 6448, 6449, 6450, 6452, 6453, 6454, 6455, 6457, 6458, 6460, 6461, 6462, 6463, 6464, 6466, 6467, 6468, 6469, 6470, 6471, 6472, 6473, 6474, 6475, 6476, 6477, 6478, 6479, 6480, 6481, 6482, 6483, 6484, 6485, 6486, 6487, 6488, 6489, 6491, 6492, 6493, 6494, 6495, 6496, 6497, 6498, 6499, 6500, 6501, 6502, 6503, 6504, 6505, 6506, 6507, 6508, 6509, 6510, 6511, 6512, 6513, 6514, 6515, 6516, 6517, 6518, 6519, 6520, 6521, 6522, 6523, 6524, 6525, 6526, 6527, 6528, 6529, 6530, 6531, 6532, 6533, 6534, 6535, 6536, 6537, 6538, 6539, 6540, 6541, 6542, 6543, 6544, 6545, 6547, 6548, 6552, 6553, 6554, 6555, 6556, 6557, 6558, 6559, 6560, 6561, 6562, 6563, 6564, 6565, 6566, 6567, 6568, 6569, 6570, 6571, 6572, 6573, 6575, 6576, 6577, 6578, 6579, 6580, 6581, 6582, 6583, 6584, 6585, 6586, 6587, 6589, 6590, 6591, 6592, 6593, 6596, 6628, 6639, 6640, 6641, 6642, 6643, 6644, 6645, 6646, 6647, 6648, 6649, 6650, 6651, 6652, 6653, 6654, 6655, 6656, 6657, 6658, 6659, 6660, 6661, 6662, 6663, 6664, 6665, 6666, 6667, 6668, 6669, 6670, 6671, 6672, 6673, 6675, 6676, 6677, 6678, 6679, 6680, 6681, 6682, 6683, 6684, 6685, 6686, 6687, 6688, 6689, 6690, 6691, 6692, 6693, 6694, 6695, 6696, 6697, 6698, 6699, 6700, 6701, 6702, 6703, 6704, 6705, 6706, 6707, 6708, 6709, 6710, 6711, 6712, 6713, 6714, 6715, 6716, 6717, 6718, 6719, 6720, 6721, 6722, 6723, 6724, 6725, 6726, 6727, 6728, 6729, 6730, 6731, 6732, 6733, 6734, 6735, 6736, 6737, 6738, 6739, 6740, 6741, 6742, 6743, 6744, 6745, 6747, 6748, 6750, 6751, 6752, 6753, 6754, 6755, 6756, 6757, 6758, 6759, 6760, 6762, 6764, 6765, 6766, 6767, 6768, 6769, 6770, 6771, 6772, 6773, 6774, 6775, 6776, 6777, 6778, 6779, 6780, 6781, 6782, 6783, 6784, 6785, 6786, 6787, 6788, 6789, 6790, 6791, 6792, 6793}",4964
13,"(('batch', ('Request For Payment FINAL_APPROVED by SUPERVISOR', 'Request Payment')),)",1,149,"{0, 1, 2, 3, 4, 5, 6, 7, 8, 9, 10, 11, 12, 14, 15, 16, 17, 18, 20, 21, 22, 23, 24, 25, 27, 28, 29, 30, 31, 32, 33, 34, 35, 36, 37, 38, 39, 42, 43, 44, 45, 46, 47, 48, 49, 50, 51, 52, 53, 54, 55, 56, 57, 58, 59, 60, 61, 62, 64, 65, 66, 67, 68, 69, 70, 71, 72, 73, 74, 75, 78, 79, 80, 81, 83, 84, 85, 86, 88, 89, 90, 91, 92, 93, 94, 95, 96, 97, 98, 99, 100, 101, 102, 103, 104, 105, 106, 107, 108, 109, 110, 111, 112, 113, 114, 116, 118, 123, 124, 125, 126, 127, 128, 129, 130, 131, 132, 133, 134, 135, 136, 137, 138, 139, 140, 141, 143, 144, 145, 146, 147, 148, 149, 150, 151, 153, 154, 155, 156, 158, 159, 160, 161, 162, 163, 164, 165, 166, 167, 168, 169, 171, 172, 175, 176, 179, 180, 181, 182, 183, 184, 185, 186, 187, 188, 189, 190, 191, 192, 193, 194, 195, 196, 198, 199, 200, 201, 202, 203, 204, 205, 206, 207, 208, 209, 210, 211, 212, 213, 214, 215, 216, 217, 218, 219, 220, 221, 222, 223, 224, 225, 226, 227, 228, 229, 230, 231, 232, 234, 235, 236, 237, 238, 239, 240, 241, 242, 243, 244, 245, 246, 247, 248, 249, 250, 251, 252, 253, 254, 256, 257, 258, 259, 260, 261, 262, 263, 264, 265, 266, 267, 268, 269, 271, 272, 273, 274, 275, 276, 277, 278, 279, 280, 281, 282, 283, 284, 285, 286, 287, 288, 289, 290, 291, 292, 293, 294, 295, 296, 297, 298, 300, 301, 302, 303, 305, 307, 310, 311, 312, 313, 314, 315, 316, 317, 318, 321, 322, 323, 324, 325, 326, 327, 331, 332, 333, 334, 335, 336, 337, 338, 339, 340, 341, 342, 343, 344, 345, 346, 348, 349, 350, 351, 352, 353, 356, 357, 358, 359, 360, 361, 362, 363, 364, 365, 366, 367, 368, 369, 370, 372, 373, 375, 376, 377, 378, 379, 380, 382, 383, 384, 385, 386, 387, 388, 389, 390, 391, 392, 393, 394, 395, 396, 397, 398, 399, 400, 401, 402, 403, 404, 405, 406, 407, 408, 409, 410, 411, 414, 415, 416, 417, 418, 419, 420, 421, 422, 423, 424, 425, 426, 427, 428, 429, 430, 431, 433, 434, 435, 436, 437, 438, 439, 440, 441, 443, 444, 445, 446, 447, 449, 450, 451, 452, 453, 454, 456, 457, 458, 459, 460, 461, 462, 463, 464, 466, 467, 468, 469, 470, 471, 473, 474, 475, 476, 477, 478, 479, 481, 482, 483, 484, 486, 487, 488, 489, 490, 491, 492, 493, 494, 495, 496, 497, 498, 499, 500, 501, 502, 503, 504, 505, 506, 508, 509, 510, 511, 512, 513, 514, 515, 516, 518, 519, 520, 521, 522, 523, 524, 525, 526, 527, 528, 530, 531, 533, 534, 535, 536, 537, 538, 539, 540, 541, 542, 543, 544, 545, 546, 547, 548, 549, 550, 551, 552, 553, 554, 555, 556, 557, 558, 559, 560, 561, 562, 563, 565, 566, 567, 568, 569, 570, 571, 572, 573, 574, 575, 576, 577, 578, 580, 582, 583, 584, 585, 586, 590, 591, 593, 594, 596, 597, 598, 599, 600, 601, 602, 603, 604, 605, 606, 607, 608, 610, 611, 612, 613, 614, 616, 617, 618, 620, 621, 622, 623, 624, 625, 626, 627, 628, 629, 631, 632, 633, 634, 635, 636, 637, 638, 639, 640, 641, 642, 643, 644, 645, 646, 647, 648, 649, 650, 651, 652, 653, 654, 655, 656, 657, 658, 659, 660, 661, 662, 663, 664, 665, 666, 667, 668, 669, 670, 671, 672, 673, 674, 675, 676, 677, 678, 679, 680, 681, 682, 683, 684, 685, 686, 687, 688, 689, 690, 693, 695, 696, 697, 698, 699, 700, 701, 702, 703, 704, 705, 706, 707, 708, 709, 710, 711, 712, 713, 714, 715, 716, 717, 718, 719, 720, 721, 722, 723, 724, 725, 726, 727, 728, 729, 730, 731, 732, 733, 734, 735, 736, 737, 738, 739, 740, 741, 742, 743, 744, 745, 746, 748, 749, 750, 751, 752, 753, 754, 755, 756, 757, 758, 759, 760, 761, 762, 763, 764, 765, 766, 767, 768, 769, 770, 771, 773, 774, 775, 776, 777, 778, 779, 780, 781, 782, 783, 784, 785, 786, 787, 788, 789, 790, 791, 792, 794, 795, 796, 797, 798, 799, 800, 801, 802, 803, 804, 805, 806, 807, 808, 809, 810, 811, 812, 813, 814, 815, 816, 817, 819, 820, 821, 824, 825, 826, 828, 829, 830, 831, 832, 833, 834, 835, 836, 837, 838, 839, 840, 841, 842, 843, 844, 845, 846, 847, 848, 849, 850, 851, 852, 854, 855, 856, 857, 858, 859, 860, 861, 862, 864, 865, 866, 867, 868, 869, 870, 871, 872, 873, 874, 875, 876, 877, 878, 879, 880, 881, 882, 883, 884, 885, 886, 887, 888, 889, 890, 891, 892, 893, 894, 895, 896, 897, 898, 899, 900, 901, 902, 903, 904, 905, 906, 907, 908, 909, 910, 911, 912, 913, 914, 915, 916, 917, 918, 919, 920, 921, 922, 923, 924, 925, 926, 927, 928, 929, 930, 931, 932, 933, 935, 936, 937, 939, 940, 941, 942, 943, 944, 945, 946, 947, 948, 949, 950, 951, 952, 953, 954, 955, 956, 957, 958, 959, 960, 961, 962, 963, 964, 965, 966, 967, 968, 969, 970, 971, 972, 973, 974, 975, 976, 977, 978, 979, 980, 981, 982, 983, 984, 985, 986, 987, 988, 989, 990, 991, 992, 993, 994, 996, 997, 999, 1000, 1001, 1002, 1003, 1004, 1005, 1006, 1007, 1008, 1009, 1010, 1011, 1012, 1013, 1014, 1015, 1016, 1017, 1018, 1019, 1020, 1021, 1022, 1023, 1024, 1025, 1026, 1028, 1029, 1030, 1031, 1032, 1033, 1034, 1035, 1036, 1037, 1038, 1039, 1040, 1041, 1042, 1043, 1044, 1045, 1046, 1047, 1048, 1050, 1051, 1052, 1053, 1054, 1055, 1056, 1057, 1058, 1059, 1060, 1061, 1063, 1064, 1065, 1066, 1067, 1069, 1070, 1071, 1073, 1074, 1075, 1076, 1077, 1078, 1079, 1080, 1081, 1082, 1083, 1085, 1086, 1087, 1088, 1089, 1090, 1092, 1093, 1094, 1095, 1096, 1097, 1098, 1099, 1100, 1101, 1103, 1104, 1105, 1106, 1107, 1108, 1109, 1110, 1111, 1112, 1113, 1114, 1115, 1116, 1117, 1118, 1119, 1120, 1121, 1122, 1123, 1124, 1125, 1126, 1127, 1128, 1129, 1130, 1131, 1132, 1133, 1134, 1135, 1136, 1137, 1138, 1140, 1141, 1142, 1143, 1144, 1145, 1146, 1147, 1148, 1149, 1150, 1151, 1152, 1153, 1154, 1155, 1156, 1157, 1158, 1159, 1160, 1161, 1162, 1163, 1165, 1166, 1167, 1168, 1169, 1170, 1171, 1172, 1173, 1174, 1175, 1176, 1177, 1178, 1179, 1180, 1181, 1182, 1183, 1184, 1185, 1186, 1187, 1188, 1189, 1190, 1191, 1192, 1193, 1194, 1195, 1196, 1197, 1198, 1199, 1200, 1201, 1202, 1203, 1204, 1205, 1206, 1207, 1208, 1209, 1210, 1211, 1212, 1213, 1214, 1215, 1216, 1217, 1218, 1219, 1220, 1221, 1222, 1223, 1224, 1225, 1226, 1227, 1228, 1229, 1230, 1231, 1232, 1233, 1234, 1235, 1236, 1237, 1238, 1239, 1240, 1241, 1242, 1243, 1244, 1245, 1246, 1247, 1248, 1249, 1250, 1251, 1252, 1253, 1254, 1255, 1258, 1259, 1260, 1262, 1263, 1264, 1265, 1267, 1268, 1269, 1270, 1271, 1272, 1273, 1274, 1275, 1276, 1277, 1278, 1279, 1280, 1281, 1282, 1283, 1284, 1285, 1286, 1287, 1288, 1289, 1290, 1291, 1292, 1293, 1294, 1295, 1298, 1299, 1300, 1301, 1302, 1303, 1304, 1305, 1306, 1307, 1308, 1309, 1310, 1311, 1313, 1314, 1315, 1316, 1317, 1318, 1320, 1321, 1323, 1324, 1325, 1326, 1327, 1328, 1329, 1330, 1331, 1332, 1333, 1334, 1335, 1336, 1337, 1338, 1339, 1340, 1342, 1343, 1344, 1345, 1346, 1347, 1348, 1349, 1350, 1351, 1352, 1353, 1354, 1355, 1356, 1357, 1358, 1359, 1360, 1361, 1362, 1364, 1365, 1366, 1367, 1368, 1369, 1370, 1371, 1372, 1373, 1374, 1375, 1376, 1377, 1378, 1379, 1380, 1381, 1382, 1383, 1384, 1385, 1386, 1387, 1388, 1389, 1390, 1391, 1392, 1393, 1394, 1395, 1396, 1397, 1399, 1400, 1401, 1402, 1403, 1404, 1405, 1406, 1407, 1408, 1409, 1410, 1411, 1412, 1413, 1414, 1415, 1416, 1418, 1419, 1420, 1421, 1422, 1423, 1424, 1426, 1427, 1428, 1429, 1430, 1431, 1432, 1433, 1434, 1435, 1436, 1437, 1439, 1440, 1441, 1442, 1443, 1445, 1446, 1447, 1448, 1449, 1450, 1451, 1452, 1453, 1454, 1455, 1456, 1457, 1458, 1459, 1460, 1461, 1462, 1464, 1465, 1466, 1467, 1468, 1469, 1470, 1471, 1472, 1473, 1474, 1475, 1476, 1477, 1478, 1479, 1481, 1482, 1483, 1484, 1485, 1487, 1488, 1489, 1491, 1492, 1493, 1494, 1495, 1496, 1499, 1500, 1501, 1502, 1503, 1504, 1505, 1506, 1507, 1508, 1509, 1510, 1511, 1512, 1513, 1514, 1515, 1516, 1517, 1518, 1519, 1520, 1521, 1522, 1523, 1524, 1525, 1526, 1527, 1528, 1529, 1530, 1531, 1532, 1533, 1534, 1535, 1536, 1538, 1539, 1540, 1541, 1542, 1543, 1544, 1545, 1546, 1548, 1549, 1550, 1551, 1552, 1553, 1554, 1556, 1557, 1558, 1559, 1560, 1561, 1562, 1563, 1564, 1565, 1566, 1567, 1568, 1569, 1570, 1571, 1572, 1573, 1574, 1575, 1576, 1577, 1578, 1579, 1580, 1581, 1582, 1583, 1584, 1585, 1586, 1587, 1588, 1589, 1590, 1591, 1592, 1593, 1594, 1595, 1596, 1597, 1598, 1599, 1600, 1601, 1602, 1603, 1604, 1605, 1606, 1607, 1608, 1609, 1610, 1612, 1613, 1614, 1615, 1616, 1617, 1618, 1619, 1620, 1621, 1622, 1623, 1624, 1625, 1626, 1627, 1628, 1629, 1630, 1631, 1632, 1633, 1634, 1635, 1636, 1637, 1638, 1639, 1640, 1641, 1642, 1643, 1644, 1645, 1646, 1647, 1648, 1649, 1650, 1651, 1652, 1653, 1654, 1655, 1656, 1657, 1658, 1659, 1660, 1661, 1662, 1663, 1664, 1665, 1666, 1667, 1668, 1669, 1670, 1671, 1672, 1673, 1674, 1675, 1676, 1678, 1679, 1680, 1681, 1682, 1683, 1684, 1685, 1686, 1687, 1688, 1689, 1690, 1691, 1692, 1693, 1694, 1695, 1696, 1697, 1698, 1699, 1700, 1701, 1702, 1703, 1704, 1705, 1706, 1707, 1708, 1709, 1710, 1711, 1712, 1713, 1714, 1715, 1716, 1717, 1718, 1719, 1720, 1721, 1722, 1723, 1724, 1725, 1726, 1727, 1728, 1729, 1730, 1731, 1732, 1734, 1735, 1736, 1737, 1738, 1739, 1740, 1741, 1742, 1743, 1744, 1745, 1746, 1747, 1748, 1749, 1752, 1753, 1754, 1755, 1756, 1757, 1758, 1759, 1760, 1761, 1762, 1764, 1765, 1766, 1767, 1768, 1769, 1770, 1771, 1772, 1773, 1774, 1775, 1776, 1778, 1779, 1780, 1781, 1782, 1783, 1784, 1785, 1786, 1787, 1788, 1789, 1790, 1791, 1792, 1793, 1795, 1796, 1797, 1798, 1799, 1800, 1801, 1802, 1803, 1804, 1805, 1806, 1807, 1808, 1809, 1810, 1811, 1812, 1813, 1814, 1815, 1816, 1817, 1818, 1819, 1820, 1821, 1822, 1823, 1824, 1825, 1826, 1827, 1828, 1829, 1830, 1831, 1832, 1833, 1834, 1835, 1836, 1837, 1838, 1839, 1840, 1841, 1842, 1843, 1844, 1845, 1846, 1847, 1848, 1849, 1850, 1851, 1852, 1853, 1854, 1855, 1857, 1858, 1859, 1860, 1861, 1862, 1863, 1864, 1865, 1866, 1867, 1868, 1869, 1870, 1871, 1872, 1873, 1874, 1875, 1876, 1877, 1878, 1879, 1880, 1881, 1882, 1883, 1884, 1885, 1886, 1887, 1888, 1889, 1890, 1891, 1892, 1893, 1894, 1895, 1896, 1897, 1898, 1899, 1900, 1901, 1902, 1903, 1904, 1905, 1907, 1908, 1909, 1910, 1911, 1912, 1914, 1915, 1916, 1918, 1919, 1920, 1921, 1922, 1923, 1924, 1925, 1926, 1927, 1928, 1929, 1930, 1931, 1932, 1934, 1936, 1937, 1938, 1939, 1940, 1941, 1942, 1943, 1944, 1945, 1946, 1947, 1948, 1949, 1950, 1951, 1952, 1954, 1955, 1956, 1957, 1958, 1959, 1960, 1961, 1962, 1963, 1964, 1965, 1966, 1967, 1968, 1969, 1970, 1971, 1972, 1973, 1974, 1975, 1976, 1977, 1978, 1979, 1980, 1981, 1982, 1983, 1984, 1985, 1986, 1987, 1988, 1990, 1991, 1992, 1993, 1994, 1995, 1996, 1997, 1998, 1999, 2000, 2001, 2002, 2003, 2004, 2005, 2006, 2007, 2008, 2009, 2010, 2011, 2012, 2014, 2015, 2016, 2017, 2018, 2019, 2020, 2021, 2022, 2023, 2024, 2025, 2026, 2027, 2028, 2029, 2030, 2031, 2032, 2033, 2034, 2035, 2036, 2037, 2038, 2039, 2040, 2041, 2042, 2043, 2044, 2045, 2046, 2047, 2049, 2050, 2051, 2052, 2053, 2055, 2056, 2057, 2058, 2059, 2060, 2061, 2062, 2063, 2064, 2065, 2066, 2067, 2068, 2069, 2070, 2071, 2073, 2074, 2075, 2076, 2077, 2079, 2080, 2081, 2082, 2083, 2084, 2085, 2086, 2087, 2088, 2089, 2090, 2091, 2092, 2094, 2095, 2096, 2097, 2098, 2099, 2100, 2101, 2102, 2103, 2104, 2106, 2107, 2108, 2109, 2110, 2111, 2112, 2113, 2114, 2115, 2116, 2117, 2118, 2119, 2120, 2121, 2122, 2123, 2124, 2125, 2126, 2128, 2129, 2130, 2131, 2132, 2133, 2134, 2135, 2137, 2138, 2139, 2140, 2141, 2142, 2143, 2144, 2146, 2147, 2148, 2149, 2150, 2151, 2152, 2153, 2154, 2155, 2156, 2157, 2158, 2159, 2160, 2161, 2162, 2163, 2164, 2166, 2167, 2168, 2169, 2170, 2171, 2172, 2173, 2174, 2175, 2176, 2177, 2178, 2179, 2180, 2181, 2182, 2183, 2184, 2185, 2186, 2187, 2188, 2189, 2190, 2191, 2192, 2193, 2194, 2195, 2196, 2197, 2198, 2200, 2201, 2202, 2203, 2204, 2205, 2206, 2207, 2208, 2209, 2210, 2211, 2212, 2213, 2214, 2215, 2216, 2217, 2218, 2219, 2220, 2221, 2222, 2223, 2224, 2225, 2226, 2228, 2229, 2230, 2231, 2232, 2233, 2234, 2235, 2236, 2237, 2239, 2240, 2241, 2242, 2243, 2244, 2245, 2246, 2247, 2248, 2249, 2250, 2251, 2252, 2253, 2254, 2255, 2259, 2260, 2261, 2262, 2263, 2264, 2265, 2266, 2267, 2268, 2269, 2270, 2271, 2272, 2273, 2274, 2275, 2276, 2277, 2280, 2281, 2282, 2283, 2284, 2285, 2287, 2288, 2289, 2290, 2291, 2292, 2293, 2294, 2295, 2296, 2297, 2298, 2299, 2300, 2301, 2302, 2303, 2304, 2305, 2306, 2307, 2309, 2310, 2311, 2312, 2313, 2315, 2316, 2317, 2318, 2319, 2320, 2321, 2322, 2323, 2324, 2325, 2327, 2328, 2329, 2330, 2331, 2332, 2333, 2334, 2335, 2336, 2337, 2338, 2339, 2340, 2341, 2342, 2344, 2345, 2346, 2347, 2348, 2349, 2350, 2351, 2352, 2353, 2354, 2355, 2356, 2357, 2358, 2359, 2360, 2361, 2362, 2363, 2364, 2365, 2366, 2367, 2368, 2369, 2370, 2371, 2373, 2374, 2375, 2376, 2377, 2378, 2379, 2380, 2381, 2382, 2383, 2384, 2385, 2386, 2387, 2388, 2389, 2390, 2391, 2392, 2393, 2394, 2395, 2396, 2397, 2398, 2399, 2401, 2402, 2403, 2404, 2405, 2406, 2407, 2408, 2409, 2410, 2411, 2412, 2413, 2414, 2415, 2416, 2419, 2420, 2421, 2422, 2423, 2424, 2425, 2426, 2427, 2428, 2429, 2430, 2431, 2432, 2433, 2434, 2435, 2436, 2437, 2438, 2439, 2440, 2441, 2442, 2443, 2444, 2445, 2448, 2449, 2450, 2452, 2453, 2454, 2455, 2456, 2457, 2458, 2459, 2460, 2461, 2462, 2463, 2464, 2465, 2466, 2467, 2469, 2470, 2471, 2472, 2473, 2474, 2475, 2476, 2477, 2478, 2479, 2480, 2481, 2482, 2483, 2484, 2485, 2486, 2487, 2488, 2489, 2490, 2491, 2492, 2494, 2495, 2496, 2497, 2499, 2500, 2501, 2503, 2504, 2505, 2506, 2508, 2509, 2510, 2511, 2512, 2513, 2514, 2515, 2516, 2517, 2518, 2519, 2520, 2521, 2522, 2523, 2524, 2525, 2526, 2527, 2528, 2529, 2530, 2531, 2532, 2533, 2534, 2535, 2536, 2537, 2538, 2540, 2541, 2543, 2544, 2546, 2547, 2548, 2549, 2550, 2551, 2552, 2553, 2554, 2555, 2556, 2557, 2558, 2559, 2560, 2561, 2562, 2563, 2564, 2566, 2567, 2568, 2569, 2570, 2572, 2574, 2575, 2576, 2577, 2578, 2579, 2580, 2581, 2582, 2583, 2584, 2585, 2586, 2587, 2590, 2591, 2592, 2593, 2594, 2595, 2596, 2597, 2598, 2599, 2600, 2601, 2603, 2604, 2605, 2606, 2607, 2608, 2609, 2610, 2611, 2612, 2613, 2614, 2615, 2616, 2617, 2620, 2621, 2622, 2623, 2624, 2625, 2626, 2627, 2628, 2629, 2630, 2631, 2632, 2633, 2635, 2636, 2637, 2639, 2640, 2641, 2642, 2643, 2644, 2645, 2646, 2647, 2648, 2649, 2650, 2652, 2653, 2654, 2655, 2656, 2657, 2658, 2659, 2660, 2662, 2664, 2666, 2667, 2668, 2669, 2671, 2672, 2673, 2674, 2677, 2679, 2680, 2681, 2682, 2683, 2684, 2685, 2686, 2687, 2688, 2689, 2690, 2691, 2692, 2693, 2694, 2695, 2696, 2697, 2698, 2699, 2700, 2701, 2703, 2704, 2705, 2706, 2707, 2708, 2709, 2710, 2711, 2712, 2713, 2715, 2716, 2717, 2718, 2720, 2721, 2723, 2724, 2725, 2726, 2727, 2728, 2729, 2730, 2731, 2732, 2733, 2734, 2735, 2736, 2737, 2738, 2739, 2740, 2741, 2744, 2745, 2746, 2747, 2748, 2749, 2750, 2751, 2753, 2754, 2755, 2756, 2757, 2758, 2759, 2760, 2761, 2762, 2763, 2764, 2765, 2766, 2768, 2769, 2770, 2771, 2772, 2773, 2774, 2775, 2776, 2777, 2779, 2780, 2782, 2783, 2784, 2785, 2786, 2787, 2789, 2790, 2791, 2792, 2793, 2794, 2795, 2796, 2797, 2798, 2799, 2800, 2801, 2802, 2803, 2804, 2805, 2806, 2807, 2808, 2809, 2811, 2812, 2813, 2814, 2815, 2816, 2817, 2818, 2819, 2820, 2821, 2822, 2823, 2825, 2826, 2827, 2828, 2830, 2831, 2832, 2833, 2834, 2835, 2836, 2837, 2838, 2839, 2840, 2841, 2842, 2843, 2844, 2845, 2846, 2847, 2848, 2849, 2850, 2851, 2852, 2853, 2854, 2855, 2856, 2857, 2858, 2859, 2860, 2861, 2862, 2863, 2865, 2866, 2867, 2868, 2869, 2870, 2871, 2872, 2873, 2874, 2875, 2877, 2878, 2880, 2883, 2884, 2886, 2887, 2888, 2889, 2890, 2891, 2892, 2893, 2894, 2895, 2896, 2897, 2898, 2899, 2900, 2901, 2902, 2903, 2904, 2905, 2906, 2907, 2908, 2909, 2910, 2911, 2912, 2914, 2915, 2916, 2917, 2918, 2919, 2920, 2921, 2923, 2924, 2925, 2926, 2927, 2930, 2931, 2932, 2933, 2934, 2935, 2937, 2938, 2939, 2940, 2941, 2942, 2943, 2944, 2945, 2946, 2947, 2949, 2950, 2951, 2952, 2953, 2955, 2956, 2957, 2959, 2960, 2961, 2962, 2963, 2965, 2966, 2967, 2968, 2969, 2970, 2971, 2972, 2973, 2974, 2975, 2976, 2977, 2978, 2979, 2980, 2981, 2982, 2983, 2984, 2985, 2986, 2987, 2988, 2989, 2990, 2991, 2992, 2993, 2994, 2995, 2996, 2997, 2998, 2999, 3000, 3001, 3002, 3003, 3004, 3005, 3006, 3007, 3008, 3009, 3010, 3011, 3012, 3014, 3015, 3016, 3017, 3018, 3019, 3020, 3022, 3023, 3024, 3025, 3026, 3027, 3028, 3029, 3030, 3031, 3032, 3033, 3034, 3035, 3036, 3037, 3038, 3039, 3040, 3042, 3043, 3044, 3045, 3046, 3047, 3048, 3049, 3050, 3051, 3052, 3053, 3054, 3055, 3057, 3058, 3059, 3060, 3061, 3062, 3063, 3064, 3065, 3066, 3067, 3068, 3070, 3071, 3072, 3073, 3074, 3075, 3076, 3077, 3079, 3080, 3081, 3082, 3083, 3084, 3086, 3087, 3088, 3089, 3090, 3091, 3093, 3094, 3095, 3096, 3097, 3098, 3099, 3100, 3101, 3102, 3103, 3104, 3105, 3106, 3107, 3108, 3109, 3110, 3111, 3112, 3113, 3114, 3115, 3116, 3118, 3119, 3120, 3121, 3122, 3123, 3124, 3125, 3126, 3127, 3128, 3131, 3132, 3133, 3134, 3135, 3136, 3137, 3138, 3139, 3142, 3143, 3144, 3146, 3147, 3149, 3150, 3151, 3152, 3153, 3155, 3156, 3157, 3158, 3159, 3160, 3162, 3163, 3164, 3165, 3166, 3167, 3169, 3170, 3171, 3172, 3173, 3174, 3175, 3176, 3177, 3178, 3179, 3180, 3181, 3182, 3183, 3184, 3185, 3186, 3187, 3188, 3189, 3190, 3191, 3192, 3193, 3194, 3195, 3196, 3197, 3198, 3199, 3200, 3201, 3202, 3203, 3204, 3205, 3206, 3207, 3208, 3209, 3210, 3211, 3212, 3213, 3214, 3215, 3216, 3217, 3218, 3219, 3222, 3223, 3224, 3225, 3226, 3227, 3228, 3229, 3231, 3232, 3233, 3234, 3236, 3240, 3241, 3242, 3243, 3244, 3245, 3247, 3248, 3249, 3250, 3251, 3252, 3253, 3254, 3255, 3256, 3258, 3259, 3260, 3261, 3262, 3263, 3265, 3269, 3270, 3271, 3272, 3273, 3276, 3277, 3279, 3280, 3281, 3282, 3283, 3284, 3285, 3286, 3287, 3288, 3289, 3291, 3292, 3293, 3294, 3295, 3296, 3298, 3299, 3300, 3301, 3302, 3303, 3304, 3305, 3306, 3307, 3310, 3311, 3312, 3313, 3314, 3316, 3317, 3318, 3319, 3320, 3321, 3322, 3323, 3325, 3326, 3327, 3328, 3329, 3330, 3331, 3332, 3333, 3334, 3335, 3337, 3338, 3339, 3340, 3341, 3342, 3343, 3344, 3345, 3346, 3347, 3349, 3350, 3351, 3352, 3353, 3354, 3355, 3356, 3357, 3358, 3359, 3360, 3362, 3363, 3364, 3366, 3367, 3368, 3369, 3370, 3371, 3372, 3373, 3374, 3375, 3376, 3377, 3378, 3379, 3380, 3381, 3382, 3383, 3384, 3386, 3387, 3388, 3389, 3390, 3391, 3392, 3393, 3394, 3396, 3397, 3398, 3399, 3400, 3401, 3402, 3403, 3404, 3405, 3406, 3407, 3408, 3410, 3411, 3412, 3413, 3414, 3415, 3416, 3417, 3418, 3419, 3421, 3422, 3423, 3424, 3426, 3427, 3428, 3429, 3430, 3431, 3432, 3433, 3434, 3435, 3436, 3437, 3438, 3439, 3440, 3441, 3442, 3443, 3444, 3445, 3446, 3447, 3448, 3449, 3450, 3451, 3452, 3453, 3454, 3455, 3456, 3457, 3459, 3460, 3461, 3462, 3465, 3466, 3467, 3468, 3469, 3470, 3471, 3472, 3473, 3474, 3476, 3477, 3480, 3481, 3482, 3483, 3484, 3485, 3486, 3487, 3488, 3489, 3490, 3491, 3492, 3493, 3494, 3495, 3497, 3498, 3499, 3500, 3501, 3502, 3503, 3504, 3505, 3506, 3507, 3509, 3510, 3511, 3512, 3513, 3514, 3515, 3516, 3519, 3520, 3521, 3522, 3523, 3525, 3526, 3527, 3528, 3529, 3530, 3531, 3532, 3533, 3534, 3535, 3536, 3538, 3539, 3540, 3541, 3542, 3543, 3544, 3545, 3546, 3547, 3548, 3549, 3550, 3551, 3552, 3553, 3556, 3557, 3558, 3562, 3563, 3564, 3565, 3566, 3567, 3568, 3569, 3570, 3571, 3572, 3573, 3574, 3575, 3576, 3577, 3578, 3580, 3581, 3582, 3583, 3584, 3585, 3586, 3588, 3589, 3591, 3592, 3593, 3594, 3595, 3596, 3598, 3599, 3600, 3601, 3602, 3603, 3604, 3605, 3606, 3607, 3608, 3609, 3610, 3611, 3612, 3613, 3614, 3615, 3616, 3617, 3618, 3620, 3621, 3622, 3623, 3624, 3625, 3626, 3627, 3628, 3629, 3630, 3631, 3632, 3633, 3634, 3635, 3636, 3637, 3638, 3639, 3640, 3642, 3644, 3645, 3646, 3647, 3648, 3649, 3650, 3651, 3652, 3653, 3655, 3656, 3657, 3658, 3660, 3661, 3662, 3663, 3664, 3665, 3666, 3667, 3668, 3669, 3670, 3671, 3672, 3673, 3674, 3675, 3676, 3677, 3678, 3679, 3680, 3681, 3682, 3683, 3684, 3685, 3686, 3687, 3688, 3689, 3690, 3691, 3692, 3693, 3694, 3696, 3697, 3698, 3699, 3700, 3701, 3702, 3703, 3704, 3705, 3706, 3707, 3708, 3709, 3710, 3711, 3712, 3713, 3716, 3717, 3718, 3719, 3721, 3722, 3724, 3728, 3729, 3730, 3731, 3732, 3733, 3734, 3735, 3736, 3737, 3738, 3739, 3740, 3743, 3744, 3748, 3749, 3750, 3751, 3752, 3753, 3754, 3756, 3757, 3758, 3759, 3760, 3761, 3762, 3763, 3764, 3765, 3766, 3767, 3768, 3769, 3770, 3772, 3773, 3774, 3775, 3776, 3777, 3778, 3779, 3781, 3782, 3783, 3784, 3785, 3786, 3787, 3788, 3789, 3790, 3791, 3792, 3793, 3794, 3795, 3796, 3797, 3798, 3799, 3800, 3801, 3802, 3803, 3804, 3805, 3806, 3807, 3808, 3809, 3810, 3811, 3812, 3813, 3814, 3815, 3817, 3818, 3819, 3820, 3821, 3822, 3823, 3825, 3826, 3827, 3828, 3829, 3830, 3831, 3832, 3833, 3834, 3835, 3836, 3837, 3838, 3839, 3840, 3841, 3843, 3844, 3845, 3846, 3847, 3848, 3849, 3850, 3851, 3852, 3853, 3854, 3855, 3856, 3857, 3858, 3859, 3860, 3861, 3862, 3863, 3864, 3866, 3867, 3868, 3869, 3870, 3871, 3872, 3873, 3874, 3875, 3877, 3878, 3879, 3880, 3884, 3886, 3887, 3888, 3889, 3890, 3891, 3892, 3893, 3894, 3895, 3896, 3897, 3898, 3899, 3900, 3901, 3902, 3903, 3904, 3905, 3906, 3907, 3908, 3910, 3912, 3913, 3915, 3917, 3918, 3919, 3920, 3921, 3922, 3923, 3924, 3925, 3926, 3927, 3928, 3929, 3930, 3932, 3933, 3934, 3935, 3936, 3937, 3938, 3939, 3940, 3941, 3943, 3944, 3945, 3946, 3947, 3948, 3949, 3950, 3951, 3952, 3953, 3954, 3955, 3956, 3957, 3958, 3959, 3960, 3962, 3963, 3964, 3965, 3966, 3967, 3969, 3972, 3973, 3974, 3975, 3976, 3977, 3978, 3979, 3980, 3981, 3982, 3983, 3984, 3985, 3986, 3987, 3988, 3989, 3990, 3991, 3992, 3993, 3994, 3995, 3996, 3997, 3998, 3999, 4000, 4001, 4002, 4003, 4004, 4005, 4006, 4007, 4008, 4009, 4010, 4011, 4012, 4013, 4014, 4016, 4017, 4018, 4019, 4020, 4021, 4022, 4023, 4024, 4025, 4026, 4027, 4028, 4029, 4030, 4031, 4032, 4033, 4034, 4037, 4038, 4039, 4040, 4041, 4042, 4043, 4044, 4045, 4046, 4047, 4049, 4050, 4053, 4054, 4055, 4056, 4057, 4058, 4059, 4060, 4061, 4062, 4063, 4067, 4068, 4069, 4070, 4071, 4072, 4073, 4074, 4075, 4076, 4077, 4078, 4079, 4080, 4081, 4082, 4083, 4084, 4085, 4086, 4087, 4088, 4089, 4090, 4091, 4092, 4093, 4094, 4095, 4096, 4097, 4098, 4099, 4100, 4101, 4102, 4103, 4104, 4105, 4106, 4107, 4108, 4109, 4111, 4112, 4113, 4114, 4115, 4116, 4117, 4118, 4119, 4120, 4121, 4122, 4123, 4124, 4125, 4126, 4127, 4128, 4129, 4130, 4131, 4132, 4133, 4134, 4135, 4136, 4137, 4138, 4139, 4140, 4141, 4142, 4143, 4144, 4145, 4147, 4148, 4149, 4150, 4151, 4152, 4153, 4154, 4155, 4156, 4157, 4158, 4159, 4160, 4161, 4163, 4164, 4165, 4166, 4167, 4168, 4169, 4170, 4171, 4172, 4173, 4174, 4175, 4176, 4177, 4178, 4179, 4181, 4182, 4183, 4184, 4185, 4186, 4187, 4188, 4189, 4190, 4191, 4192, 4193, 4194, 4195, 4196, 4197, 4198, 4200, 4201, 4202, 4203, 4204, 4205, 4206, 4207, 4208, 4209, 4210, 4211, 4212, 4213, 4214, 4215, 4216, 4217, 4218, 4219, 4221, 4222, 4223, 4224, 4225, 4226, 4227, 4228, 4229, 4230, 4231, 4232, 4233, 4234, 4235, 4237, 4238, 4239, 4240, 4241, 4242, 4243, 4244, 4245, 4246, 4247, 4248, 4249, 4250, 4251, 4252, 4253, 4254, 4255, 4256, 4257, 4258, 4259, 4260, 4261, 4262, 4263, 4264, 4265, 4266, 4267, 4269, 4270, 4271, 4272, 4273, 4275, 4276, 4277, 4278, 4279, 4280, 4281, 4283, 4284, 4286, 4287, 4288, 4289, 4290, 4292, 4293, 4294, 4295, 4297, 4298, 4299, 4300, 4301, 4302, 4303, 4304, 4305, 4306, 4307, 4308, 4309, 4310, 4311, 4312, 4313, 4314, 4315, 4316, 4317, 4318, 4319, 4320, 4321, 4322, 4323, 4325, 4326, 4327, 4328, 4329, 4330, 4331, 4332, 4333, 4334, 4335, 4336, 4337, 4339, 4340, 4341, 4342, 4343, 4344, 4345, 4346, 4347, 4348, 4349, 4350, 4351, 4352, 4353, 4354, 4356, 4357, 4358, 4359, 4361, 4362, 4363, 4364, 4365, 4366, 4367, 4368, 4369, 4370, 4371, 4372, 4373, 4374, 4375, 4376, 4377, 4378, 4379, 4380, 4381, 4382, 4383, 4384, 4385, 4386, 4387, 4388, 4389, 4390, 4391, 4392, 4393, 4394, 4395, 4396, 4397, 4398, 4399, 4400, 4401, 4402, 4403, 4404, 4405, 4406, 4407, 4408, 4409, 4410, 4411, 4412, 4413, 4414, 4415, 4416, 4417, 4418, 4419, 4420, 4421, 4422, 4423, 4424, 4425, 4426, 4427, 4428, 4429, 4430, 4432, 4433, 4434, 4435, 4436, 4437, 4438, 4439, 4440, 4441, 4442, 4443, 4444, 4445, 4446, 4447, 4448, 4449, 4450, 4451, 4452, 4453, 4455, 4456, 4457, 4458, 4459, 4460, 4461, 4463, 4465, 4466, 4467, 4468, 4469, 4471, 4472, 4473, 4474, 4477, 4478, 4479, 4480, 4481, 4482, 4483, 4484, 4485, 4486, 4487, 4488, 4489, 4490, 4491, 4492, 4493, 4494, 4495, 4496, 4497, 4498, 4499, 4500, 4501, 4502, 4503, 4504, 4505, 4506, 4507, 4508, 4509, 4510, 4511, 4512, 4513, 4514, 4515, 4516, 4517, 4518, 4519, 4520, 4521, 4522, 4523, 4524, 4525, 4526, 4527, 4528, 4529, 4530, 4531, 4532, 4533, 4534, 4535, 4536, 4537, 4538, 4539, 4540, 4541, 4542, 4543, 4544, 4545, 4546, 4547, 4548, 4549, 4551, 4552, 4553, 4554, 4555, 4556, 4557, 4558, 4559, 4560, 4561, 4562, 4563, 4564, 4565, 4566, 4567, 4568, 4569, 4570, 4571, 4572, 4573, 4574, 4575, 4576, 4577, 4578, 4579, 4580, 4581, 4582, 4583, 4584, 4585, 4586, 4587, 4588, 4589, 4590, 4591, 4593, 4594, 4595, 4596, 4597, 4598, 4599, 4600, 4601, 4602, 4603, 4604, 4605, 4606, 4607, 4608, 4610, 4611, 4612, 4613, 4614, 4615, 4616, 4618, 4619, 4620, 4621, 4622, 4623, 4624, 4625, 4626, 4627, 4628, 4629, 4630, 4632, 4633, 4634, 4635, 4636, 4637, 4639, 4640, 4641, 4642, 4643, 4644, 4645, 4646, 4647, 4648, 4650, 4651, 4652, 4653, 4654, 4655, 4656, 4657, 4658, 4659, 4660, 4661, 4662, 4663, 4664, 4665, 4666, 4667, 4668, 4669, 4670, 4671, 4672, 4673, 4674, 4675, 4676, 4677, 4678, 4679, 4680, 4681, 4682, 4683, 4684, 4685, 4686, 4687, 4688, 4689, 4690, 4691, 4692, 4693, 4694, 4695, 4696, 4697, 4698, 4699, 4700, 4701, 4702, 4703, 4704, 4705, 4706, 4707, 4708, 4709, 4710, 4711, 4712, 4713, 4715, 4716, 4717, 4718, 4719, 4720, 4722, 4723, 4724, 4725, 4726, 4727, 4728, 4729, 4730, 4731, 4732, 4733, 4734, 4735, 4736, 4737, 4738, 4739, 4740, 4741, 4742, 4743, 4744, 4745, 4746, 4747, 4748, 4749, 4750, 4751, 4752, 4753, 4754, 4755, 4756, 4757, 4758, 4759, 4760, 4761, 4762, 4763, 4764, 4765, 4767, 4768, 4770, 4771, 4772, 4773, 4774, 4775, 4776, 4777, 4778, 4779, 4780, 4781, 4783, 4784, 4785, 4788, 4789, 4790, 4791, 4792, 4793, 4794, 4795, 4796, 4797, 4798, 4799, 4800, 4801, 4802, 4803, 4804, 4805, 4806, 4807, 4808, 4809, 4810, 4811, 4813, 4814, 4815, 4816, 4817, 4818, 4819, 4820, 4821, 4822, 4823, 4826, 4827, 4828, 4829, 4831, 4832, 4833, 4834, 4835, 4836, 4837, 4838, 4839, 4840, 4841, 4842, 4843, 4844, 4845, 4846, 4847, 4848, 4849, 4850, 4851, 4852, 4853, 4854, 4855, 4856, 4857, 4858, 4859, 4860, 4861, 4862, 4863, 4864, 4865, 4866, 4867, 4868, 4869, 4871, 4872, 4873, 4874, 4875, 4876, 4877, 4878, 4879, 4880, 4881, 4882, 4883, 4884, 4885, 4887, 4888, 4889, 4890, 4891, 4892, 4893, 4894, 4895, 4897, 4898, 4899, 4900, 4901, 4902, 4903, 4904, 4905, 4906, 4907, 4908, 4909, 4910, 4911, 4912, 4914, 4915, 4916, 4917, 4918, 4919, 4920, 4921, 4922, 4923, 4925, 4926, 4927, 4928, 4929, 4930, 4931, 4932, 4933, 4934, 4935, 4936, 4937, 4938, 4939, 4940, 4942, 4943, 4944, 4945, 4946, 4947, 4948, 4949, 4950, 4951, 4952, 4953, 4954, 4955, 4956, 4957, 4958, 4959, 4960, 4961, 4962, 4963, 4964, 4965, 4967, 4968, 4969, 4970, 4971, 4972, 4973, 4974, 4975, 4977, 4978, 4979, 4980, 4981, 4982, 4983, 4984, 4986, 4987, 4988, 4989, 4990, 4991, 4993, 4994, 4995, 4996, 4997, 4998, 4999, 5000, 5001, 5002, 5003, 5004, 5005, 5006, 5007, 5009, 5010, 5011, 5012, 5013, 5014, 5015, 5016, 5017, 5018, 5019, 5020, 5021, 5022, 5023, 5024, 5025, 5026, 5027, 5028, 5029, 5031, 5032, 5033, 5034, 5035, 5036, 5037, 5038, 5039, 5040, 5041, 5042, 5043, 5044, 5045, 5046, 5047, 5048, 5049, 5050, 5051, 5052, 5055, 5056, 5057, 5058, 5059, 5060, 5061, 5062, 5063, 5064, 5065, 5066, 5067, 5068, 5069, 5070, 5071, 5072, 5073, 5074, 5075, 5076, 5077, 5078, 5079, 5080, 5081, 5082, 5083, 5084, 5085, 5086, 5087, 5090, 5091, 5092, 5093, 5095, 5096, 5097, 5098, 5099, 5100, 5101, 5102, 5103, 5104, 5105, 5106, 5107, 5108, 5109, 5110, 5111, 5112, 5113, 5114, 5115, 5116, 5117, 5118, 5119, 5120, 5121, 5122, 5123, 5124, 5125, 5126, 5127, 5128, 5129, 5130, 5131, 5132, 5133, 5134, 5135, 5136, 5137, 5138, 5139, 5140, 5141, 5142, 5143, 5144, 5145, 5148, 5149, 5150, 5151, 5152, 5155, 5156, 5157, 5158, 5159, 5160, 5161, 5162, 5163, 5164, 5165, 5166, 5167, 5168, 5169, 5170, 5171, 5172, 5174, 5175, 5176, 5178, 5179, 5181, 5182, 5183, 5185, 5186, 5187, 5188, 5190, 5191, 5192, 5193, 5194, 5195, 5196, 5197, 5198, 5199, 5200, 5201, 5202, 5203, 5204, 5205, 5206, 5207, 5208, 5209, 5210, 5211, 5212, 5213, 5214, 5215, 5216, 5217, 5218, 5219, 5220, 5221, 5224, 5225, 5226, 5229, 5230, 5231, 5232, 5233, 5236, 5237, 5238, 5239, 5240, 5241, 5242, 5243, 5245, 5246, 5247, 5248, 5249, 5250, 5251, 5252, 5253, 5256, 5257, 5258, 5259, 5260, 5261, 5262, 5263, 5264, 5265, 5266, 5267, 5268, 5269, 5270, 5271, 5272, 5273, 5274, 5275, 5276, 5277, 5278, 5279, 5280, 5281, 5282, 5283, 5284, 5285, 5286, 5287, 5288, 5289, 5290, 5291, 5292, 5294, 5295, 5296, 5297, 5298, 5299, 5300, 5301, 5302, 5303, 5304, 5305, 5306, 5307, 5308, 5309, 5310, 5311, 5312, 5313, 5314, 5315, 5316, 5317, 5319, 5320, 5321, 5323, 5324, 5325, 5326, 5327, 5328, 5329, 5330, 5331, 5333, 5334, 5335, 5336, 5337, 5338, 5339, 5340, 5341, 5342, 5343, 5344, 5345, 5346, 5347, 5348, 5350, 5351, 5352, 5353, 5354, 5355, 5356, 5357, 5358, 5359, 5361, 5362, 5363, 5364, 5365, 5366, 5367, 5368, 5369, 5370, 5371, 5372, 5373, 5375, 5376, 5377, 5378, 5379, 5380, 5381, 5383, 5384, 5385, 5386, 5387, 5388, 5389, 5390, 5391, 5392, 5393, 5394, 5396, 5397, 5398, 5399, 5400, 5401, 5402, 5403, 5404, 5405, 5406, 5407, 5408, 5409, 5410, 5411, 5412, 5413, 5414, 5416, 5417, 5418, 5419, 5420, 5422, 5423, 5424, 5425, 5426, 5427, 5428, 5429, 5430, 5431, 5432, 5433, 5434, 5435, 5437, 5438, 5439, 5440, 5441, 5442, 5443, 5444, 5445, 5446, 5447, 5448, 5449, 5450, 5451, 5452, 5453, 5454, 5455, 5456, 5457, 5458, 5459, 5460, 5461, 5462, 5463, 5464, 5465, 5466, 5467, 5468, 5469, 5470, 5471, 5472, 5473, 5474, 5475, 5476, 5477, 5478, 5479, 5480, 5481, 5482, 5483, 5484, 5485, 5486, 5487, 5488, 5489, 5490, 5491, 5492, 5493, 5494, 5495, 5496, 5497, 5498, 5499, 5500, 5501, 5502, 5503, 5504, 5505, 5506, 5507, 5508, 5509, 5510, 5511, 5512, 5513, 5514, 5515, 5516, 5517, 5518, 5519, 5520, 5521, 5522, 5523, 5524, 5525, 5526, 5527, 5529, 5530, 5531, 5532, 5533, 5534, 5535, 5536, 5537, 5538, 5539, 5540, 5541, 5542, 5543, 5544, 5545, 5547, 5548, 5549, 5550, 5551, 5552, 5554, 5555, 5556, 5557, 5558, 5559, 5560, 5561, 5562, 5563, 5564, 5565, 5566, 5567, 5568, 5569, 5570, 5571, 5572, 5573, 5574, 5575, 5576, 5577, 5578, 5579, 5580, 5581, 5582, 5583, 5584, 5585, 5586, 5587, 5588, 5589, 5590, 5591, 5592, 5593, 5594, 5595, 5596, 5597, 5598, 5600, 5601, 5602, 5603, 5604, 5605, 5606, 5607, 5608, 5609, 5610, 5612, 5613, 5614, 5615, 5616, 5617, 5618, 5620, 5622, 5623, 5624, 5625, 5626, 5627, 5628, 5629, 5630, 5631, 5633, 5634, 5635, 5636, 5637, 5639, 5640, 5642, 5643, 5645, 5646, 5647, 5648, 5649, 5650, 5651, 5652, 5653, 5654, 5655, 5656, 5657, 5658, 5659, 5660, 5661, 5662, 5663, 5664, 5665, 5666, 5667, 5668, 5669, 5670, 5671, 5672, 5673, 5674, 5676, 5677, 5678, 5679, 5680, 5681, 5682, 5683, 5684, 5685, 5686, 5688, 5689, 5690, 5691, 5692, 5693, 5694, 5695, 5696, 5697, 5698, 5699, 5700, 5701, 5702, 5703, 5704, 5705, 5706, 5707, 5708, 5709, 5711, 5712, 5713, 5714, 5716, 5717, 5718, 5720, 5721, 5722, 5723, 5724, 5726, 5728, 5729, 5730, 5731, 5732, 5733, 5734, 5735, 5736, 5737, 5739, 5740, 5741, 5742, 5743, 5744, 5745, 5746, 5747, 5748, 5749, 5751, 5752, 5753, 5754, 5755, 5756, 5757, 5758, 5759, 5760, 5761, 5762, 5763, 5764, 5765, 5766, 5767, 5768, 5769, 5771, 5772, 5773, 5774, 5775, 5776, 5777, 5778, 5779, 5780, 5781, 5782, 5783, 5784, 5785, 5786, 5787, 5788, 5789, 5791, 5792, 5793, 5794, 5795, 5796, 5797, 5798, 5799, 5800, 5801, 5802, 5803, 5804, 5805, 5806, 5808, 5809, 5810, 5811, 5813, 5814, 5815, 5816, 5817, 5819, 5820, 5821, 5822, 5823, 5825, 5826, 5827, 5828, 5829, 5830, 5831, 5832, 5833, 5834, 5835, 5836, 5837, 5838, 5839, 5840, 5841, 5842, 5843, 5844, 5846, 5847, 5848, 5849, 5850, 5851, 5852, 5853, 5854, 5855, 5856, 5857, 5858, 5859, 5860, 5861, 5862, 5863, 5864, 5865, 5866, 5868, 5869, 5870, 5871, 5872, 5874, 5875, 5876, 5877, 5878, 5880, 5881, 5882, 5883, 5884, 5886, 5887, 5888, 5889, 5890, 5891, 5892, 5893, 5894, 5895, 5896, 5897, 5898, 5899, 5900, 5901, 5902, 5903, 5904, 5905, 5907, 5908, 5909, 5910, 5912, 5913, 5914, 5915, 5916, 5917, 5918, 5919, 5920, 5921, 5922, 5924, 5925, 5926, 5927, 5928, 5929, 5932, 5933, 5934, 5935, 5936, 5937, 5938, 5939, 5940, 5942, 5943, 5944, 5945, 5946, 5947, 5948, 5949, 5950, 5952, 5953, 5954, 5955, 5956, 5957, 5960, 5962, 5963, 5965, 5966, 5967, 5968, 5969, 5970, 5971, 5972, 5973, 5974, 5975, 5976, 5977, 5978, 5979, 5980, 5981, 5983, 5984, 5985, 5986, 5987, 5988, 5989, 5991, 5992, 5993, 5994, 5995, 5996, 5997, 5998, 5999, 6000, 6001, 6002, 6003, 6004, 6005, 6006, 6007, 6008, 6009, 6010, 6011, 6012, 6013, 6015, 6016, 6017, 6018, 6019, 6021, 6022, 6023, 6024, 6025, 6027, 6028, 6029, 6030, 6031, 6032, 6034, 6036, 6037, 6040, 6041, 6042, 6043, 6044, 6045, 6046, 6047, 6048, 6049, 6051, 6052, 6053, 6055, 6056, 6057, 6058, 6059, 6060, 6061, 6063, 6064, 6065, 6066, 6067, 6068, 6069, 6070, 6071, 6072, 6073, 6074, 6075, 6076, 6077, 6078, 6079, 6080, 6081, 6083, 6084, 6085, 6086, 6087, 6088, 6089, 6090, 6091, 6092, 6093, 6094, 6095, 6096, 6097, 6099, 6100, 6101, 6102, 6103, 6104, 6105, 6106, 6107, 6108, 6109, 6111, 6112, 6113, 6114, 6115, 6116, 6117, 6119, 6120, 6121, 6122, 6123, 6124, 6126, 6127, 6128, 6129, 6130, 6131, 6132, 6133, 6134, 6135, 6136, 6137, 6139, 6140, 6141, 6142, 6143, 6144, 6145, 6146, 6147, 6148, 6149, 6150, 6151, 6152, 6153, 6154, 6155, 6156, 6157, 6158, 6159, 6160, 6161, 6162, 6163, 6164, 6165, 6166, 6167, 6168, 6169, 6170, 6171, 6172, 6173, 6174, 6175, 6176, 6178, 6179, 6180, 6181, 6182, 6183, 6184, 6185, 6186, 6187, 6189, 6190, 6191, 6192, 6193, 6194, 6195, 6196, 6197, 6198, 6200, 6201, 6202, 6203, 6204, 6205, 6206, 6207, 6208, 6209, 6210, 6211, 6212, 6213, 6214, 6215, 6216, 6217, 6218, 6220, 6221, 6222, 6223, 6224, 6225, 6226, 6227, 6228, 6229, 6230, 6231, 6232, 6233, 6234, 6235, 6236, 6237, 6238, 6239, 6240, 6241, 6242, 6243, 6244, 6245, 6246, 6247, 6248, 6249, 6250, 6251, 6252, 6253, 6254, 6255, 6256, 6257, 6258, 6259, 6260, 6261, 6262, 6263, 6264, 6265, 6266, 6267, 6269, 6270, 6271, 6272, 6273, 6274, 6275, 6276, 6277, 6278, 6279, 6280, 6281, 6282, 6283, 6284, 6285, 6286, 6287, 6288, 6289, 6290, 6291, 6292, 6293, 6294, 6295, 6296, 6297, 6298, 6300, 6301, 6302, 6303, 6304, 6305, 6306, 6307, 6308, 6309, 6310, 6311, 6313, 6314, 6315, 6316, 6317, 6318, 6319, 6320, 6321, 6322, 6323, 6324, 6325, 6326, 6327, 6328, 6329, 6330, 6331, 6332, 6333, 6334, 6335, 6336, 6338, 6339, 6340, 6341, 6342, 6343, 6344, 6345, 6346, 6347, 6348, 6349, 6350, 6351, 6352, 6353, 6354, 6355, 6356, 6357, 6358, 6359, 6360, 6361, 6362, 6363, 6364, 6369, 6370, 6371, 6372, 6373, 6374, 6375, 6376, 6377, 6378, 6379, 6380, 6381, 6382, 6383, 6384, 6385, 6386, 6387, 6388, 6389, 6390, 6391, 6392, 6393, 6394, 6395, 6396, 6399, 6401, 6402, 6404, 6405, 6407, 6408, 6410, 6411, 6412, 6413, 6414, 6415, 6416, 6417, 6418, 6419, 6420, 6421, 6422, 6423, 6424, 6425, 6426, 6427, 6428, 6429, 6430, 6431, 6433, 6434, 6435, 6436, 6437, 6438, 6439, 6440, 6441, 6442, 6443, 6444, 6445, 6446, 6447, 6448, 6449, 6450, 6452, 6453, 6454, 6455, 6457, 6458, 6460, 6461, 6462, 6463, 6464, 6467, 6468, 6469, 6470, 6471, 6472, 6473, 6474, 6475, 6476, 6477, 6478, 6479, 6481, 6482, 6483, 6484, 6485, 6486, 6487, 6488, 6489, 6491, 6492, 6493, 6494, 6495, 6496, 6497, 6498, 6499, 6500, 6501, 6502, 6503, 6504, 6505, 6506, 6507, 6508, 6509, 6510, 6511, 6512, 6513, 6514, 6515, 6516, 6517, 6518, 6519, 6520, 6521, 6522, 6523, 6524, 6525, 6526, 6527, 6528, 6529, 6530, 6531, 6532, 6533, 6534, 6535, 6536, 6537, 6538, 6539, 6540, 6541, 6542, 6543, 6544, 6545, 6547, 6548, 6552, 6553, 6554, 6555, 6556, 6557, 6558, 6559, 6560, 6561, 6562, 6563, 6564, 6565, 6566, 6568, 6569, 6570, 6571, 6572, 6573, 6575, 6576, 6577, 6578, 6579, 6580, 6581, 6582, 6583, 6584, 6585, 6586, 6587, 6589, 6590, 6591, 6592, 6593, 6594, 6595, 6596, 6597, 6598, 6600, 6601, 6602, 6603, 6604, 6605, 6606, 6607, 6608, 6609, 6610, 6611, 6612, 6613, 6614, 6615, 6616, 6617, 6618, 6619, 6620, 6621, 6622, 6623, 6624, 6625, 6626, 6627, 6628, 6629, 6630, 6631, 6632, 6633, 6634, 6635, 6636, 6637, 6639, 6640, 6641, 6642, 6643, 6644, 6645, 6646, 6647, 6648, 6649, 6650, 6651, 6652, 6653, 6654, 6655, 6656, 6657, 6658, 6659, 6660, 6661, 6662, 6663, 6664, 6665, 6666, 6667, 6668, 6669, 6670, 6671, 6672, 6673, 6675, 6676, 6677, 6678, 6679, 6680, 6681, 6682, 6683, 6684, 6685, 6686, 6687, 6688, 6689, 6690, 6691, 6692, 6693, 6694, 6695, 6696, 6697, 6698, 6699, 6700, 6701, 6702, 6703, 6704, 6705, 6706, 6707, 6708, 6709, 6710, 6711, 6712, 6713, 6714, 6715, 6716, 6717, 6718, 6719, 6720, 6721, 6722, 6723, 6724, 6725, 6726, 6727, 6728, 6729, 6730, 6731, 6732, 6733, 6734, 6735, 6736, 6737, 6738, 6739, 6740, 6741, 6742, 6743, 6744, 6745, 6747, 6748, 6750, 6751, 6752, 6753, 6754, 6755, 6756, 6757, 6759, 6760, 6762, 6764, 6765, 6766, 6767, 6768, 6769, 6770, 6771, 6773, 6774, 6775, 6776, 6777, 6778, 6779, 6780, 6781, 6782, 6783, 6784, 6785, 6786, 6787, 6788, 6789, 6790, 6791, 6792, 6793}",6261,"{4097, 3, 4100, 4101, 4102, 4103, 4, 4105, 4112, 4113, 4115, 4127, 4128, 4129, 4130, 4137, 4142, 4147, 4148, 4149, 4150, 4151, 4152, 4153, 4157, 4165, 4170, 4172, 4173, 4182, 4190, 4191, 4192, 4207, 4210, 4211, 4218, 4219, 4222, 4230, 4231, 4239, 4240, 4243, 4245, 4247, 4267, 4315, 4322, 2491, 4386, 4392, 4399, 4403, 4436, 4439, 4443, 4445, 4450, 4456, 4457, 4459, 4466, 4467, 4472, 4473, 379, 380, 4479, 383, 4481, 387, 388, 389, 4494, 4498, 4500, 4501, 4502, 4503, 4507, 4512, 4516, 4519, 4520, 4521, 4522, 4523, 4524, 4525, 4527, 4528, 4531, 4534, 4535, 4537, 4545, 4547, 4549, 4551, 4552, 4555, 4556, 4557, 4558, 4562, 4566, 488, 492, 493, 494, 495, 496, 497, 498, 505, 4621, 4625, 4646, 4658, 4659, 4660, 4661, 4662, 4667, 4670, 4674, 4677, 583, 4690, 4691, 4698, 4699, 4702, 4704, 4707, 4718, 622, 4720, 623, 4722, 4730, 4731, 4736, 4742, 4743, 647, 648, 649, 4750, 4752, 4756, 4759, 665, 666, 667, 670, 671, 672, 673, 674, 675, 681, 683, 684, 4791, 4793, 4794, 4796, 4803, 707, 4805, 711, 712, 713, 4810, 4811, 714, 717, 719, 720, 724, 4821, 4822, 4823, 4832, 4840, 4845, 750, 4850, 4851, 755, 758, 760, 761, 762, 763, 764, 4861, 767, 4864, 4865, 768, 769, 4868, 770, 771, 774, 775, 777, 779, 4880, 4884, 4891, 4893, 4897, 4898, 4904, 4906, 4907, 4919, 4928, 4930, 4933, 4934, 4935, 4937, 4938, 4952, 4968, 4970, 4980, 4983, 4986, 5000, 5001, 5002, 5009, 5012, 5015, 5024, 5025, 5031, 5033, 5037, 5039, 5040, 957, 958, 959, 960, 961, 962, 963, 964, 965, 5062, 966, 969, 5067, 971, 973, 5072, 977, 5075, 5080, 5081, 5082, 5085, 5086, 5091, 5092, 5093, 5096, 5097, 5107, 5108, 1014, 1015, 1016, 1019, 1021, 1022, 1023, 5120, 1024, 5130, 5132, 5136, 5137, 5140, 5142, 5145, 5149, 5152, 5159, 5163, 5178, 5179, 5182, 5183, 1087, 5187, 1094, 5191, 5194, 1103, 5200, 5203, 1107, 5207, 1111, 5214, 1123, 5220, 1124, 1125, 1126, 1127, 1128, 1129, 1130, 1131, 5230, 5240, 5245, 1151, 5248, 5249, 1154, 5250, 5262, 1166, 5264, 5266, 5272, 1176, 5275, 5278, 5285, 5287, 5288, 5289, 1195, 5302, 1220, 5320, 5321, 1225, 5323, 1226, 1227, 1231, 5328, 1234, 5333, 1237, 5337, 1242, 5339, 5340, 1243, 1244, 1253, 5353, 5359, 5362, 1269, 1271, 1274, 1275, 5372, 1278, 5376, 5384, 5385, 1288, 5391, 1298, 1300, 5398, 1303, 5402, 1307, 5404, 1308, 1309, 5407, 5409, 1313, 5411, 1314, 1315, 5414, 1316, 1317, 5417, 1318, 1321, 1327, 5430, 1336, 1339, 1340, 5442, 1346, 1348, 5449, 5451, 1356, 1357, 5454, 5455, 1360, 5462, 5463, 1366, 5466, 1370, 5468, 1372, 1374, 5472, 1376, 1380, 5477, 1382, 1387, 5485, 5486, 5487, 1391, 1393, 1397, 5496, 1402, 5500, 1404, 5502, 1407, 1414, 5511, 1416, 5514, 5515, 1418, 5518, 1427, 5524, 5529, 5530, 1433, 5533, 1439, 1446, 1447, 1450, 1451, 1453, 1454, 5552, 1456, 1457, 1459, 5558, 1464, 1466, 5563, 5564, 5565, 5566, 1470, 1471, 1472, 5573, 1477, 5575, 1479, 1481, 1484, 1485, 5582, 5583, 5584, 1489, 5589, 1493, 1495, 5593, 1501, 1502, 5601, 1505, 1506, 1507, 5618, 5622, 5623, 1526, 5637, 1542, 5639, 1543, 5643, 1549, 1552, 5650, 5653, 5654, 5657, 1562, 5659, 1566, 1567, 1569, 5669, 1573, 5671, 1574, 1577, 1578, 1579, 1580, 1581, 1582, 1583, 5683, 1587, 1588, 1593, 1595, 5692, 1596, 5698, 1606, 1607, 5704, 5705, 5706, 5707, 5708, 1612, 1613, 5712, 1616, 1617, 1618, 5716, 1620, 1621, 1622, 1629, 1630, 1631, 1636, 5734, 5735, 5736, 5737, 1638, 1639, 1641, 1643, 1644, 1646, 1647, 1648, 5747, 5748, 1658, 5756, 5757, 5758, 1662, 5760, 1663, 1665, 1666, 1674, 1675, 5772, 5774, 5776, 1680, 5782, 1688, 5785, 1689, 1690, 5788, 1693, 5791, 1696, 5799, 5800, 1707, 1711, 5811, 5813, 5814, 1720, 5819, 1725, 5823, 1727, 5827, 1731, 1732, 5830, 5831, 1735, 1736, 1738, 1740, 1744, 1747, 5846, 5847, 1752, 5850, 5852, 5853, 1756, 1761, 1762, 5860, 5861, 5862, 1767, 5864, 5866, 5870, 5874, 1779, 5878, 5881, 5882, 1788, 5886, 1791, 5888, 1792, 1793, 1795, 5892, 1799, 1800, 5897, 1801, 1802, 1803, 1804, 5902, 5903, 1805, 1806, 1807, 1808, 1809, 1810, 5910, 1811, 1812, 1814, 1815, 5915, 1817, 5918, 1823, 5920, 5921, 1828, 1830, 1831, 1833, 1834, 1838, 5938, 1842, 1843, 1846, 5945, 1849, 1850, 1853, 1854, 1855, 5952, 5953, 5954, 1857, 1863, 1867, 5971, 1876, 1880, 1881, 1883, 5986, 1892, 1897, 1898, 5998, 6001, 1907, 6007, 1911, 6009, 1912, 6015, 6016, 1919, 1920, 1922, 1923, 6021, 6022, 1931, 6029, 1934, 6032, 1937, 6037, 1941, 6041, 6042, 6043, 1946, 1947, 6048, 1957, 6055, 6056, 6058, 1965, 6064, 6065, 6067, 6068, 6069, 1971, 1972, 6074, 1978, 1979, 6078, 6080, 1986, 6083, 1987, 1993, 6091, 6093, 6094, 6096, 6097, 6101, 6103, 2007, 6105, 6106, 6108, 6109, 6113, 6115, 6117, 2021, 2022, 2029, 2030, 6127, 6130, 6131, 6133, 6135, 2041, 6140, 6142, 6143, 6144, 6148, 6152, 6156, 6158, 6173, 2088, 6186, 6187, 2092, 6193, 6196, 2103, 6203, 6204, 2107, 6206, 2109, 6208, 6209, 2112, 6211, 6212, 6213, 6214, 6215, 2113, 2119, 6218, 2122, 6220, 2124, 6225, 6227, 6231, 6232, 6235, 2140, 6237, 6238, 2142, 6240, 6241, 6242, 6243, 6244, 6245, 2147, 2149, 6250, 2156, 6253, 6254, 2162, 2163, 6261, 6263, 6264, 6265, 6266, 6267, 2170, 6269, 6270, 6271, 2178, 6276, 2180, 2182, 2183, 6281, 2185, 2187, 6284, 2190, 6288, 6294, 6295, 2198, 2201, 2202, 2204, 6301, 6302, 6305, 6308, 6309, 6310, 2216, 2217, 6322, 6323, 6326, 2230, 6329, 2235, 6332, 2236, 2237, 6338, 2245, 6342, 6343, 6344, 2252, 6348, 2255, 6352, 6355, 2261, 6358, 6361, 6364, 2273, 6371, 6373, 2277, 2280, 6377, 2282, 2283, 6380, 6384, 6386, 6387, 2290, 2293, 6391, 6392, 2297, 2298, 6395, 6405, 2309, 2310, 6408, 6411, 6412, 6414, 6416, 6417, 2320, 2321, 6421, 6423, 6424, 2327, 2328, 2329, 2331, 6429, 2332, 6431, 2333, 6433, 6434, 2334, 2336, 2337, 2338, 2340, 6440, 2341, 2345, 2346, 6444, 6445, 2347, 6449, 2353, 6453, 6454, 2357, 2358, 6457, 6458, 2360, 6462, 6463, 2370, 6471, 6472, 2375, 2376, 6475, 6476, 6477, 6478, 2383, 6482, 2387, 6484, 2389, 2390, 6487, 6488, 2392, 2393, 6491, 6492, 2394, 6494, 6495, 6496, 2396, 6498, 6499, 2399, 2401, 2404, 2410, 6508, 6510, 2414, 6511, 6514, 2422, 6518, 6519, 6520, 6521, 6522, 6523, 6524, 6525, 6526, 2424, 2428, 2430, 6530, 2438, 2439, 2444, 2445, 2449, 2450, 6547, 6548, 2452, 2455, 2458, 6555, 2459, 6557, 2462, 6560, 6563, 6564, 2469, 6566, 2470, 6568, 2471, 6570, 6571, 2472, 6565, 6576, 2480, 6578, 2484, 6581, 2485, 6583, 2486, 6585, 2487, 6587, 2492, 2488, 6589, 6590, 2489, 2490, 6593, 6594, 6595, 6597, 6598, 2494, 2499, 2500, 6602, 2501, 2504, 6605, 6606, 2508, 6608, 6609, 6610, 2510, 2512, 2514, 2517, 6613, 2519, 2520, 6614, 6619, 2522, 2523, 2524, 2525, 2526, 6621, 2528, 2529, 6622, 2531, 6630, 6631, 6632, 6628, 2533, 2537, 2538, 2540, 6636, 6637, 2544, 6643, 6644, 2551, 2552, 6648, 2555, 2557, 2559, 2561, 2564, 6660, 6661, 6664, 6666, 6671, 6677, 2587, 6686, 2591, 6687, 2593, 6688, 2595, 2596, 2597, 6690, 2599, 6696, 6697, 2603, 6701, 2606, 2607, 2610, 2611, 6710, 2615, 2616, 6712, 6716, 2623, 2625, 2628, 2629, 2631, 2632, 2633, 6730, 2635, 2636, 2637, 2639, 6738, 6739, 2645, 2647, 2648, 2650, 2652, 2655, 6765, 6766, 2673, 2679, 2680, 6776, 6777, 6781, 2687, 2688, 6786, 2692, 2693, 2694, 2696, 2697, 2698, 2700, 2701, 2711, 2720, 2723, 2725, 2726, 2729, 2737, 2739, 2744, 2757, 2758, 2759, 2760, 2761, 2765, 2768, 2773, 2774, 2775, 2776, 2779, 2783, 2784, 2786, 2789, 2790, 2791, 2795, 2796, 2799, 2802, 2803, 2807, 2809, 2812, 2819, 2834, 2835, 2836, 2838, 2841, 2844, 2847, 2851, 2853, 2854, 2855, 2856, 2857, 2862, 2867, 2868, 2869, 2877, 2883, 2886, 2891, 2896, 2904, 2905, 2906, 2910, 2912, 2914, 2916, 2917, 2918, 2919, 2923, 2927, 2930, 2934, 2937, 2938, 2939, 2940, 2941, 2943, 2944, 2946, 2949, 2950, 2963, 2976, 2990, 2991, 3001, 3002, 3003, 3008, 3009, 3010, 3014, 3015, 3016, 3019, 3020, 3022, 3025, 3031, 3032, 3033, 3034, 3038, 3039, 3040, 3044, 3046, 3048, 3053, 3055, 3060, 3062, 3065, 3066, 3067, 3070, 3072, 3073, 3075, 3079, 3084, 3091, 3093, 3094, 3101, 3103, 3106, 3107, 3108, 3109, 3111, 3113, 3115, 3116, 3121, 3123, 3126, 3132, 3135, 3136, 3144, 3151, 3153, 3155, 3157, 3166, 3174, 3179, 3184, 3190, 3198, 3199, 3201, 3202, 3209, 3211, 3215, 3225, 3228, 3250, 3253, 3258, 3263, 3265, 3271, 3272, 3273, 3277, 3284, 3286, 3287, 3289, 3294, 3300, 3301, 3303, 3305, 3311, 3314, 3318, 3322, 3329, 3331, 3338, 3339, 3340, 3351, 3352, 3354, 3355, 3359, 3360, 3364, 3366, 3370, 3371, 3372, 3375, 3380, 3381, 3382, 3383, 3393, 3394, 3397, 3403, 3407, 3410, 3415, 3416, 3422, 3424, 3429, 3433, 3434, 3437, 3439, 3444, 3446, 3447, 3455, 3456, 3457, 3462, 3466, 3468, 3481, 3488, 3489, 3494, 3502, 3503, 3504, 3507, 3521, 3525, 3526, 3528, 3531, 3536, 3538, 3541, 3544, 3545, 3551, 3556, 3562, 3563, 3564, 3565, 3566, 3568, 3573, 3582, 3583, 3595, 3601, 3617, 3618, 3623, 3629, 3651, 3664, 3665, 3671, 3672, 3673, 3676, 3677, 3681, 3693, 3697, 3699, 3701, 3710, 3711, 3716, 3717, 3728, 3729, 3735, 3738, 3743, 3758, 3760, 3762, 3763, 3765, 3767, 3768, 3772, 3776, 3777, 3778, 3783, 3787, 3795, 3797, 3801, 3802, 3806, 3808, 3822, 3825, 3828, 3831, 3847, 3869, 3870, 3874, 3877, 3878, 3880, 3886, 3887, 3888, 3889, 3890, 3891, 3892, 3894, 3895, 3896, 3897, 3901, 3906, 3908, 3910, 3915, 3917, 3920, 3925, 3926, 3928, 3930, 3935, 3937, 3946, 3949, 3952, 3954, 3956, 3959, 3962, 3966, 3969, 3979, 3982, 3983, 3984, 3987, 3993, 3998, 4000, 4003, 4004, 4012, 4020, 4021, 4022, 4023, 4024, 4028, 4031, 4032, 4037, 4038, 4041, 4043, 4045, 4047, 4055, 4056, 4057, 4061, 4068, 4069, 4072, 4073, 4074, 4077, 4081, 4090}",1563,"{0, 1, 2, 5, 6, 7, 8, 9, 10, 11, 12, 14, 15, 16, 17, 18, 20, 21, 22, 23, 24, 25, 27, 28, 29, 30, 31, 32, 33, 34, 35, 36, 37, 38, 39, 42, 43, 44, 45, 46, 47, 48, 49, 50, 51, 52, 53, 54, 55, 56, 57, 58, 59, 60, 61, 62, 64, 65, 66, 67, 68, 69, 70, 71, 72, 73, 74, 75, 78, 79, 80, 81, 83, 84, 85, 86, 88, 89, 90, 91, 92, 93, 94, 95, 96, 97, 98, 99, 100, 101, 102, 103, 104, 105, 106, 107, 108, 109, 110, 111, 112, 113, 114, 116, 118, 123, 124, 125, 126, 127, 128, 129, 130, 131, 132, 133, 134, 135, 136, 137, 138, 139, 140, 141, 143, 144, 145, 146, 147, 148, 149, 150, 151, 153, 154, 155, 156, 158, 159, 160, 161, 162, 163, 164, 165, 166, 167, 168, 169, 171, 172, 175, 176, 179, 180, 181, 182, 183, 184, 185, 186, 187, 188, 189, 190, 191, 192, 193, 194, 195, 196, 198, 199, 200, 201, 202, 203, 204, 205, 206, 207, 208, 209, 210, 211, 212, 213, 214, 215, 216, 217, 218, 219, 220, 221, 222, 223, 224, 225, 226, 227, 228, 229, 230, 231, 232, 234, 235, 236, 237, 238, 239, 240, 241, 242, 243, 244, 245, 246, 247, 248, 249, 250, 251, 252, 253, 254, 256, 257, 258, 259, 260, 261, 262, 263, 264, 265, 266, 267, 268, 269, 271, 272, 273, 274, 275, 276, 277, 278, 279, 280, 281, 282, 283, 284, 285, 286, 287, 288, 289, 290, 291, 292, 293, 294, 295, 296, 297, 298, 300, 301, 302, 303, 305, 307, 310, 311, 312, 313, 314, 315, 316, 317, 318, 321, 322, 323, 324, 325, 326, 327, 331, 332, 333, 334, 335, 336, 337, 338, 339, 340, 341, 342, 343, 344, 345, 346, 348, 349, 350, 351, 352, 353, 356, 357, 358, 359, 360, 361, 362, 363, 364, 365, 366, 367, 368, 369, 370, 372, 373, 375, 376, 377, 378, 382, 384, 385, 386, 390, 391, 392, 393, 394, 395, 396, 397, 398, 399, 400, 401, 402, 403, 404, 405, 406, 407, 408, 409, 410, 411, 414, 415, 416, 417, 418, 419, 420, 421, 422, 423, 424, 425, 426, 427, 428, 429, 430, 431, 433, 434, 435, 436, 437, 438, 439, 440, 441, 443, 444, 445, 446, 447, 449, 450, 451, 452, 453, 454, 456, 457, 458, 459, 460, 461, 462, 463, 464, 466, 467, 468, 469, 470, 471, 473, 474, 475, 476, 477, 478, 479, 481, 482, 483, 484, 486, 487, 489, 490, 491, 499, 500, 501, 502, 503, 504, 506, 508, 509, 510, 511, 512, 513, 514, 515, 516, 518, 519, 520, 521, 522, 523, 524, 525, 526, 527, 528, 530, 531, 533, 534, 535, 536, 537, 538, 539, 540, 541, 542, 543, 544, 545, 546, 547, 548, 549, 550, 551, 552, 553, 554, 555, 556, 557, 558, 559, 560, 561, 562, 563, 565, 566, 567, 568, 569, 570, 571, 572, 573, 574, 575, 576, 577, 578, 580, 582, 584, 585, 586, 590, 591, 593, 594, 596, 597, 598, 599, 600, 601, 602, 603, 604, 605, 606, 607, 608, 610, 611, 612, 613, 614, 616, 617, 618, 620, 621, 624, 625, 626, 627, 628, 629, 631, 632, 633, 634, 635, 636, 637, 638, 639, 640, 641, 642, 643, 644, 645, 646, 650, 651, 652, 653, 654, 655, 656, 657, 658, 659, 660, 661, 662, 663, 664, 668, 669, 676, 677, 678, 679, 680, 682, 685, 686, 687, 688, 689, 690, 693, 695, 696, 697, 698, 699, 700, 701, 702, 703, 704, 705, 706, 708, 709, 710, 715, 716, 718, 721, 722, 723, 725, 726, 727, 728, 729, 730, 731, 732, 733, 734, 735, 736, 737, 738, 739, 740, 741, 742, 743, 744, 745, 746, 748, 749, 751, 752, 753, 754, 756, 757, 759, 765, 766, 773, 776, 778, 780, 781, 782, 783, 784, 785, 786, 787, 788, 789, 790, 791, 792, 794, 795, 796, 797, 798, 799, 800, 801, 802, 803, 804, 805, 806, 807, 808, 809, 810, 811, 812, 813, 814, 815, 816, 817, 819, 820, 821, 824, 825, 826, 828, 829, 830, 831, 832, 833, 834, 835, 836, 837, 838, 839, 840, 841, 842, 843, 844, 845, 846, 847, 848, 849, 850, 851, 852, 854, 855, 856, 857, 858, 859, 860, 861, 862, 864, 865, 866, 867, 868, 869, 870, 871, 872, 873, 874, 875, 876, 877, 878, 879, 880, 881, 882, 883, 884, 885, 886, 887, 888, 889, 890, 891, 892, 893, 894, 895, 896, 897, 898, 899, 900, 901, 902, 903, 904, 905, 906, 907, 908, 909, 910, 911, 912, 913, 914, 915, 916, 917, 918, 919, 920, 921, 922, 923, 924, 925, 926, 927, 928, 929, 930, 931, 932, 933, 935, 936, 937, 939, 940, 941, 942, 943, 944, 945, 946, 947, 948, 949, 950, 951, 952, 953, 954, 955, 956, 967, 968, 970, 972, 974, 975, 976, 978, 979, 980, 981, 982, 983, 984, 985, 986, 987, 988, 989, 990, 991, 992, 993, 994, 996, 997, 999, 1000, 1001, 1002, 1003, 1004, 1005, 1006, 1007, 1008, 1009, 1010, 1011, 1012, 1013, 1017, 1018, 1020, 1025, 1026, 1028, 1029, 1030, 1031, 1032, 1033, 1034, 1035, 1036, 1037, 1038, 1039, 1040, 1041, 1042, 1043, 1044, 1045, 1046, 1047, 1048, 1050, 1051, 1052, 1053, 1054, 1055, 1056, 1057, 1058, 1059, 1060, 1061, 1063, 1064, 1065, 1066, 1067, 1069, 1070, 1071, 1073, 1074, 1075, 1076, 1077, 1078, 1079, 1080, 1081, 1082, 1083, 1085, 1086, 1088, 1089, 1090, 1092, 1093, 1095, 1096, 1097, 1098, 1099, 1100, 1101, 1104, 1105, 1106, 1108, 1109, 1110, 1112, 1113, 1114, 1115, 1116, 1117, 1118, 1119, 1120, 1121, 1122, 1132, 1133, 1134, 1135, 1136, 1137, 1138, 1140, 1141, 1142, 1143, 1144, 1145, 1146, 1147, 1148, 1149, 1150, 1152, 1153, 1155, 1156, 1157, 1158, 1159, 1160, 1161, 1162, 1163, 1165, 1167, 1168, 1169, 1170, 1171, 1172, 1173, 1174, 1175, 1177, 1178, 1179, 1180, 1181, 1182, 1183, 1184, 1185, 1186, 1187, 1188, 1189, 1190, 1191, 1192, 1193, 1194, 1196, 1197, 1198, 1199, 1200, 1201, 1202, 1203, 1204, 1205, 1206, 1207, 1208, 1209, 1210, 1211, 1212, 1213, 1214, 1215, 1216, 1217, 1218, 1219, 1221, 1222, 1223, 1224, 1228, 1229, 1230, 1232, 1233, 1235, 1236, 1238, 1239, 1240, 1241, 1245, 1246, 1247, 1248, 1249, 1250, 1251, 1252, 1254, 1255, 1258, 1259, 1260, 1262, 1263, 1264, 1265, 1267, 1268, 1270, 1272, 1273, 1276, 1277, 1279, 1280, 1281, 1282, 1283, 1284, 1285, 1286, 1287, 1289, 1290, 1291, 1292, 1293, 1294, 1295, 1299, 1301, 1302, 1304, 1305, 1306, 1310, 1311, 1320, 1323, 1324, 1325, 1326, 1328, 1329, 1330, 1331, 1332, 1333, 1334, 1335, 1337, 1338, 1342, 1343, 1344, 1345, 1347, 1349, 1350, 1351, 1352, 1353, 1354, 1355, 1358, 1359, 1361, 1362, 1364, 1365, 1367, 1368, 1369, 1371, 1373, 1375, 1377, 1378, 1379, 1381, 1383, 1384, 1385, 1386, 1388, 1389, 1390, 1392, 1394, 1395, 1396, 1399, 1400, 1401, 1403, 1405, 1406, 1408, 1409, 1410, 1411, 1412, 1413, 1415, 1419, 1420, 1421, 1422, 1423, 1424, 1426, 1428, 1429, 1430, 1431, 1432, 1434, 1435, 1436, 1437, 1440, 1441, 1442, 1443, 1445, 1448, 1449, 1452, 1455, 1458, 1460, 1461, 1462, 1465, 1467, 1468, 1469, 1473, 1474, 1475, 1476, 1478, 1482, 1483, 1487, 1488, 1491, 1492, 1494, 1496, 1499, 1500, 1503, 1504, 1508, 1509, 1510, 1511, 1512, 1513, 1514, 1515, 1516, 1517, 1518, 1519, 1520, 1521, 1522, 1523, 1524, 1525, 1527, 1528, 1529, 1530, 1531, 1532, 1533, 1534, 1535, 1536, 1538, 1539, 1540, 1541, 1544, 1545, 1546, 1548, 1550, 1551, 1553, 1554, 1556, 1557, 1558, 1559, 1560, 1561, 1563, 1564, 1565, 1568, 1570, 1571, 1572, 1575, 1576, 1584, 1585, 1586, 1589, 1590, 1591, 1592, 1594, 1597, 1598, 1599, 1600, 1601, 1602, 1603, 1604, 1605, 1608, 1609, 1610, 1614, 1615, 1619, 1623, 1624, 1625, 1626, 1627, 1628, 1632, 1633, 1634, 1635, 1637, 1640, 1642, 1645, 1649, 1650, 1651, 1652, 1653, 1654, 1655, 1656, 1657, 1659, 1660, 1661, 1664, 1667, 1668, 1669, 1670, 1671, 1672, 1673, 1676, 1678, 1679, 1681, 1682, 1683, 1684, 1685, 1686, 1687, 1691, 1692, 1694, 1695, 1697, 1698, 1699, 1700, 1701, 1702, 1703, 1704, 1705, 1706, 1708, 1709, 1710, 1712, 1713, 1714, 1715, 1716, 1717, 1718, 1719, 1721, 1722, 1723, 1724, 1726, 1728, 1729, 1730, 1734, 1737, 1739, 1741, 1742, 1743, 1745, 1746, 1748, 1749, 1753, 1754, 1755, 1757, 1758, 1759, 1760, 1764, 1765, 1766, 1768, 1769, 1770, 1771, 1772, 1773, 1774, 1775, 1776, 1778, 1780, 1781, 1782, 1783, 1784, 1785, 1786, 1787, 1789, 1790, 1796, 1797, 1798, 1813, 1816, 1818, 1819, 1820, 1821, 1822, 1824, 1825, 1826, 1827, 1829, 1832, 1835, 1836, 1837, 1839, 1840, 1841, 1844, 1845, 1847, 1848, 1851, 1852, 1858, 1859, 1860, 1861, 1862, 1864, 1865, 1866, 1868, 1869, 1870, 1871, 1872, 1873, 1874, 1875, 1877, 1878, 1879, 1882, 1884, 1885, 1886, 1887, 1888, 1889, 1890, 1891, 1893, 1894, 1895, 1896, 1899, 1900, 1901, 1902, 1903, 1904, 1905, 1908, 1909, 1910, 1914, 1915, 1916, 1918, 1921, 1924, 1925, 1926, 1927, 1928, 1929, 1930, 1932, 1936, 1938, 1939, 1940, 1942, 1943, 1944, 1945, 1948, 1949, 1950, 1951, 1952, 1954, 1955, 1956, 1958, 1959, 1960, 1961, 1962, 1963, 1964, 1966, 1967, 1968, 1969, 1970, 1973, 1974, 1975, 1976, 1977, 1980, 1981, 1982, 1983, 1984, 1985, 1988, 1990, 1991, 1992, 1994, 1995, 1996, 1997, 1998, 1999, 2000, 2001, 2002, 2003, 2004, 2005, 2006, 2008, 2009, 2010, 2011, 2012, 2014, 2015, 2016, 2017, 2018, 2019, 2020, 2023, 2024, 2025, 2026, 2027, 2028, 2031, 2032, 2033, 2034, 2035, 2036, 2037, 2038, 2039, 2040, 2042, 2043, 2044, 2045, 2046, 2047, 2049, 2050, 2051, 2052, 2053, 2055, 2056, 2057, 2058, 2059, 2060, 2061, 2062, 2063, 2064, 2065, 2066, 2067, 2068, 2069, 2070, 2071, 2073, 2074, 2075, 2076, 2077, 2079, 2080, 2081, 2082, 2083, 2084, 2085, 2086, 2087, 2089, 2090, 2091, 2094, 2095, 2096, 2097, 2098, 2099, 2100, 2101, 2102, 2104, 2106, 2108, 2110, 2111, 2114, 2115, 2116, 2117, 2118, 2120, 2121, 2123, 2125, 2126, 2128, 2129, 2130, 2131, 2132, 2133, 2134, 2135, 2137, 2138, 2139, 2141, 2143, 2144, 2146, 2148, 2150, 2151, 2152, 2153, 2154, 2155, 2157, 2158, 2159, 2160, 2161, 2164, 2166, 2167, 2168, 2169, 2171, 2172, 2173, 2174, 2175, 2176, 2177, 2179, 2181, 2184, 2186, 2188, 2189, 2191, 2192, 2193, 2194, 2195, 2196, 2197, 2200, 2203, 2205, 2206, 2207, 2208, 2209, 2210, 2211, 2212, 2213, 2214, 2215, 2218, 2219, 2220, 2221, 2222, 2223, 2224, 2225, 2226, 2228, 2229, 2231, 2232, 2233, 2234, 2239, 2240, 2241, 2242, 2243, 2244, 2246, 2247, 2248, 2249, 2250, 2251, 2253, 2254, 2259, 2260, 2262, 2263, 2264, 2265, 2266, 2267, 2268, 2269, 2270, 2271, 2272, 2274, 2275, 2276, 2281, 2284, 2285, 2287, 2288, 2289, 2291, 2292, 2294, 2295, 2296, 2299, 2300, 2301, 2302, 2303, 2304, 2305, 2306, 2307, 2311, 2312, 2313, 2315, 2316, 2317, 2318, 2319, 2322, 2323, 2324, 2325, 2330, 2335, 2339, 2342, 2344, 2348, 2349, 2350, 2351, 2352, 2354, 2355, 2356, 2359, 2361, 2362, 2363, 2364, 2365, 2366, 2367, 2368, 2369, 2371, 2373, 2374, 2377, 2378, 2379, 2380, 2381, 2382, 2384, 2385, 2386, 2388, 2391, 2395, 2397, 2398, 2402, 2403, 2405, 2406, 2407, 2408, 2409, 2411, 2412, 2413, 2415, 2416, 2419, 2420, 2421, 2423, 2425, 2426, 2427, 2429, 2431, 2432, 2433, 2434, 2435, 2436, 2437, 2440, 2441, 2442, 2443, 2448, 2453, 2454, 2456, 2457, 2460, 2461, 2463, 2464, 2465, 2466, 2467, 2473, 2474, 2475, 2476, 2477, 2478, 2479, 2481, 2482, 2483, 2495, 2496, 2497, 2503, 2505, 2506, 2509, 2511, 2513, 2515, 2516, 2518, 2521, 2527, 2530, 2532, 2534, 2535, 2536, 2541, 2543, 2546, 2547, 2548, 2549, 2550, 2553, 2554, 2556, 2558, 2560, 2562, 2563, 2566, 2567, 2568, 2569, 2570, 2572, 2574, 2575, 2576, 2577, 2578, 2579, 2580, 2581, 2582, 2583, 2584, 2585, 2586, 2590, 2592, 2594, 2598, 2600, 2601, 2604, 2605, 2608, 2609, 2612, 2613, 2614, 2617, 2620, 2621, 2622, 2624, 2626, 2627, 2630, 2640, 2641, 2642, 2643, 2644, 2646, 2649, 2653, 2654, 2656, 2657, 2658, 2659, 2660, 2662, 2664, 2666, 2667, 2668, 2669, 2671, 2672, 2674, 2677, 2681, 2682, 2683, 2684, 2685, 2686, 2689, 2690, 2691, 2695, 2699, 2703, 2704, 2705, 2706, 2707, 2708, 2709, 2710, 2712, 2713, 2715, 2716, 2717, 2718, 2721, 2724, 2727, 2728, 2730, 2731, 2732, 2733, 2734, 2735, 2736, 2738, 2740, 2741, 2745, 2746, 2747, 2748, 2749, 2750, 2751, 2753, 2754, 2755, 2756, 2762, 2763, 2764, 2766, 2769, 2770, 2771, 2772, 2777, 2780, 2782, 2785, 2787, 2792, 2793, 2794, 2797, 2798, 2800, 2801, 2804, 2805, 2806, 2808, 2811, 2813, 2814, 2815, 2816, 2817, 2818, 2820, 2821, 2822, 2823, 2825, 2826, 2827, 2828, 2830, 2831, 2832, 2833, 2837, 2839, 2840, 2842, 2843, 2845, 2846, 2848, 2849, 2850, 2852, 2858, 2859, 2860, 2861, 2863, 2865, 2866, 2870, 2871, 2872, 2873, 2874, 2875, 2878, 2880, 2884, 2887, 2888, 2889, 2890, 2892, 2893, 2894, 2895, 2897, 2898, 2899, 2900, 2901, 2902, 2903, 2907, 2908, 2909, 2911, 2915, 2920, 2921, 2924, 2925, 2926, 2931, 2932, 2933, 2935, 2942, 2945, 2947, 2951, 2952, 2953, 2955, 2956, 2957, 2959, 2960, 2961, 2962, 2965, 2966, 2967, 2968, 2969, 2970, 2971, 2972, 2973, 2974, 2975, 2977, 2978, 2979, 2980, 2981, 2982, 2983, 2984, 2985, 2986, 2987, 2988, 2989, 2992, 2993, 2994, 2995, 2996, 2997, 2998, 2999, 3000, 3004, 3005, 3006, 3007, 3011, 3012, 3017, 3018, 3023, 3024, 3026, 3027, 3028, 3029, 3030, 3035, 3036, 3037, 3042, 3043, 3045, 3047, 3049, 3050, 3051, 3052, 3054, 3057, 3058, 3059, 3061, 3063, 3064, 3068, 3071, 3074, 3076, 3077, 3080, 3081, 3082, 3083, 3086, 3087, 3088, 3089, 3090, 3095, 3096, 3097, 3098, 3099, 3100, 3102, 3104, 3105, 3110, 3112, 3114, 3118, 3119, 3120, 3122, 3124, 3125, 3127, 3128, 3131, 3133, 3134, 3137, 3138, 3139, 3142, 3143, 3146, 3147, 3149, 3150, 3152, 3156, 3158, 3159, 3160, 3162, 3163, 3164, 3165, 3167, 3169, 3170, 3171, 3172, 3173, 3175, 3176, 3177, 3178, 3180, 3181, 3182, 3183, 3185, 3186, 3187, 3188, 3189, 3191, 3192, 3193, 3194, 3195, 3196, 3197, 3200, 3203, 3204, 3205, 3206, 3207, 3208, 3210, 3212, 3213, 3214, 3216, 3217, 3218, 3219, 3222, 3223, 3224, 3226, 3227, 3229, 3231, 3232, 3233, 3234, 3236, 3240, 3241, 3242, 3243, 3244, 3245, 3247, 3248, 3249, 3251, 3252, 3254, 3255, 3256, 3259, 3260, 3261, 3262, 3269, 3270, 3276, 3279, 3280, 3281, 3282, 3283, 3285, 3288, 3291, 3292, 3293, 3295, 3296, 3298, 3299, 3302, 3304, 3306, 3307, 3310, 3312, 3313, 3316, 3317, 3319, 3320, 3321, 3323, 3325, 3326, 3327, 3328, 3330, 3332, 3333, 3334, 3335, 3337, 3341, 3342, 3343, 3344, 3345, 3346, 3347, 3349, 3350, 3353, 3356, 3357, 3358, 3362, 3363, 3367, 3368, 3369, 3373, 3374, 3376, 3377, 3378, 3379, 3384, 3386, 3387, 3388, 3389, 3390, 3391, 3392, 3396, 3398, 3399, 3400, 3401, 3402, 3404, 3405, 3406, 3408, 3411, 3412, 3413, 3414, 3417, 3418, 3419, 3421, 3423, 3426, 3427, 3428, 3430, 3431, 3432, 3435, 3436, 3438, 3440, 3441, 3442, 3443, 3445, 3448, 3449, 3450, 3451, 3452, 3453, 3454, 3459, 3460, 3461, 3465, 3467, 3469, 3470, 3471, 3472, 3473, 3474, 3476, 3477, 3480, 3482, 3483, 3484, 3485, 3486, 3487, 3490, 3491, 3492, 3493, 3495, 3497, 3498, 3499, 3500, 3501, 3505, 3506, 3509, 3510, 3511, 3512, 3513, 3514, 3515, 3516, 3519, 3520, 3522, 3523, 3527, 3529, 3530, 3532, 3533, 3534, 3535, 3539, 3540, 3542, 3543, 3546, 3547, 3548, 3549, 3550, 3552, 3553, 3557, 3558, 3567, 3569, 3570, 3571, 3572, 3574, 3575, 3576, 3577, 3578, 3580, 3581, 3584, 3585, 3586, 3588, 3589, 3591, 3592, 3593, 3594, 3596, 3598, 3599, 3600, 3602, 3603, 3604, 3605, 3606, 3607, 3608, 3609, 3610, 3611, 3612, 3613, 3614, 3615, 3616, 3620, 3621, 3622, 3624, 3625, 3626, 3627, 3628, 3630, 3631, 3632, 3633, 3634, 3635, 3636, 3637, 3638, 3639, 3640, 3642, 3644, 3645, 3646, 3647, 3648, 3649, 3650, 3652, 3653, 3655, 3656, 3657, 3658, 3660, 3661, 3662, 3663, 3666, 3667, 3668, 3669, 3670, 3674, 3675, 3678, 3679, 3680, 3682, 3683, 3684, 3685, 3686, 3687, 3688, 3689, 3690, 3691, 3692, 3694, 3696, 3698, 3700, 3702, 3703, 3704, 3705, 3706, 3707, 3708, 3709, 3712, 3713, 3718, 3719, 3721, 3722, 3724, 3730, 3731, 3732, 3733, 3734, 3736, 3737, 3739, 3740, 3744, 3748, 3749, 3750, 3751, 3752, 3753, 3754, 3756, 3757, 3759, 3761, 3764, 3766, 3769, 3770, 3773, 3774, 3775, 3779, 3781, 3782, 3784, 3785, 3786, 3788, 3789, 3790, 3791, 3792, 3793, 3794, 3796, 3798, 3799, 3800, 3803, 3804, 3805, 3807, 3809, 3810, 3811, 3812, 3813, 3814, 3815, 3817, 3818, 3819, 3820, 3821, 3823, 3826, 3827, 3829, 3830, 3832, 3833, 3834, 3835, 3836, 3837, 3838, 3839, 3840, 3841, 3843, 3844, 3845, 3846, 3848, 3849, 3850, 3851, 3852, 3853, 3854, 3855, 3856, 3857, 3858, 3859, 3860, 3861, 3862, 3863, 3864, 3866, 3867, 3868, 3871, 3872, 3873, 3875, 3879, 3884, 3893, 3898, 3899, 3900, 3902, 3903, 3904, 3905, 3907, 3912, 3913, 3918, 3919, 3921, 3922, 3923, 3924, 3927, 3929, 3932, 3933, 3934, 3936, 3938, 3939, 3940, 3941, 3943, 3944, 3945, 3947, 3948, 3950, 3951, 3953, 3955, 3957, 3958, 3960, 3963, 3964, 3965, 3967, 3972, 3973, 3974, 3975, 3976, 3977, 3978, 3980, 3981, 3985, 3986, 3988, 3989, 3990, 3991, 3992, 3994, 3995, 3996, 3997, 3999, 4001, 4002, 4005, 4006, 4007, 4008, 4009, 4010, 4011, 4013, 4014, 4016, 4017, 4018, 4019, 4025, 4026, 4027, 4029, 4030, 4033, 4034, 4039, 4040, 4042, 4044, 4046, 4049, 4050, 4053, 4054, 4058, 4059, 4060, 4062, 4063, 4067, 4070, 4071, 4075, 4076, 4078, 4079, 4080, 4082, 4083, 4084, 4085, 4086, 4087, 4088, 4089, 4091, 4092, 4093, 4094, 4095, 4096, 4098, 4099, 4104, 4106, 4107, 4108, 4109, 4111, 4114, 4116, 4117, 4118, 4119, 4120, 4121, 4122, 4123, 4124, 4125, 4126, 4131, 4132, 4133, 4134, 4135, 4136, 4138, 4139, 4140, 4141, 4143, 4144, 4145, 4154, 4155, 4156, 4158, 4159, 4160, 4161, 4163, 4164, 4166, 4167, 4168, 4169, 4171, 4174, 4175, 4176, 4177, 4178, 4179, 4181, 4183, 4184, 4185, 4186, 4187, 4188, 4189, 4193, 4194, 4195, 4196, 4197, 4198, 4200, 4201, 4202, 4203, 4204, 4205, 4206, 4208, 4209, 4212, 4213, 4214, 4215, 4216, 4217, 4221, 4223, 4224, 4225, 4226, 4227, 4228, 4229, 4232, 4233, 4234, 4235, 4237, 4238, 4241, 4242, 4244, 4246, 4248, 4249, 4250, 4251, 4252, 4253, 4254, 4255, 4256, 4257, 4258, 4259, 4260, 4261, 4262, 4263, 4264, 4265, 4266, 4269, 4270, 4271, 4272, 4273, 4275, 4276, 4277, 4278, 4279, 4280, 4281, 4283, 4284, 4286, 4287, 4288, 4289, 4290, 4292, 4293, 4294, 4295, 4297, 4298, 4299, 4300, 4301, 4302, 4303, 4304, 4305, 4306, 4307, 4308, 4309, 4310, 4311, 4312, 4313, 4314, 4316, 4317, 4318, 4319, 4320, 4321, 4323, 4325, 4326, 4327, 4328, 4329, 4330, 4331, 4332, 4333, 4334, 4335, 4336, 4337, 4339, 4340, 4341, 4342, 4343, 4344, 4345, 4346, 4347, 4348, 4349, 4350, 4351, 4352, 4353, 4354, 4356, 4357, 4358, 4359, 4361, 4362, 4363, 4364, 4365, 4366, 4367, 4368, 4369, 4370, 4371, 4372, 4373, 4374, 4375, 4376, 4377, 4378, 4379, 4380, 4381, 4382, 4383, 4384, 4385, 4387, 4388, 4389, 4390, 4391, 4393, 4394, 4395, 4396, 4397, 4398, 4400, 4401, 4402, 4404, 4405, 4406, 4407, 4408, 4409, 4410, 4411, 4412, 4413, 4414, 4415, 4416, 4417, 4418, 4419, 4420, 4421, 4422, 4423, 4424, 4425, 4426, 4427, 4428, 4429, 4430, 4432, 4433, 4434, 4435, 4437, 4438, 4440, 4441, 4442, 4444, 4446, 4447, 4448, 4449, 4451, 4452, 4453, 4455, 4458, 4460, 4461, 4463, 4465, 4468, 4469, 4471, 4474, 4477, 4478, 4480, 4482, 4483, 4484, 4485, 4486, 4487, 4488, 4489, 4490, 4491, 4492, 4493, 4495, 4496, 4497, 4499, 4504, 4505, 4506, 4508, 4509, 4510, 4511, 4513, 4514, 4515, 4517, 4518, 4526, 4529, 4530, 4532, 4533, 4536, 4538, 4539, 4540, 4541, 4542, 4543, 4544, 4546, 4548, 4553, 4554, 4559, 4560, 4561, 4563, 4564, 4565, 4567, 4568, 4569, 4570, 4571, 4572, 4573, 4574, 4575, 4576, 4577, 4578, 4579, 4580, 4581, 4582, 4583, 4584, 4585, 4586, 4587, 4588, 4589, 4590, 4591, 4593, 4594, 4595, 4596, 4597, 4598, 4599, 4600, 4601, 4602, 4603, 4604, 4605, 4606, 4607, 4608, 4610, 4611, 4612, 4613, 4614, 4615, 4616, 4618, 4619, 4620, 4622, 4623, 4624, 4626, 4627, 4628, 4629, 4630, 4632, 4633, 4634, 4635, 4636, 4637, 4639, 4640, 4641, 4642, 4643, 4644, 4645, 4647, 4648, 4650, 4651, 4652, 4653, 4654, 4655, 4656, 4657, 4663, 4664, 4665, 4666, 4668, 4669, 4671, 4672, 4673, 4675, 4676, 4678, 4679, 4680, 4681, 4682, 4683, 4684, 4685, 4686, 4687, 4688, 4689, 4692, 4693, 4694, 4695, 4696, 4697, 4700, 4701, 4703, 4705, 4706, 4708, 4709, 4710, 4711, 4712, 4713, 4715, 4716, 4717, 4719, 4723, 4724, 4725, 4726, 4727, 4728, 4729, 4732, 4733, 4734, 4735, 4737, 4738, 4739, 4740, 4741, 4744, 4745, 4746, 4747, 4748, 4749, 4751, 4753, 4754, 4755, 4757, 4758, 4760, 4761, 4762, 4763, 4764, 4765, 4767, 4768, 4770, 4771, 4772, 4773, 4774, 4775, 4776, 4777, 4778, 4779, 4780, 4781, 4783, 4784, 4785, 4788, 4789, 4790, 4792, 4795, 4797, 4798, 4799, 4800, 4801, 4802, 4804, 4806, 4807, 4808, 4809, 4813, 4814, 4815, 4816, 4817, 4818, 4819, 4820, 4826, 4827, 4828, 4829, 4831, 4833, 4834, 4835, 4836, 4837, 4838, 4839, 4841, 4842, 4843, 4844, 4846, 4847, 4848, 4849, 4852, 4853, 4854, 4855, 4856, 4857, 4858, 4859, 4860, 4862, 4863, 4866, 4867, 4869, 4871, 4872, 4873, 4874, 4875, 4876, 4877, 4878, 4879, 4881, 4882, 4883, 4885, 4887, 4888, 4889, 4890, 4892, 4894, 4895, 4899, 4900, 4901, 4902, 4903, 4905, 4908, 4909, 4910, 4911, 4912, 4914, 4915, 4916, 4917, 4918, 4920, 4921, 4922, 4923, 4925, 4926, 4927, 4929, 4931, 4932, 4936, 4939, 4940, 4942, 4943, 4944, 4945, 4946, 4947, 4948, 4949, 4950, 4951, 4953, 4954, 4955, 4956, 4957, 4958, 4959, 4960, 4961, 4962, 4963, 4964, 4965, 4967, 4969, 4971, 4972, 4973, 4974, 4975, 4977, 4978, 4979, 4981, 4982, 4984, 4987, 4988, 4989, 4990, 4991, 4993, 4994, 4995, 4996, 4997, 4998, 4999, 5003, 5004, 5005, 5006, 5007, 5010, 5011, 5013, 5014, 5016, 5017, 5018, 5019, 5020, 5021, 5022, 5023, 5026, 5027, 5028, 5029, 5032, 5034, 5035, 5036, 5038, 5041, 5042, 5043, 5044, 5045, 5046, 5047, 5048, 5049, 5050, 5051, 5052, 5055, 5056, 5057, 5058, 5059, 5060, 5061, 5063, 5064, 5065, 5066, 5068, 5069, 5070, 5071, 5073, 5074, 5076, 5077, 5078, 5079, 5083, 5084, 5087, 5090, 5095, 5098, 5099, 5100, 5101, 5102, 5103, 5104, 5105, 5106, 5109, 5110, 5111, 5112, 5113, 5114, 5115, 5116, 5117, 5118, 5119, 5121, 5122, 5123, 5124, 5125, 5126, 5127, 5128, 5129, 5131, 5133, 5134, 5135, 5138, 5139, 5141, 5143, 5144, 5148, 5150, 5151, 5155, 5156, 5157, 5158, 5160, 5161, 5162, 5164, 5165, 5166, 5167, 5168, 5169, 5170, 5171, 5172, 5174, 5175, 5176, 5181, 5185, 5186, 5188, 5190, 5192, 5193, 5195, 5196, 5197, 5198, 5199, 5201, 5202, 5204, 5205, 5206, 5208, 5209, 5210, 5211, 5212, 5213, 5215, 5216, 5217, 5218, 5219, 5221, 5224, 5225, 5226, 5229, 5231, 5232, 5233, 5236, 5237, 5238, 5239, 5241, 5242, 5243, 5246, 5247, 5251, 5252, 5253, 5256, 5257, 5258, 5259, 5260, 5261, 5263, 5265, 5267, 5268, 5269, 5270, 5271, 5273, 5274, 5276, 5277, 5279, 5280, 5281, 5282, 5283, 5284, 5286, 5290, 5291, 5292, 5294, 5295, 5296, 5297, 5298, 5299, 5300, 5301, 5303, 5304, 5305, 5306, 5307, 5308, 5309, 5310, 5311, 5312, 5313, 5314, 5315, 5316, 5317, 5319, 5324, 5325, 5326, 5327, 5329, 5330, 5331, 5334, 5335, 5336, 5338, 5341, 5342, 5343, 5344, 5345, 5346, 5347, 5348, 5350, 5351, 5352, 5354, 5355, 5356, 5357, 5358, 5361, 5363, 5364, 5365, 5366, 5367, 5368, 5369, 5370, 5371, 5373, 5375, 5377, 5378, 5379, 5380, 5381, 5383, 5386, 5387, 5388, 5389, 5390, 5392, 5393, 5394, 5396, 5397, 5399, 5400, 5401, 5403, 5405, 5406, 5408, 5410, 5412, 5413, 5416, 5418, 5419, 5420, 5422, 5423, 5424, 5425, 5426, 5427, 5428, 5429, 5431, 5432, 5433, 5434, 5435, 5437, 5438, 5439, 5440, 5441, 5443, 5444, 5445, 5446, 5447, 5448, 5450, 5452, 5453, 5456, 5457, 5458, 5459, 5460, 5461, 5464, 5465, 5467, 5469, 5470, 5471, 5473, 5474, 5475, 5476, 5478, 5479, 5480, 5481, 5482, 5483, 5484, 5488, 5489, 5490, 5491, 5492, 5493, 5494, 5495, 5497, 5498, 5499, 5501, 5503, 5504, 5505, 5506, 5507, 5508, 5509, 5510, 5512, 5513, 5516, 5517, 5519, 5520, 5521, 5522, 5523, 5525, 5526, 5527, 5531, 5532, 5534, 5535, 5536, 5537, 5538, 5539, 5540, 5541, 5542, 5543, 5544, 5545, 5547, 5548, 5549, 5550, 5551, 5554, 5555, 5556, 5557, 5559, 5560, 5561, 5562, 5567, 5568, 5569, 5570, 5571, 5572, 5574, 5576, 5577, 5578, 5579, 5580, 5581, 5585, 5586, 5587, 5588, 5590, 5591, 5592, 5594, 5595, 5596, 5597, 5598, 5600, 5602, 5603, 5604, 5605, 5606, 5607, 5608, 5609, 5610, 5612, 5613, 5614, 5615, 5616, 5617, 5620, 5624, 5625, 5626, 5627, 5628, 5629, 5630, 5631, 5633, 5634, 5635, 5636, 5640, 5642, 5645, 5646, 5647, 5648, 5649, 5651, 5652, 5655, 5656, 5658, 5660, 5661, 5662, 5663, 5664, 5665, 5666, 5667, 5668, 5670, 5672, 5673, 5674, 5676, 5677, 5678, 5679, 5680, 5681, 5682, 5684, 5685, 5686, 5688, 5689, 5690, 5691, 5693, 5694, 5695, 5696, 5697, 5699, 5700, 5701, 5702, 5703, 5709, 5711, 5713, 5714, 5717, 5718, 5720, 5721, 5722, 5723, 5724, 5726, 5728, 5729, 5730, 5731, 5732, 5733, 5739, 5740, 5741, 5742, 5743, 5744, 5745, 5746, 5749, 5751, 5752, 5753, 5754, 5755, 5759, 5761, 5762, 5763, 5764, 5765, 5766, 5767, 5768, 5769, 5771, 5773, 5775, 5777, 5778, 5779, 5780, 5781, 5783, 5784, 5786, 5787, 5789, 5792, 5793, 5794, 5795, 5796, 5797, 5798, 5801, 5802, 5803, 5804, 5805, 5806, 5808, 5809, 5810, 5815, 5816, 5817, 5820, 5821, 5822, 5825, 5826, 5828, 5829, 5832, 5833, 5834, 5835, 5836, 5837, 5838, 5839, 5840, 5841, 5842, 5843, 5844, 5848, 5849, 5851, 5854, 5855, 5856, 5857, 5858, 5859, 5863, 5865, 5868, 5869, 5871, 5872, 5875, 5876, 5877, 5880, 5883, 5884, 5887, 5889, 5890, 5891, 5893, 5894, 5895, 5896, 5898, 5899, 5900, 5901, 5904, 5905, 5907, 5908, 5909, 5912, 5913, 5914, 5916, 5917, 5919, 5922, 5924, 5925, 5926, 5927, 5928, 5929, 5932, 5933, 5934, 5935, 5936, 5937, 5939, 5940, 5942, 5943, 5944, 5946, 5947, 5948, 5949, 5950, 5955, 5956, 5957, 5960, 5962, 5963, 5965, 5966, 5967, 5968, 5969, 5970, 5972, 5973, 5974, 5975, 5976, 5977, 5978, 5979, 5980, 5981, 5983, 5984, 5985, 5987, 5988, 5989, 5991, 5992, 5993, 5994, 5995, 5996, 5997, 5999, 6000, 6002, 6003, 6004, 6005, 6006, 6008, 6010, 6011, 6012, 6013, 6017, 6018, 6019, 6023, 6024, 6025, 6027, 6028, 6030, 6031, 6034, 6036, 6040, 6044, 6045, 6046, 6047, 6049, 6051, 6052, 6053, 6057, 6059, 6060, 6061, 6063, 6066, 6070, 6071, 6072, 6073, 6075, 6076, 6077, 6079, 6081, 6084, 6085, 6086, 6087, 6088, 6089, 6090, 6092, 6095, 6099, 6100, 6102, 6104, 6107, 6111, 6112, 6114, 6116, 6119, 6120, 6121, 6122, 6123, 6124, 6126, 6128, 6129, 6132, 6134, 6136, 6137, 6139, 6141, 6145, 6146, 6147, 6149, 6150, 6151, 6153, 6154, 6155, 6157, 6159, 6160, 6161, 6162, 6163, 6164, 6165, 6166, 6167, 6168, 6169, 6170, 6171, 6172, 6174, 6175, 6176, 6178, 6179, 6180, 6181, 6182, 6183, 6184, 6185, 6189, 6190, 6191, 6192, 6194, 6195, 6197, 6198, 6200, 6201, 6202, 6205, 6207, 6210, 6216, 6217, 6221, 6222, 6223, 6224, 6226, 6228, 6229, 6230, 6233, 6234, 6236, 6239, 6246, 6247, 6248, 6249, 6251, 6252, 6255, 6256, 6257, 6258, 6259, 6260, 6262, 6272, 6273, 6274, 6275, 6277, 6278, 6279, 6280, 6282, 6283, 6285, 6286, 6287, 6289, 6290, 6291, 6292, 6293, 6296, 6297, 6298, 6300, 6303, 6304, 6306, 6307, 6311, 6313, 6314, 6315, 6316, 6317, 6318, 6319, 6320, 6321, 6324, 6325, 6327, 6328, 6330, 6331, 6333, 6334, 6335, 6336, 6339, 6340, 6341, 6345, 6346, 6347, 6349, 6350, 6351, 6353, 6354, 6356, 6357, 6359, 6360, 6362, 6363, 6369, 6370, 6372, 6374, 6375, 6376, 6378, 6379, 6381, 6382, 6383, 6385, 6388, 6389, 6390, 6393, 6394, 6396, 6399, 6401, 6402, 6404, 6407, 6410, 6413, 6415, 6418, 6419, 6420, 6422, 6425, 6426, 6427, 6428, 6430, 6435, 6436, 6437, 6438, 6439, 6441, 6442, 6443, 6446, 6447, 6448, 6450, 6452, 6455, 6460, 6461, 6464, 6467, 6468, 6469, 6470, 6473, 6474, 6479, 6481, 6483, 6485, 6486, 6489, 6493, 6497, 6500, 6501, 6502, 6503, 6504, 6505, 6506, 6507, 6509, 6512, 6513, 6515, 6516, 6517, 6527, 6528, 6529, 6531, 6532, 6533, 6534, 6535, 6536, 6537, 6538, 6539, 6540, 6541, 6542, 6543, 6544, 6545, 6552, 6553, 6554, 6556, 6558, 6559, 6561, 6562, 6569, 6572, 6573, 6575, 6577, 6579, 6580, 6582, 6584, 6586, 6591, 6592, 6596, 6600, 6601, 6603, 6604, 6607, 6611, 6612, 6615, 6616, 6617, 6618, 6620, 6623, 6624, 6625, 6626, 6627, 6629, 6633, 6634, 6635, 6639, 6640, 6641, 6642, 6645, 6646, 6647, 6649, 6650, 6651, 6652, 6653, 6654, 6655, 6656, 6657, 6658, 6659, 6662, 6663, 6665, 6667, 6668, 6669, 6670, 6672, 6673, 6675, 6676, 6678, 6679, 6680, 6681, 6682, 6683, 6684, 6685, 6689, 6691, 6692, 6693, 6694, 6695, 6698, 6699, 6700, 6702, 6703, 6704, 6705, 6706, 6707, 6708, 6709, 6711, 6713, 6714, 6715, 6717, 6718, 6719, 6720, 6721, 6722, 6723, 6724, 6725, 6726, 6727, 6728, 6729, 6731, 6732, 6733, 6734, 6735, 6736, 6737, 6740, 6741, 6742, 6743, 6744, 6745, 6747, 6748, 6750, 6751, 6752, 6753, 6754, 6755, 6756, 6757, 6759, 6760, 6762, 6764, 6767, 6768, 6769, 6770, 6771, 6773, 6774, 6775, 6778, 6779, 6780, 6782, 6783, 6784, 6785, 6787, 6788, 6789, 6790, 6791, 6792, 6793}",4698
14,"(('batch', ('Request For Payment APPROVED by ADMINISTRATION', 'Request For Payment FINAL_APPROVED by SUPERVISOR')),)",1,55,"{989, 1078, 1085, 1088, 1089, 1090, 1092, 1093, 1094, 1095, 1096, 1097, 1098, 1099, 1100, 1101, 1103, 1104, 1105, 1106, 1107, 1108, 1109, 1112, 1114, 1115, 1116, 1117, 1118, 1120, 1121, 1122, 1123, 1124, 1125, 1126, 1127, 1128, 1129, 1130, 1131, 1134, 1135, 1136, 1137, 1138, 1140, 1142, 1145, 1147, 1148, 1149, 1150, 1151, 1152, 1153, 1155, 1156, 1158, 1160, 1161, 1162, 1163, 1165, 1167, 1169, 1170, 1171, 1172, 1176, 1177, 1179, 1180, 1181, 1182, 1183, 1184, 1185, 1186, 1187, 1188, 1190, 1196, 1197, 1198, 1199, 1200, 1201, 1203, 1204, 1205, 1207, 1208, 1209, 1210, 1213, 1214, 1215, 1216, 1218, 1219, 1221, 1222, 1223, 1225, 1228, 1229, 1230, 1231, 1233, 1234, 1237, 1238, 1239, 1240, 1241, 1242, 1244, 1246, 1247, 1250, 1254, 1255, 1263, 1265, 1268, 1272, 1273, 1274, 1275, 1276, 1277, 1280, 1281, 1282, 1284, 1285, 1287, 1290, 1291, 1294, 1300, 1301, 1302, 1304, 1305, 1307, 1308, 1309, 1310, 1311, 1313, 1314, 1315, 1318, 1320, 1321, 1323, 1324, 1325, 1327, 1328, 1329, 1330, 1331, 1332, 1334, 1335, 1336, 1338, 1342, 1345, 1346, 1347, 1349, 1353, 1357, 1360, 1365, 1367, 1368, 1369, 1370, 1373, 1374, 1377, 1378, 1379, 1380, 1382, 1385, 1386, 1387, 1388, 1389, 1390, 1391, 1392, 1393, 1395, 1396, 1397, 1400, 1401, 1402, 1404, 1405, 1406, 1409, 1410, 1413, 1414, 1415, 1420, 1421, 1423, 1424, 1429, 1430, 1431, 1432, 1434, 1435, 1439, 1440, 1441, 1442, 1443, 1446, 1448, 1450, 1452, 1453, 1454, 1455, 1456, 1457, 1458, 1459, 1460, 1461, 1462, 1464, 1467, 1468, 1469, 1470, 1471, 1472, 1473, 1476, 1477, 1478, 1483, 1484, 1485, 1487, 1489, 1491, 1493, 1495, 1496, 1499, 1501, 1502, 1503, 1504, 1505, 1507, 1508, 1509, 1510, 1511, 1512, 1513, 1514, 1515, 1516, 1518, 1520, 1521, 1522, 1523, 1524, 1526, 1528, 1530, 1531, 1532, 1533, 1536, 1538, 1540, 1542, 1543, 1544, 1545, 1546, 1549, 1551, 1552, 1553, 1554, 1556, 1558, 1560, 1562, 1563, 1565, 1566, 1567, 1568, 1569, 1573, 1574, 1578, 1579, 1580, 1581, 1582, 1583, 1584, 1587, 1588, 1589, 1591, 1592, 1593, 1594, 1595, 1596, 1597, 1598, 1601, 1602, 1604, 1605, 1606, 1607, 1610, 1612, 1614, 1619, 1620, 1621, 1622, 1624, 1625, 1627, 1628, 1629, 1630, 1633, 1637, 1639, 1640, 1642, 1643, 1644, 1645, 1646, 1647, 1648, 1655, 1658, 1661, 1662, 1663, 1665, 1666, 1667, 1669, 1670, 1671, 1674, 1678, 1681, 1682, 1683, 1687, 1691, 1693, 1694, 1699, 1700, 1701, 1702, 1704, 1706, 1707, 1708, 1709, 1710, 1712, 1713, 1714, 1715, 1716, 1717, 1718, 1726, 1727, 1728, 1730, 1731, 1732, 1736, 1737, 1739, 1743, 1744, 1745, 1746, 1748, 1752, 1753, 1754, 1756, 1757, 1758, 1760, 1761, 1764, 1769, 1771, 1772, 1773, 1774, 1775, 1776, 1778, 1779, 1780, 1786, 1790, 1796, 1799, 1801, 1802, 1803, 1804, 1805, 1808, 1810, 1811, 1812, 1814, 1817, 1818, 1819, 1821, 1822, 1825, 1827, 1828, 1829, 1830, 1831, 1834, 1835, 1836, 1837, 1840, 1841, 1842, 1843, 1847, 1848, 1849, 1850, 1859, 1863, 1865, 1867, 1869, 1870, 1871, 1874, 1875, 1878, 1880, 1881, 1883, 1885, 1886, 1888, 1892, 1893, 1895, 1896, 1897, 1898, 1900, 1901, 1902, 1903, 1905, 1907, 1909, 1910, 1911, 1912, 1915, 1918, 1919, 1920, 1921, 1922, 1923, 1924, 1928, 1929, 1931, 1934, 1937, 1940, 1941, 1944, 1945, 1946, 1947, 1948, 1951, 1955, 1956, 1957, 1958, 1960, 1962, 1964, 1965, 1967, 1968, 1969, 1971, 1972, 1976, 1978, 1979, 1981, 1983, 1986, 1987, 1992, 1993, 1994, 1996, 1997, 1999, 2000, 2001, 2002, 2004, 2005, 2006, 2007, 2010, 2011, 2017, 2019, 2020, 2023, 2024, 2025, 2026, 2031, 2032, 2033, 2034, 2039, 2040, 2041, 2043, 2044, 2047, 2049, 2050, 2051, 2052, 2053, 2056, 2063, 2064, 2065, 2071, 2073, 2074, 2075, 2077, 2079, 2080, 2082, 2083, 2084, 2085, 2087, 2091, 2094, 2100, 2103, 2109, 2111, 2113, 2114, 2115, 2116, 2117, 2119, 2121, 2122, 2124, 2125, 2126, 2128, 2129, 2130, 2131, 2133, 2134, 2135, 2137, 2138, 2141, 2143, 2144, 2148, 2150, 2151, 2154, 2155, 2157, 2158, 2159, 2164, 2166, 2167, 2168, 2169, 2172, 2173, 2174, 2175, 2176, 2177, 2178, 2180, 2181, 2182, 2183, 2186, 2188, 2189, 2191, 2194, 2195, 2196, 2197, 2200, 2201, 2202, 2203, 2204, 2205, 2209, 2210, 2211, 2213, 2214, 2216, 2218, 2219, 2222, 2223, 2226, 2230, 2232, 2234, 2235, 2237, 2239, 2241, 2242, 2244, 2246, 2247, 2248, 2251, 2252, 2253, 2254, 2255, 2259, 2260, 2261, 2262, 2263, 2264, 2265, 2268, 2269, 2272, 2277, 2280, 2284, 2285, 2287, 2288, 2289, 2291, 2292, 2293, 2294, 2295, 2296, 2297, 2299, 2302, 2303, 2304, 2305, 2306, 2310, 2313, 2315, 2320, 2321, 2324, 2327, 2328, 2329, 2331, 2336, 2337, 2338, 2341, 2342, 2345, 2346, 2348, 2349, 2350, 2351, 2352, 2353, 2354, 2357, 2358, 2359, 2360, 2363, 2364, 2365, 2366, 2370, 2373, 2374, 2375, 2377, 2380, 2383, 2385, 2386, 2387, 2388, 2389, 2390, 2391, 2392, 2393, 2396, 2397, 2398, 2401, 2403, 2404, 2405, 2407, 2408, 2409, 2410, 2411, 2412, 2416, 2420, 2421, 2422, 2423, 2425, 2426, 2427, 2428, 2429, 2430, 2437, 2440, 2443, 2448, 2450, 2452, 2453, 2454, 2455, 2459, 2460, 2466, 2470, 2471, 2472, 2473, 2475, 2476, 2477, 2478, 2480, 2481, 2482, 2484, 2485, 2486, 2487, 2488, 2489, 2490, 2491, 2492, 2494, 2495, 2496, 2497, 2501, 2503, 2504, 2508, 2510, 2511, 2515, 2516, 2517, 2518, 2519, 2520, 2522, 2523, 2524, 2525, 2526, 2527, 2528, 2529, 2530, 2531, 2535, 2540, 2543, 2544, 2551, 2552, 2553, 2554, 2557, 2559, 2561, 2562, 2564, 2569, 2570, 2574, 2579, 2580, 2584, 2586, 2591, 2592, 2593, 2595, 2596, 2597, 2599, 2603, 2604, 2606, 2607, 2608, 2614, 2615, 2616, 2620, 2622, 2623, 2624, 2625, 2627, 2628, 2629, 2633, 2635, 2636, 2637, 2640, 2643, 2648, 2650, 2652, 2653, 2656, 2660, 2662, 2666, 2667, 2669, 2672, 2673, 2677, 2679, 2680, 2681, 2683, 2685, 2686, 2687, 2688, 2690, 2692, 2693, 2694, 2696, 2697, 2698, 2699, 2700, 2701, 2703, 2704, 2705, 2707, 2708, 2710, 2712, 2713, 2717, 2718, 2720, 2724, 2725, 2727, 2732, 2733, 2734, 2735, 2736, 2738, 2739, 2740, 2745, 2746, 2747, 2748, 2753, 2754, 2755, 2756, 2757, 2758, 2759, 2760, 2763, 2765, 2768, 2770, 2771, 2772, 2773, 2774, 2777, 2779, 2782, 2783, 2784, 2787, 2789, 2790, 2792, 2793, 2794, 2795, 2800, 2802, 2804, 2808, 2811, 2813, 2817, 2819, 2820, 2821, 2828, 2830, 2831, 2832, 2833, 2835, 2836, 2837, 2838, 2841, 2842, 2843, 2845, 2846, 2847, 2850, 2851, 2855, 2856, 2857, 2858, 2859, 2860, 2861, 2862, 2863, 2865, 2866, 2867, 2868, 2869, 2870, 2872, 2873, 2877, 2878, 2883, 2887, 2888, 2891, 2897, 2898, 2899, 2900, 2901, 2904, 2908, 2909, 2910, 2911, 2912, 2914, 2916, 2917, 2918, 2921, 2923, 2924, 2926, 2930, 2931, 2932, 2934, 2938, 2941, 2942, 2943, 2944, 2945, 2946, 2947, 2949, 2950, 2952, 2953, 2959, 2962, 2963, 2965, 2967, 2969, 2970, 2971, 2974, 2975, 2976, 2977, 2979, 2980, 2982, 2983, 2984, 2985, 2986, 2987, 2989, 2991, 2992, 2993, 2995, 2997, 2998, 2999, 3001, 3004, 3005, 3006, 3008, 3010, 3012, 3015, 3016, 3018, 3020, 3022, 3023, 3024, 3025, 3026, 3027, 3028, 3029, 3030, 3031, 3034, 3036, 3038, 3039, 3040, 3042, 3043, 3046, 3047, 3048, 3049, 3050, 3052, 3053, 3057, 3058, 3059, 3060, 3061, 3062, 3063, 3066, 3067, 3070, 3071, 3072, 3073, 3075, 3076, 3077, 3079, 3080, 3081, 3082, 3084, 3086, 3087, 3088, 3089, 3091, 3093, 3094, 3097, 3098, 3100, 3101, 3103, 3104, 3107, 3108, 3109, 3111, 3112, 3113, 3114, 3115, 3116, 3119, 3121, 3122, 3123, 3124, 3125, 3126, 3128, 3131, 3132, 3134, 3135, 3136, 3137, 3142, 3144, 3146, 3147, 3151, 3152, 3155, 3156, 3157, 3159, 3160, 3163, 3164, 3165, 3166, 3170, 3171, 3172, 3174, 3175, 3176, 3178, 3179, 3180, 3181, 3182, 3184, 3187, 3188, 3192, 3195, 3196, 3197, 3198, 3199, 3200, 3202, 3205, 3206, 3210, 3212, 3213, 3215, 3216, 3217, 3218, 3219, 3224, 3226, 3227, 3228, 3231, 3232, 3234, 3236, 3240, 3241, 3242, 3243, 3244, 3247, 3248, 3249, 3252, 3253, 3254, 3255, 3256, 3260, 3262, 3263, 3265, 3269, 3271, 3273, 3276, 3277, 3279, 3283, 3284, 3285, 3287, 3288, 3289, 3291, 3292, 3293, 3294, 3295, 3296, 3298, 3300, 3302, 3304, 3305, 3306, 3307, 3318, 3319, 3320, 3323, 3325, 3326, 3328, 3330, 3331, 3335, 3338, 3341, 3343, 3345, 3346, 3349, 3350, 3351, 3355, 3357, 3358, 3359, 3363, 3364, 3366, 3368, 3369, 3370, 3371, 3372, 3373, 3375, 3377, 3378, 3380, 3381, 3382, 3383, 3387, 3390, 3391, 3393, 3394, 3396, 3397, 3398, 3399, 3400, 3402, 3403, 3404, 3405, 3406, 3407, 3410, 3411, 3413, 3414, 3416, 3417, 3418, 3422, 3423, 3426, 3428, 3429, 3435, 3437, 3438, 3439, 3440, 3442, 3444, 3446, 3447, 3449, 3452, 3453, 3454, 3456, 3459, 3460, 3462, 3463, 3465, 3466, 3467, 3468, 3469, 3470, 3471, 3474, 3476, 3480, 3481, 3482, 3483, 3485, 3487, 3490, 3493, 3494, 3495, 3497, 3498, 3499, 3502, 3503, 3504, 3505, 3506, 3507, 3509, 3514, 3515, 3516, 3520, 3522, 3523, 3525, 3526, 3527, 3529, 3531, 3532, 3536, 3538, 3541, 3542, 3544, 3546, 3547, 3548, 3549, 3550, 3551, 3552, 3553, 3556, 3557, 3563, 3564, 3565, 3566, 3568, 3569, 3576, 3577, 3578, 3580, 3581, 3582, 3583, 3584, 3586, 3589, 3591, 3592, 3593, 3594, 3595, 3596, 3598, 3599, 3600, 3601, 3602, 3604, 3605, 3608, 3610, 3611, 3612, 3613, 3614, 3615, 3620, 3621, 3622, 3625, 3627, 3629, 3632, 3633, 3635, 3640, 3642, 3644, 3645, 3646, 3650, 3651, 3652, 3653, 3658, 3660, 3664, 3665, 3667, 3669, 3672, 3674, 3676, 3677, 3680, 3681, 3682, 3683, 3684, 3686, 3688, 3689, 3692, 3694, 3696, 3697, 3699, 3707, 3708, 3710, 3711, 3712, 3713, 3716, 3717, 3718, 3721, 3722, 3728, 3729, 3731, 3733, 3735, 3737, 3740, 3743, 3744, 3749, 3751, 3752, 3753, 3754, 3757, 3758, 3759, 3760, 3762, 3765, 3767, 3768, 3770, 3773, 3775, 3776, 3778, 3779, 3782, 3783, 3785, 3787, 3788, 3791, 3792, 3793, 3795, 3796, 3798, 3800, 3802, 3803, 3805, 3806, 3807, 3808, 3809, 3810, 3811, 3812, 3814, 3815, 3817, 3822, 3826, 3828, 3834, 3835, 3836, 3839, 3840, 3841, 3845, 3846, 3847, 3848, 3849, 3850, 3851, 3852, 3853, 3854, 3855, 3859, 3860, 3861, 3862, 3863, 3864, 3866, 3867, 3869, 3871, 3872, 3874, 3877, 3878, 3879, 3880, 3884, 3886, 3887, 3888, 3889, 3890, 3891, 3892, 3893, 3898, 3900, 3901, 3902, 3904, 3905, 3906, 3908, 3912, 3913, 3915, 3917, 3918, 3919, 3921, 3922, 3924, 3926, 3928, 3929, 3930, 3932, 3933, 3934, 3937, 3941, 3943, 3944, 3945, 3946, 3949, 3951, 3952, 3954, 3955, 3956, 3959, 3963, 3964, 3966, 3972, 3974, 3979, 3980, 3981, 3982, 3983, 3984, 3987, 3988, 3989, 3992, 3993, 3995, 3999, 4001, 4003, 4010, 4011, 4012, 4013, 4014, 4016, 4017, 4018, 4020, 4021, 4022, 4023, 4024, 4025, 4028, 4032, 4033, 4037, 4038, 4039, 4040, 4041, 4042, 4043, 4044, 4045, 4053, 4056, 4057, 4058, 4059, 4060, 4067, 4068, 4069, 4070, 4071, 4072, 4073, 4074, 4075, 4077, 4078, 4081, 4083, 4084, 4085, 4086, 4088, 4090, 4091, 4092, 4093, 4094, 4095, 4097, 4098, 4099, 4104, 4106, 4107, 4108, 4109, 4111, 4112, 4113, 4114, 4115, 4118, 4120, 4121, 4124, 4127, 4128, 4129, 4130, 4132, 4133, 4134, 4135, 4136, 4137, 4139, 4142, 4144, 4145, 4147, 4148, 4149, 4150, 4151, 4152, 4153, 4156, 4157, 4160, 4164, 4165, 4168, 4170, 4171, 4172, 4173, 4174, 4175, 4176, 4177, 4178, 4179, 4181, 4182, 4185, 4186, 4187, 4189, 4190, 4192, 4193, 4195, 4198, 4201, 4202, 4203, 4204, 4205, 4207, 4209, 4210, 4211, 4213, 4217, 4218, 4219, 4221, 4222, 4225, 4227, 4229, 4230, 4231, 4232, 4234, 4235, 4237, 4239, 4240, 4243, 4245, 4247, 4248, 4251, 4252, 4254, 4255, 4257, 4259, 4260, 4261, 4264, 4265, 4266, 4267, 4269, 4271, 4272, 4276, 4281, 4283, 4284, 4287, 4288, 4292, 4294, 4295, 4298, 4300, 4301, 4302, 4303, 4305, 4306, 4307, 4310, 4311, 4312, 4313, 4322, 4323, 4326, 4328, 4329, 4332, 4334, 4337, 4339, 4340, 4341, 4343, 4344, 4346, 4347, 4348, 4350, 4351, 4353, 4354, 4356, 4357, 4359, 4361, 4362, 4365, 4366, 4367, 4369, 4373, 4374, 4376, 4378, 4380, 4383, 4384, 4385, 4387, 4389, 4390, 4391, 4393, 4394, 4395, 4396, 4397, 4400, 4402, 4403, 4404, 4405, 4406, 4408, 4410, 4412, 4414, 4415, 4416, 4418, 4419, 4421, 4423, 4424, 4428, 4429, 4434, 4436, 4437, 4439, 4442, 4443, 4444, 4446, 4448, 4449, 4450, 4451, 4452, 4453, 4455, 4456, 4457, 4458, 4459, 4465, 4466, 4467, 4473, 4474, 4477, 4479, 4480, 4481, 4482, 4483, 4484, 4485, 4486, 4487, 4488, 4489, 4490, 4491, 4495, 4496, 4498, 4499, 4500, 4501, 4502, 4503, 4504, 4505, 4506, 4507, 4511, 4512, 4513, 4514, 4515, 4516, 4517, 4519, 4520, 4521, 4522, 4523, 4525, 4526, 4528, 4529, 4530, 4531, 4532, 4533, 4534, 4535, 4537, 4538, 4539, 4541, 4542, 4545, 4546, 4547, 4548, 4549, 4551, 4552, 4555, 4556, 4557, 4558, 4559, 4560, 4561, 4562, 4566, 4567, 4568, 4569, 4570, 4575, 4577, 4579, 4581, 4583, 4584, 4588, 4593, 4595, 4598, 4599, 4600, 4601, 4604, 4605, 4611, 4612, 4615, 4622, 4623, 4624, 4625, 4628, 4630, 4635, 4636, 4637, 4639, 4640, 4641, 4642, 4645, 4646, 4647, 4648, 4651, 4652, 4654, 4657, 4658, 4659, 4660, 4661, 4663, 4664, 4666, 4668, 4670, 4671, 4672, 4674, 4675, 4676, 4678, 4679, 4680, 4681, 4685, 4686, 4687, 4688, 4689, 4690, 4691, 4693, 4695, 4696, 4697, 4698, 4699, 4700, 4701, 4703, 4704, 4705, 4706, 4707, 4708, 4709, 4710, 4711, 4712, 4713, 4715, 4716, 4717, 4718, 4719, 4720, 4722, 4724, 4727, 4728, 4729, 4730, 4731, 4736, 4739, 4740, 4742, 4743, 4744, 4745, 4746, 4747, 4748, 4749, 4750, 4751, 4752, 4753, 4755, 4757, 4761, 4762, 4764, 4765, 4767, 4773, 4774, 4777, 4779, 4781, 4784, 4785, 4788, 4790, 4791, 4792, 4793, 4794, 4795, 4796, 4797, 4798, 4799, 4800, 4802, 4805, 4807, 4808, 4809, 4810, 4811, 4814, 4815, 4821, 4823, 4827, 4828, 4829, 4832, 4833, 4834, 4835, 4836, 4837, 4842, 4843, 4844, 4845, 4846, 4848, 4849, 4850, 4851, 4854, 4855, 4856, 4857, 4859, 4860, 4861, 4862, 4863, 4868, 4869, 4871, 4872, 4873, 4874, 4876, 4877, 4879, 4880, 4882, 4885, 4888, 4889, 4891, 4892, 4893, 4894, 4898, 4901, 4903, 4904, 4905, 4906, 4907, 4908, 4909, 4910, 4911, 4912, 4914, 4915, 4919, 4920, 4921, 4923, 4926, 4927, 4929, 4930, 4931, 4935, 4937, 4940, 4942, 4948, 4949, 4950, 4951, 4954, 4955, 4958, 4959, 4962, 4963, 4964, 4968, 4969, 4970, 4971, 4972, 4973, 4974, 4975, 4980, 4981, 4982, 4983, 4984, 4987, 4995, 4998, 5000, 5002, 5003, 5004, 5005, 5006, 5007, 5009, 5011, 5012, 5014, 5015, 5017, 5018, 5019, 5020, 5021, 5023, 5024, 5025, 5027, 5029, 5032, 5033, 5036, 5037, 5038, 5039, 5040, 5041, 5042, 5043, 5044, 5045, 5047, 5051, 5052, 5055, 5056, 5057, 5058, 5059, 5060, 5063, 5066, 5067, 5068, 5070, 5072, 5075, 5076, 5077, 5080, 5081, 5082, 5083, 5084, 5085, 5086, 5087, 5090, 5091, 5092, 5093, 5095, 5096, 5097, 5105, 5107, 5108, 5109, 5110, 5114, 5115, 5117, 5118, 5119, 5120, 5121, 5122, 5123, 5124, 5125, 5126, 5127, 5128, 5129, 5130, 5132, 5133, 5134, 5135, 5136, 5137, 5140, 5141, 5142, 5143, 5145, 5147, 5149, 5150, 5155, 5157, 5158, 5160, 5161, 5162, 5163, 5164, 5166, 5167, 5169, 5170, 5171, 5174, 5176, 5178, 5182, 5183, 5185, 5187, 5190, 5191, 5194, 5195, 5196, 5197, 5198, 5199, 5201, 5202, 5203, 5205, 5209, 5210, 5211, 5212, 5214, 5215, 5217, 5220, 5221, 5224, 5225, 5226, 5229, 5230, 5231, 5232, 5236, 5237, 5238, 5239, 5242, 5243, 5246, 5248, 5253, 5257, 5258, 5259, 5260, 5262, 5263, 5264, 5265, 5267, 5268, 5269, 5270, 5273, 5274, 5275, 5278, 5279, 5281, 5283, 5284, 5287, 5288, 5291, 5292, 5296, 5297, 5300, 5301, 5302, 5303, 5304, 5305, 5307, 5308, 5312, 5314, 5315, 5316, 5319, 5320, 5321, 5323, 5327, 5328, 5329, 5330, 5333, 5334, 5336, 5337, 5339, 5340, 5342, 5343, 5344, 5345, 5346, 5347, 5353, 5354, 5357, 5361, 5362, 5364, 5365, 5368, 5369, 5370, 5371, 5372, 5373, 5375, 5376, 5377, 5378, 5379, 5380, 5383, 5384, 5385, 5387, 5388, 5389, 5390, 5391, 5392, 5394, 5397, 5399, 5402, 5403, 5404, 5406, 5407, 5408, 5409, 5411, 5412, 5413, 5414, 5416, 5418, 5419, 5420, 5422, 5423, 5425, 5426, 5427, 5428, 5429, 5430, 5437, 5438, 5440, 5441, 5442, 5443, 5444, 5445, 5446, 5447, 5448, 5449, 5450, 5452, 5453, 5454, 5457, 5458, 5459, 5460, 5461, 5462, 5463, 5464, 5466, 5468, 5469, 5471, 5474, 5476, 5477, 5480, 5481, 5482, 5483, 5484, 5485, 5486, 5487, 5489, 5490, 5491, 5493, 5496, 5501, 5502, 5504, 5505, 5506, 5511, 5512, 5513, 5514, 5515, 5516, 5518, 5520, 5521, 5522, 5523, 5529, 5530, 5534, 5535, 5536, 5537, 5538, 5539, 5540, 5541, 5543, 5544, 5545, 5548, 5549, 5551, 5557, 5558, 5561, 5562, 5571, 5573, 5575, 5576, 5577, 5579, 5581, 5582, 5583, 5584, 5585, 5587, 5589, 5590, 5591, 5592, 5593, 5594, 5595, 5598, 5600, 5601, 5602, 5603, 5606, 5607, 5608, 5609, 5610, 5614, 5615, 5617, 5618, 5622, 5628, 5630, 5631, 5637, 5639, 5640, 5642, 5645, 5647, 5648, 5650, 5651, 5652, 5653, 5654, 5655, 5656, 5657, 5659, 5660, 5662, 5663, 5664, 5665, 5666, 5667, 5668, 5669, 5670, 5671, 5672, 5673, 5677, 5678, 5679, 5680, 5681, 5683, 5686, 5689, 5690, 5691, 5692, 5693, 5694, 5696, 5698, 5699, 5700, 5701, 5703, 5705, 5707, 5709, 5712, 5714, 5716, 5720, 5721, 5722, 5723, 5724, 5726, 5728, 5729, 5730, 5736, 5737, 5739, 5741, 5742, 5743, 5744, 5745, 5746, 5747, 5748, 5749, 5751, 5752, 5754, 5755, 5756, 5758, 5759, 5761, 5762, 5763, 5766, 5768, 5772, 5773, 5774, 5776, 5778, 5779, 5781, 5784, 5785, 5786, 5788, 5789, 5791, 5792, 5793, 5794, 5795, 5796, 5797, 5798, 5802, 5803, 5808, 5809, 5811, 5813, 5814, 5815, 5816, 5817, 5819, 5823, 5828, 5830, 5832, 5834, 5837, 5838, 5844, 5848, 5849, 5851, 5853, 5854, 5855, 5860, 5861, 5862, 5864, 5865, 5866, 5868, 5874, 5881, 5882, 5886, 5887, 5888, 5892, 5897, 5898, 5899, 5900, 5902, 5903, 5905, 5907, 5909, 5910, 5912, 5913, 5915, 5916, 5918, 5920, 5921, 5922, 5925, 5927, 5928, 5932, 5933, 5934, 5935, 5936, 5939, 5940, 5942, 5943, 5944, 5945, 5947, 5948, 5949, 5950, 5952, 5953, 5954, 5955, 5956, 5957, 5960, 5962, 5963, 5965, 5966, 5967, 5968, 5970, 5971, 5979, 5980, 5983, 5984, 5985, 5987, 5988, 5989, 5992, 5993, 5994, 5995, 5996, 5997, 5998, 6000, 6002, 6003, 6004, 6006, 6007, 6008, 6010, 6011, 6012, 6013, 6017, 6021, 6023, 6025, 6027, 6028, 6029, 6032, 6034, 6039, 6040, 6042, 6043, 6044, 6045, 6046, 6049, 6051, 6052, 6053, 6055, 6058, 6064, 6066, 6069, 6071, 6072, 6073, 6078, 6079, 6081, 6083, 6084, 6086, 6088, 6089, 6091, 6093, 6094, 6096, 6097, 6099, 6100, 6103, 6105, 6106, 6107, 6108, 6109, 6112, 6113, 6115, 6117, 6122, 6123, 6127, 6130, 6132, 6133, 6134, 6139, 6142, 6143, 6144, 6147, 6148, 6149, 6150, 6151, 6152, 6153, 6154, 6155, 6156, 6157, 6158, 6159, 6160, 6161, 6162, 6163, 6166, 6167, 6168, 6169, 6170, 6171, 6172, 6173, 6174, 6180, 6181, 6182, 6183, 6184, 6185, 6186, 6187, 6190, 6191, 6192, 6193, 6195, 6197, 6198, 6201, 6202, 6207, 6223, 6224, 6230, 6233, 6234, 6235, 6236, 6237, 6238, 6239, 6240, 6241, 6242, 6243, 6244, 6245, 6246, 6247, 6249, 6251, 6253, 6254, 6255, 6256, 6258, 6259, 6260, 6261, 6263, 6264, 6265, 6266, 6267, 6269, 6270, 6271, 6275, 6276, 6277, 6281, 6282, 6283, 6284, 6285, 6287, 6288, 6290, 6291, 6293, 6294, 6297, 6300, 6301, 6303, 6304, 6305, 6306, 6307, 6308, 6309, 6310, 6313, 6315, 6318, 6320, 6321, 6322, 6323, 6324, 6326, 6327, 6329, 6330, 6331, 6332, 6333, 6335, 6339, 6341, 6342, 6344, 6345, 6346, 6347, 6348, 6349, 6351, 6352, 6354, 6355, 6356, 6357, 6359, 6361, 6364, 6369, 6370, 6371, 6372, 6375, 6376, 6377, 6386, 6388, 6393, 6394, 6399, 6401, 6404, 6405, 6407, 6408, 6410, 6411, 6412, 6413, 6414, 6415, 6416, 6417, 6418, 6422, 6423, 6424, 6426, 6428, 6430, 6431, 6433, 6434, 6436, 6438, 6440, 6441, 6443, 6444, 6445, 6447, 6449, 6452, 6454, 6458, 6460, 6461, 6462, 6463, 6464, 6467, 6470, 6471, 6472, 6473, 6474, 6475, 6477, 6478, 6479, 6483, 6484, 6485, 6486, 6487, 6488, 6491, 6492, 6494, 6495, 6496, 6498, 6499, 6502, 6504, 6506, 6507, 6508, 6509, 6510, 6514, 6516, 6517, 6526, 6527, 6528, 6529, 6531, 6532, 6533, 6534, 6535, 6543, 6545, 6547, 6548, 6552, 6553, 6557, 6559, 6560, 6561, 6566, 6571, 6572, 6577, 6578, 6579, 6580, 6581, 6582, 6583, 6585, 6586, 6587, 6589, 6590, 6593, 6598, 6602, 6604, 6605, 6609, 6611, 6613, 6614, 6618, 6619, 6621, 6622, 6626, 6627, 6628, 6629, 6632, 6633, 6635, 6637, 6643, 6644, 6645, 6647, 6648, 6649, 6651, 6652, 6653, 6654, 6655, 6656, 6657, 6659, 6660, 6661, 6663, 6664, 6666, 6669, 6671, 6672, 6677, 6680, 6681, 6682, 6686, 6687, 6688, 6689, 6690, 6693, 6694, 6696, 6697, 6698, 6699, 6701, 6702, 6703, 6704, 6705, 6707, 6708, 6710, 6713, 6714, 6715, 6717, 6718, 6719, 6724, 6725, 6728, 6733, 6738, 6739, 6740, 6741, 6742, 6743, 6745, 6748, 6750, 6751, 6753, 6755, 6756, 6759, 6760, 6764, 6765, 6766, 6767, 6769, 6770, 6773, 6775, 6776, 6777, 6778, 6779, 6780, 6781, 6783, 6784, 6785, 6788, 6789, 6790, 6791}",3310,"{6149, 6150, 6151, 5130, 6155, 5133, 6157, 5135, 6158, 5137, 6159, 6160, 6162, 5141, 5142, 6163, 6168, 5145, 6169, 6171, 5163, 5169, 5171, 5174, 3471, 5178, 5182, 5183, 5187, 6529, 5209, 5210, 5211, 5212, 2143, 5224, 2155, 5229, 5236, 2164, 5238, 5239, 2166, 2169, 2172, 5246, 2180, 5253, 2182, 5258, 6284, 5262, 5263, 5264, 5265, 6287, 5267, 6288, 6294, 6297, 6300, 6301, 5278, 6305, 6306, 2211, 6308, 6309, 6310, 1188, 2216, 2218, 2219, 1197, 2222, 1200, 1201, 2226, 1203, 1204, 1205, 2234, 1214, 6339, 6342, 6344, 6347, 6348, 3277, 1229, 1230, 6351, 6352, 6357, 1238, 1239, 1240, 6361, 1241, 6364, 4332, 6399, 5376, 5375, 5378, 5379, 5380, 5383, 5384, 5385, 6407, 5387, 6412, 5388, 5389, 5390, 5391, 5392, 6417, 5394, 6414, 6415, 5397, 6418, 5399, 6423, 6424, 6422, 6428, 6430, 6431, 6433, 6434, 6436, 6438, 2348, 6445, 6449, 6452, 6458, 5437, 5438, 6462, 6464, 6463, 5442, 5443, 6467, 5445, 3391, 6471, 5448, 5449, 6472, 3396, 3399, 4429, 3402, 3404, 3405, 3406, 6479, 4436, 5461, 5462, 5463, 6485, 5466, 5468, 5471, 5477, 5485, 5486, 5487, 6516, 6517, 3454, 4479, 6528, 4481, 4482, 4483, 4484, 4485, 4486, 4487, 4488, 4489, 4490, 6531, 3462, 6535, 3466, 4495, 4496, 3468, 4498, 4499, 4500, 4501, 4502, 4503, 6543, 2448, 2450, 6547, 2452, 2455, 3482, 2459, 3483, 6557, 6559, 6561, 3497, 6571, 6578, 6579, 6580, 6581, 5562, 4539, 4541, 4542, 4547, 4549, 2501, 4551, 4552, 1484, 1485, 1487, 5585, 1489, 2515, 2516, 1491, 2518, 1493, 1495, 2522, 2524, 2525, 2526, 1501, 2529, 5606, 1515, 1516, 1518, 1523, 1524, 6645, 6648, 6649, 1530, 6651, 6410, 6652, 6653, 6655, 6656, 6657, 1531, 6659, 1540, 1533, 1542, 1543, 6664, 1544, 6666, 1545, 1546, 6669, 1552, 6677, 1558, 1560, 5657, 5660, 1565, 1567, 5664, 5665, 5666, 1568, 6689, 6690, 1573, 1574, 6693, 6694, 6699, 6701, 5678, 6702, 1583, 5681, 1584, 5683, 1587, 5686, 1591, 1593, 1594, 5691, 5692, 5693, 5694, 1596, 1597, 1598, 5698, 5699, 5700, 1605, 5712, 3688, 5745, 5746, 5747, 5748, 4747, 2703, 5776, 2704, 2705, 2710, 5784, 2712, 2713, 4764, 2717, 2718, 4767, 5792, 5794, 5795, 5796, 4773, 4774, 2740, 2746, 2747, 2753, 2754, 2755, 2756, 4805, 2757, 2758, 2759, 3787, 3788, 3791, 2768, 3793, 2770, 3796, 3798, 3803, 3808, 3809, 3810, 1829, 1830, 4903, 1831, 1835, 1836, 3886, 3887, 3888, 3889, 3890, 3891, 3892, 1841, 1842, 1843, 5948, 5949, 3904, 3908, 5956, 5960, 3913, 2888, 3915, 5962, 3917, 3918, 2891, 2897, 5970, 2898, 2899, 2900, 2901, 5979, 5980, 5984, 5985, 4964, 5989, 5993, 4970, 5994, 4972, 4973, 4974, 4975, 5995, 6000, 6002, 6003, 4980, 6004, 4982, 1907, 4984, 6006, 1910, 6008, 1911, 6010, 1912, 1919, 1920, 1922, 1923, 5002, 5003, 5006, 5007, 5014, 5017, 5018, 5019, 2974, 2975, 5025, 2977, 5027, 2979, 2980, 2982, 2983, 5032, 2984, 5036, 5037, 5038, 5039, 1994, 2010, 2011, 4060, 5084, 4067, 4072, 4073, 4074, 2024, 2025, 4077, 4078, 3456, 2031, 2033, 2039, 6139}",473,"{989, 1078, 1085, 1088, 1089, 1090, 1092, 1093, 1094, 1095, 1096, 1097, 1098, 1099, 1100, 1101, 1103, 1104, 1105, 1106, 1107, 1108, 1109, 1112, 1114, 1115, 1116, 1117, 1118, 1120, 1121, 1122, 1123, 1124, 1125, 1126, 1127, 1128, 1129, 1130, 1131, 1134, 1135, 1136, 1137, 1138, 1140, 1142, 1145, 1147, 1148, 1149, 1150, 1151, 1152, 1153, 1155, 1156, 1158, 1160, 1161, 1162, 1163, 1165, 1167, 1169, 1170, 1171, 1172, 1176, 1177, 1179, 1180, 1181, 1182, 1183, 1184, 1185, 1186, 1187, 1190, 1196, 1198, 1199, 1207, 1208, 1209, 1210, 1213, 1215, 1216, 1218, 1219, 1221, 1222, 1223, 1225, 1228, 1231, 1233, 1234, 1237, 1242, 1244, 1246, 1247, 1250, 1254, 1255, 1263, 1265, 1268, 1272, 1273, 1274, 1275, 1276, 1277, 1280, 1281, 1282, 1284, 1285, 1287, 1290, 1291, 1294, 1300, 1301, 1302, 1304, 1305, 1307, 1308, 1309, 1310, 1311, 1313, 1314, 1315, 1318, 1320, 1321, 1323, 1324, 1325, 1327, 1328, 1329, 1330, 1331, 1332, 1334, 1335, 1336, 1338, 1342, 1345, 1346, 1347, 1349, 1353, 1357, 1360, 1365, 1367, 1368, 1369, 1370, 1373, 1374, 1377, 1378, 1379, 1380, 1382, 1385, 1386, 1387, 1388, 1389, 1390, 1391, 1392, 1393, 1395, 1396, 1397, 1400, 1401, 1402, 1404, 1405, 1406, 1409, 1410, 1413, 1414, 1415, 1420, 1421, 1423, 1424, 1429, 1430, 1431, 1432, 1434, 1435, 1439, 1440, 1441, 1442, 1443, 1446, 1448, 1450, 1452, 1453, 1454, 1455, 1456, 1457, 1458, 1459, 1460, 1461, 1462, 1464, 1467, 1468, 1469, 1470, 1471, 1472, 1473, 1476, 1477, 1478, 1483, 1496, 1499, 1502, 1503, 1504, 1505, 1507, 1508, 1509, 1510, 1511, 1512, 1513, 1514, 1520, 1521, 1522, 1526, 1528, 1532, 1536, 1538, 1549, 1551, 1553, 1554, 1556, 1562, 1563, 1566, 1569, 1578, 1579, 1580, 1581, 1582, 1588, 1589, 1592, 1595, 1601, 1602, 1604, 1606, 1607, 1610, 1612, 1614, 1619, 1620, 1621, 1622, 1624, 1625, 1627, 1628, 1629, 1630, 1633, 1637, 1639, 1640, 1642, 1643, 1644, 1645, 1646, 1647, 1648, 1655, 1658, 1661, 1662, 1663, 1665, 1666, 1667, 1669, 1670, 1671, 1674, 1678, 1681, 1682, 1683, 1687, 1691, 1693, 1694, 1699, 1700, 1701, 1702, 1704, 1706, 1707, 1708, 1709, 1710, 1712, 1713, 1714, 1715, 1716, 1717, 1718, 1726, 1727, 1728, 1730, 1731, 1732, 1736, 1737, 1739, 1743, 1744, 1745, 1746, 1748, 1752, 1753, 1754, 1756, 1757, 1758, 1760, 1761, 1764, 1769, 1771, 1772, 1773, 1774, 1775, 1776, 1778, 1779, 1780, 1786, 1790, 1796, 1799, 1801, 1802, 1803, 1804, 1805, 1808, 1810, 1811, 1812, 1814, 1817, 1818, 1819, 1821, 1822, 1825, 1827, 1828, 1834, 1837, 1840, 1847, 1848, 1849, 1850, 1859, 1863, 1865, 1867, 1869, 1870, 1871, 1874, 1875, 1878, 1880, 1881, 1883, 1885, 1886, 1888, 1892, 1893, 1895, 1896, 1897, 1898, 1900, 1901, 1902, 1903, 1905, 1909, 1915, 1918, 1921, 1924, 1928, 1929, 1931, 1934, 1937, 1940, 1941, 1944, 1945, 1946, 1947, 1948, 1951, 1955, 1956, 1957, 1958, 1960, 1962, 1964, 1965, 1967, 1968, 1969, 1971, 1972, 1976, 1978, 1979, 1981, 1983, 1986, 1987, 1992, 1993, 1996, 1997, 1999, 2000, 2001, 2002, 2004, 2005, 2006, 2007, 2017, 2019, 2020, 2023, 2026, 2032, 2034, 2040, 2041, 2043, 2044, 2047, 2049, 2050, 2051, 2052, 2053, 2056, 2063, 2064, 2065, 2071, 2073, 2074, 2075, 2077, 2079, 2080, 2082, 2083, 2084, 2085, 2087, 2091, 2094, 2100, 2103, 2109, 2111, 2113, 2114, 2115, 2116, 2117, 2119, 2121, 2122, 2124, 2125, 2126, 2128, 2129, 2130, 2131, 2133, 2134, 2135, 2137, 2138, 2141, 2144, 2148, 2150, 2151, 2154, 2157, 2158, 2159, 2167, 2168, 2173, 2174, 2175, 2176, 2177, 2178, 2181, 2183, 2186, 2188, 2189, 2191, 2194, 2195, 2196, 2197, 2200, 2201, 2202, 2203, 2204, 2205, 2209, 2210, 2213, 2214, 2223, 2230, 2232, 2235, 2237, 2239, 2241, 2242, 2244, 2246, 2247, 2248, 2251, 2252, 2253, 2254, 2255, 2259, 2260, 2261, 2262, 2263, 2264, 2265, 2268, 2269, 2272, 2277, 2280, 2284, 2285, 2287, 2288, 2289, 2291, 2292, 2293, 2294, 2295, 2296, 2297, 2299, 2302, 2303, 2304, 2305, 2306, 2310, 2313, 2315, 2320, 2321, 2324, 2327, 2328, 2329, 2331, 2336, 2337, 2338, 2341, 2342, 2345, 2346, 2349, 2350, 2351, 2352, 2353, 2354, 2357, 2358, 2359, 2360, 2363, 2364, 2365, 2366, 2370, 2373, 2374, 2375, 2377, 2380, 2383, 2385, 2386, 2387, 2388, 2389, 2390, 2391, 2392, 2393, 2396, 2397, 2398, 2401, 2403, 2404, 2405, 2407, 2408, 2409, 2410, 2411, 2412, 2416, 2420, 2421, 2422, 2423, 2425, 2426, 2427, 2428, 2429, 2430, 2437, 2440, 2443, 2453, 2454, 2460, 2466, 2470, 2471, 2472, 2473, 2475, 2476, 2477, 2478, 2480, 2481, 2482, 2484, 2485, 2486, 2487, 2488, 2489, 2490, 2491, 2492, 2494, 2495, 2496, 2497, 2503, 2504, 2508, 2510, 2511, 2517, 2519, 2520, 2523, 2527, 2528, 2530, 2531, 2535, 2540, 2543, 2544, 2551, 2552, 2553, 2554, 2557, 2559, 2561, 2562, 2564, 2569, 2570, 2574, 2579, 2580, 2584, 2586, 2591, 2592, 2593, 2595, 2596, 2597, 2599, 2603, 2604, 2606, 2607, 2608, 2614, 2615, 2616, 2620, 2622, 2623, 2624, 2625, 2627, 2628, 2629, 2633, 2635, 2636, 2637, 2640, 2643, 2648, 2650, 2652, 2653, 2656, 2660, 2662, 2666, 2667, 2669, 2672, 2673, 2677, 2679, 2680, 2681, 2683, 2685, 2686, 2687, 2688, 2690, 2692, 2693, 2694, 2696, 2697, 2698, 2699, 2700, 2701, 2707, 2708, 2720, 2724, 2725, 2727, 2732, 2733, 2734, 2735, 2736, 2738, 2739, 2745, 2748, 2760, 2763, 2765, 2771, 2772, 2773, 2774, 2777, 2779, 2782, 2783, 2784, 2787, 2789, 2790, 2792, 2793, 2794, 2795, 2800, 2802, 2804, 2808, 2811, 2813, 2817, 2819, 2820, 2821, 2828, 2830, 2831, 2832, 2833, 2835, 2836, 2837, 2838, 2841, 2842, 2843, 2845, 2846, 2847, 2850, 2851, 2855, 2856, 2857, 2858, 2859, 2860, 2861, 2862, 2863, 2865, 2866, 2867, 2868, 2869, 2870, 2872, 2873, 2877, 2878, 2883, 2887, 2904, 2908, 2909, 2910, 2911, 2912, 2914, 2916, 2917, 2918, 2921, 2923, 2924, 2926, 2930, 2931, 2932, 2934, 2938, 2941, 2942, 2943, 2944, 2945, 2946, 2947, 2949, 2950, 2952, 2953, 2959, 2962, 2963, 2965, 2967, 2969, 2970, 2971, 2976, 2985, 2986, 2987, 2989, 2991, 2992, 2993, 2995, 2997, 2998, 2999, 3001, 3004, 3005, 3006, 3008, 3010, 3012, 3015, 3016, 3018, 3020, 3022, 3023, 3024, 3025, 3026, 3027, 3028, 3029, 3030, 3031, 3034, 3036, 3038, 3039, 3040, 3042, 3043, 3046, 3047, 3048, 3049, 3050, 3052, 3053, 3057, 3058, 3059, 3060, 3061, 3062, 3063, 3066, 3067, 3070, 3071, 3072, 3073, 3075, 3076, 3077, 3079, 3080, 3081, 3082, 3084, 3086, 3087, 3088, 3089, 3091, 3093, 3094, 3097, 3098, 3100, 3101, 3103, 3104, 3107, 3108, 3109, 3111, 3112, 3113, 3114, 3115, 3116, 3119, 3121, 3122, 3123, 3124, 3125, 3126, 3128, 3131, 3132, 3134, 3135, 3136, 3137, 3142, 3144, 3146, 3147, 3151, 3152, 3155, 3156, 3157, 3159, 3160, 3163, 3164, 3165, 3166, 3170, 3171, 3172, 3174, 3175, 3176, 3178, 3179, 3180, 3181, 3182, 3184, 3187, 3188, 3192, 3195, 3196, 3197, 3198, 3199, 3200, 3202, 3205, 3206, 3210, 3212, 3213, 3215, 3216, 3217, 3218, 3219, 3224, 3226, 3227, 3228, 3231, 3232, 3234, 3236, 3240, 3241, 3242, 3243, 3244, 3247, 3248, 3249, 3252, 3253, 3254, 3255, 3256, 3260, 3262, 3263, 3265, 3269, 3271, 3273, 3276, 3279, 3283, 3284, 3285, 3287, 3288, 3289, 3291, 3292, 3293, 3294, 3295, 3296, 3298, 3300, 3302, 3304, 3305, 3306, 3307, 3318, 3319, 3320, 3323, 3325, 3326, 3328, 3330, 3331, 3335, 3338, 3341, 3343, 3345, 3346, 3349, 3350, 3351, 3355, 3357, 3358, 3359, 3363, 3364, 3366, 3368, 3369, 3370, 3371, 3372, 3373, 3375, 3377, 3378, 3380, 3381, 3382, 3383, 3387, 3390, 3393, 3394, 3397, 3398, 3400, 3403, 3407, 3410, 3411, 3413, 3414, 3416, 3417, 3418, 3422, 3423, 3426, 3428, 3429, 3435, 3437, 3438, 3439, 3440, 3442, 3444, 3446, 3447, 3449, 3452, 3453, 3459, 3460, 3463, 3465, 3467, 3469, 3470, 3474, 3476, 3480, 3481, 3485, 3487, 3490, 3493, 3494, 3495, 3498, 3499, 3502, 3503, 3504, 3505, 3506, 3507, 3509, 3514, 3515, 3516, 3520, 3522, 3523, 3525, 3526, 3527, 3529, 3531, 3532, 3536, 3538, 3541, 3542, 3544, 3546, 3547, 3548, 3549, 3550, 3551, 3552, 3553, 3556, 3557, 3563, 3564, 3565, 3566, 3568, 3569, 3576, 3577, 3578, 3580, 3581, 3582, 3583, 3584, 3586, 3589, 3591, 3592, 3593, 3594, 3595, 3596, 3598, 3599, 3600, 3601, 3602, 3604, 3605, 3608, 3610, 3611, 3612, 3613, 3614, 3615, 3620, 3621, 3622, 3625, 3627, 3629, 3632, 3633, 3635, 3640, 3642, 3644, 3645, 3646, 3650, 3651, 3652, 3653, 3658, 3660, 3664, 3665, 3667, 3669, 3672, 3674, 3676, 3677, 3680, 3681, 3682, 3683, 3684, 3686, 3689, 3692, 3694, 3696, 3697, 3699, 3707, 3708, 3710, 3711, 3712, 3713, 3716, 3717, 3718, 3721, 3722, 3728, 3729, 3731, 3733, 3735, 3737, 3740, 3743, 3744, 3749, 3751, 3752, 3753, 3754, 3757, 3758, 3759, 3760, 3762, 3765, 3767, 3768, 3770, 3773, 3775, 3776, 3778, 3779, 3782, 3783, 3785, 3792, 3795, 3800, 3802, 3805, 3806, 3807, 3811, 3812, 3814, 3815, 3817, 3822, 3826, 3828, 3834, 3835, 3836, 3839, 3840, 3841, 3845, 3846, 3847, 3848, 3849, 3850, 3851, 3852, 3853, 3854, 3855, 3859, 3860, 3861, 3862, 3863, 3864, 3866, 3867, 3869, 3871, 3872, 3874, 3877, 3878, 3879, 3880, 3884, 3893, 3898, 3900, 3901, 3902, 3905, 3906, 3912, 3919, 3921, 3922, 3924, 3926, 3928, 3929, 3930, 3932, 3933, 3934, 3937, 3941, 3943, 3944, 3945, 3946, 3949, 3951, 3952, 3954, 3955, 3956, 3959, 3963, 3964, 3966, 3972, 3974, 3979, 3980, 3981, 3982, 3983, 3984, 3987, 3988, 3989, 3992, 3993, 3995, 3999, 4001, 4003, 4010, 4011, 4012, 4013, 4014, 4016, 4017, 4018, 4020, 4021, 4022, 4023, 4024, 4025, 4028, 4032, 4033, 4037, 4038, 4039, 4040, 4041, 4042, 4043, 4044, 4045, 4053, 4056, 4057, 4058, 4059, 4068, 4069, 4070, 4071, 4075, 4081, 4083, 4084, 4085, 4086, 4088, 4090, 4091, 4092, 4093, 4094, 4095, 4097, 4098, 4099, 4104, 4106, 4107, 4108, 4109, 4111, 4112, 4113, 4114, 4115, 4118, 4120, 4121, 4124, 4127, 4128, 4129, 4130, 4132, 4133, 4134, 4135, 4136, 4137, 4139, 4142, 4144, 4145, 4147, 4148, 4149, 4150, 4151, 4152, 4153, 4156, 4157, 4160, 4164, 4165, 4168, 4170, 4171, 4172, 4173, 4174, 4175, 4176, 4177, 4178, 4179, 4181, 4182, 4185, 4186, 4187, 4189, 4190, 4192, 4193, 4195, 4198, 4201, 4202, 4203, 4204, 4205, 4207, 4209, 4210, 4211, 4213, 4217, 4218, 4219, 4221, 4222, 4225, 4227, 4229, 4230, 4231, 4232, 4234, 4235, 4237, 4239, 4240, 4243, 4245, 4247, 4248, 4251, 4252, 4254, 4255, 4257, 4259, 4260, 4261, 4264, 4265, 4266, 4267, 4269, 4271, 4272, 4276, 4281, 4283, 4284, 4287, 4288, 4292, 4294, 4295, 4298, 4300, 4301, 4302, 4303, 4305, 4306, 4307, 4310, 4311, 4312, 4313, 4322, 4323, 4326, 4328, 4329, 4334, 4337, 4339, 4340, 4341, 4343, 4344, 4346, 4347, 4348, 4350, 4351, 4353, 4354, 4356, 4357, 4359, 4361, 4362, 4365, 4366, 4367, 4369, 4373, 4374, 4376, 4378, 4380, 4383, 4384, 4385, 4387, 4389, 4390, 4391, 4393, 4394, 4395, 4396, 4397, 4400, 4402, 4403, 4404, 4405, 4406, 4408, 4410, 4412, 4414, 4415, 4416, 4418, 4419, 4421, 4423, 4424, 4428, 4434, 4437, 4439, 4442, 4443, 4444, 4446, 4448, 4449, 4450, 4451, 4452, 4453, 4455, 4456, 4457, 4458, 4459, 4465, 4466, 4467, 4473, 4474, 4477, 4480, 4491, 4504, 4505, 4506, 4507, 4511, 4512, 4513, 4514, 4515, 4516, 4517, 4519, 4520, 4521, 4522, 4523, 4525, 4526, 4528, 4529, 4530, 4531, 4532, 4533, 4534, 4535, 4537, 4538, 4545, 4546, 4548, 4555, 4556, 4557, 4558, 4559, 4560, 4561, 4562, 4566, 4567, 4568, 4569, 4570, 4575, 4577, 4579, 4581, 4583, 4584, 4588, 4593, 4595, 4598, 4599, 4600, 4601, 4604, 4605, 4611, 4612, 4615, 4622, 4623, 4624, 4625, 4628, 4630, 4635, 4636, 4637, 4639, 4640, 4641, 4642, 4645, 4646, 4647, 4648, 4651, 4652, 4654, 4657, 4658, 4659, 4660, 4661, 4663, 4664, 4666, 4668, 4670, 4671, 4672, 4674, 4675, 4676, 4678, 4679, 4680, 4681, 4685, 4686, 4687, 4688, 4689, 4690, 4691, 4693, 4695, 4696, 4697, 4698, 4699, 4700, 4701, 4703, 4704, 4705, 4706, 4707, 4708, 4709, 4710, 4711, 4712, 4713, 4715, 4716, 4717, 4718, 4719, 4720, 4722, 4724, 4727, 4728, 4729, 4730, 4731, 4736, 4739, 4740, 4742, 4743, 4744, 4745, 4746, 4748, 4749, 4750, 4751, 4752, 4753, 4755, 4757, 4761, 4762, 4765, 4777, 4779, 4781, 4784, 4785, 4788, 4790, 4791, 4792, 4793, 4794, 4795, 4796, 4797, 4798, 4799, 4800, 4802, 4807, 4808, 4809, 4810, 4811, 4814, 4815, 4821, 4823, 4827, 4828, 4829, 4832, 4833, 4834, 4835, 4836, 4837, 4842, 4843, 4844, 4845, 4846, 4848, 4849, 4850, 4851, 4854, 4855, 4856, 4857, 4859, 4860, 4861, 4862, 4863, 4868, 4869, 4871, 4872, 4873, 4874, 4876, 4877, 4879, 4880, 4882, 4885, 4888, 4889, 4891, 4892, 4893, 4894, 4898, 4901, 4904, 4905, 4906, 4907, 4908, 4909, 4910, 4911, 4912, 4914, 4915, 4919, 4920, 4921, 4923, 4926, 4927, 4929, 4930, 4931, 4935, 4937, 4940, 4942, 4948, 4949, 4950, 4951, 4954, 4955, 4958, 4959, 4962, 4963, 4968, 4969, 4971, 4981, 4983, 4987, 4995, 4998, 5000, 5004, 5005, 5009, 5011, 5012, 5015, 5020, 5021, 5023, 5024, 5029, 5033, 5040, 5041, 5042, 5043, 5044, 5045, 5047, 5051, 5052, 5055, 5056, 5057, 5058, 5059, 5060, 5063, 5066, 5067, 5068, 5070, 5072, 5075, 5076, 5077, 5080, 5081, 5082, 5083, 5085, 5086, 5087, 5090, 5091, 5092, 5093, 5095, 5096, 5097, 5105, 5107, 5108, 5109, 5110, 5114, 5115, 5117, 5118, 5119, 5120, 5121, 5122, 5123, 5124, 5125, 5126, 5127, 5128, 5129, 5132, 5134, 5136, 5140, 5143, 5147, 5149, 5150, 5155, 5157, 5158, 5160, 5161, 5162, 5164, 5166, 5167, 5170, 5176, 5185, 5190, 5191, 5194, 5195, 5196, 5197, 5198, 5199, 5201, 5202, 5203, 5205, 5214, 5215, 5217, 5220, 5221, 5225, 5226, 5230, 5231, 5232, 5237, 5242, 5243, 5248, 5257, 5259, 5260, 5268, 5269, 5270, 5273, 5274, 5275, 5279, 5281, 5283, 5284, 5287, 5288, 5291, 5292, 5296, 5297, 5300, 5301, 5302, 5303, 5304, 5305, 5307, 5308, 5312, 5314, 5315, 5316, 5319, 5320, 5321, 5323, 5327, 5328, 5329, 5330, 5333, 5334, 5336, 5337, 5339, 5340, 5342, 5343, 5344, 5345, 5346, 5347, 5353, 5354, 5357, 5361, 5362, 5364, 5365, 5368, 5369, 5370, 5371, 5372, 5373, 5377, 5402, 5403, 5404, 5406, 5407, 5408, 5409, 5411, 5412, 5413, 5414, 5416, 5418, 5419, 5420, 5422, 5423, 5425, 5426, 5427, 5428, 5429, 5430, 5440, 5441, 5444, 5446, 5447, 5450, 5452, 5453, 5454, 5457, 5458, 5459, 5460, 5464, 5469, 5474, 5476, 5480, 5481, 5482, 5483, 5484, 5489, 5490, 5491, 5493, 5496, 5501, 5502, 5504, 5505, 5506, 5511, 5512, 5513, 5514, 5515, 5516, 5518, 5520, 5521, 5522, 5523, 5529, 5530, 5534, 5535, 5536, 5537, 5538, 5539, 5540, 5541, 5543, 5544, 5545, 5548, 5549, 5551, 5557, 5558, 5561, 5571, 5573, 5575, 5576, 5577, 5579, 5581, 5582, 5583, 5584, 5587, 5589, 5590, 5591, 5592, 5593, 5594, 5595, 5598, 5600, 5601, 5602, 5603, 5607, 5608, 5609, 5610, 5614, 5615, 5617, 5618, 5622, 5628, 5630, 5631, 5637, 5639, 5640, 5642, 5645, 5647, 5648, 5650, 5651, 5652, 5653, 5654, 5655, 5656, 5659, 5662, 5663, 5667, 5668, 5669, 5670, 5671, 5672, 5673, 5677, 5679, 5680, 5689, 5690, 5696, 5701, 5703, 5705, 5707, 5709, 5714, 5716, 5720, 5721, 5722, 5723, 5724, 5726, 5728, 5729, 5730, 5736, 5737, 5739, 5741, 5742, 5743, 5744, 5749, 5751, 5752, 5754, 5755, 5756, 5758, 5759, 5761, 5762, 5763, 5766, 5768, 5772, 5773, 5774, 5778, 5779, 5781, 5785, 5786, 5788, 5789, 5791, 5793, 5797, 5798, 5802, 5803, 5808, 5809, 5811, 5813, 5814, 5815, 5816, 5817, 5819, 5823, 5828, 5830, 5832, 5834, 5837, 5838, 5844, 5848, 5849, 5851, 5853, 5854, 5855, 5860, 5861, 5862, 5864, 5865, 5866, 5868, 5874, 5881, 5882, 5886, 5887, 5888, 5892, 5897, 5898, 5899, 5900, 5902, 5903, 5905, 5907, 5909, 5910, 5912, 5913, 5915, 5916, 5918, 5920, 5921, 5922, 5925, 5927, 5928, 5932, 5933, 5934, 5935, 5936, 5939, 5940, 5942, 5943, 5944, 5945, 5947, 5950, 5952, 5953, 5954, 5955, 5957, 5963, 5965, 5966, 5967, 5968, 5971, 5983, 5987, 5988, 5992, 5996, 5997, 5998, 6007, 6011, 6012, 6013, 6017, 6021, 6023, 6025, 6027, 6028, 6029, 6032, 6034, 6039, 6040, 6042, 6043, 6044, 6045, 6046, 6049, 6051, 6052, 6053, 6055, 6058, 6064, 6066, 6069, 6071, 6072, 6073, 6078, 6079, 6081, 6083, 6084, 6086, 6088, 6089, 6091, 6093, 6094, 6096, 6097, 6099, 6100, 6103, 6105, 6106, 6107, 6108, 6109, 6112, 6113, 6115, 6117, 6122, 6123, 6127, 6130, 6132, 6133, 6134, 6142, 6143, 6144, 6147, 6148, 6152, 6153, 6154, 6156, 6161, 6166, 6167, 6170, 6172, 6173, 6174, 6180, 6181, 6182, 6183, 6184, 6185, 6186, 6187, 6190, 6191, 6192, 6193, 6195, 6197, 6198, 6201, 6202, 6207, 6223, 6224, 6230, 6233, 6234, 6235, 6236, 6237, 6238, 6239, 6240, 6241, 6242, 6243, 6244, 6245, 6246, 6247, 6249, 6251, 6253, 6254, 6255, 6256, 6258, 6259, 6260, 6261, 6263, 6264, 6265, 6266, 6267, 6269, 6270, 6271, 6275, 6276, 6277, 6281, 6282, 6283, 6285, 6290, 6291, 6293, 6303, 6304, 6307, 6313, 6315, 6318, 6320, 6321, 6322, 6323, 6324, 6326, 6327, 6329, 6330, 6331, 6332, 6333, 6335, 6341, 6345, 6346, 6349, 6354, 6355, 6356, 6359, 6369, 6370, 6371, 6372, 6375, 6376, 6377, 6386, 6388, 6393, 6394, 6401, 6404, 6405, 6408, 6411, 6413, 6416, 6426, 6440, 6441, 6443, 6444, 6447, 6454, 6460, 6461, 6470, 6473, 6474, 6475, 6477, 6478, 6483, 6484, 6486, 6487, 6488, 6491, 6492, 6494, 6495, 6496, 6498, 6499, 6502, 6504, 6506, 6507, 6508, 6509, 6510, 6514, 6526, 6527, 6532, 6533, 6534, 6545, 6548, 6552, 6553, 6560, 6566, 6572, 6577, 6582, 6583, 6585, 6586, 6587, 6589, 6590, 6593, 6598, 6602, 6604, 6605, 6609, 6611, 6613, 6614, 6618, 6619, 6621, 6622, 6626, 6627, 6628, 6629, 6632, 6633, 6635, 6637, 6643, 6644, 6647, 6654, 6660, 6661, 6663, 6671, 6672, 6680, 6681, 6682, 6686, 6687, 6688, 6696, 6697, 6698, 6703, 6704, 6705, 6707, 6708, 6710, 6713, 6714, 6715, 6717, 6718, 6719, 6724, 6725, 6728, 6733, 6738, 6739, 6740, 6741, 6742, 6743, 6745, 6748, 6750, 6751, 6753, 6755, 6756, 6759, 6760, 6764, 6765, 6766, 6767, 6769, 6770, 6773, 6775, 6776, 6777, 6778, 6779, 6780, 6781, 6783, 6784, 6785, 6788, 6789, 6790, 6791}",2837
15,"(('batch', ('Request Payment', 'Payment Handled')),)",1,66,"{0, 1, 2, 3, 4, 5, 6, 7, 8, 9, 10, 11, 12, 13, 14, 15, 16, 17, 18, 20, 21, 22, 23, 24, 25, 27, 28, 29, 30, 31, 32, 33, 34, 35, 36, 37, 38, 39, 42, 43, 44, 45, 46, 47, 48, 49, 50, 51, 52, 53, 54, 55, 56, 57, 58, 59, 60, 61, 62, 64, 65, 66, 67, 68, 69, 70, 71, 72, 73, 74, 75, 78, 79, 80, 81, 83, 84, 85, 86, 88, 89, 90, 91, 92, 93, 94, 95, 96, 97, 98, 99, 100, 101, 102, 103, 104, 105, 106, 107, 108, 109, 110, 111, 112, 113, 114, 115, 116, 117, 118, 123, 124, 125, 126, 127, 128, 129, 130, 131, 132, 133, 134, 135, 136, 137, 138, 139, 140, 141, 143, 144, 145, 146, 147, 148, 149, 150, 151, 153, 154, 155, 156, 158, 159, 160, 161, 162, 163, 164, 165, 166, 167, 168, 169, 171, 172, 175, 176, 179, 180, 181, 182, 183, 184, 185, 186, 187, 188, 189, 190, 191, 192, 193, 194, 195, 196, 198, 199, 200, 201, 202, 203, 204, 205, 206, 207, 208, 209, 210, 211, 212, 213, 214, 215, 216, 217, 218, 219, 220, 221, 222, 223, 224, 225, 226, 227, 228, 229, 230, 231, 232, 234, 235, 236, 237, 238, 239, 240, 241, 242, 243, 244, 245, 246, 247, 248, 249, 250, 251, 252, 253, 254, 256, 257, 258, 259, 260, 261, 262, 263, 264, 265, 266, 267, 268, 269, 271, 272, 273, 274, 275, 276, 277, 278, 279, 280, 281, 282, 283, 284, 285, 286, 287, 288, 289, 290, 291, 292, 293, 294, 295, 296, 297, 298, 300, 301, 302, 303, 305, 307, 310, 311, 312, 313, 314, 315, 316, 317, 318, 321, 322, 323, 324, 325, 326, 327, 331, 332, 333, 334, 335, 336, 337, 338, 339, 340, 341, 342, 343, 344, 345, 346, 348, 349, 350, 351, 352, 353, 356, 357, 358, 359, 360, 361, 362, 363, 364, 365, 366, 367, 368, 369, 370, 372, 373, 375, 376, 377, 378, 379, 380, 382, 383, 384, 385, 386, 387, 388, 389, 390, 391, 392, 393, 394, 395, 396, 397, 398, 399, 400, 401, 402, 403, 404, 405, 406, 407, 408, 409, 410, 411, 414, 415, 416, 417, 418, 419, 420, 421, 422, 423, 424, 425, 426, 427, 428, 429, 430, 431, 433, 434, 435, 436, 437, 438, 439, 440, 441, 443, 444, 445, 446, 447, 449, 450, 451, 452, 453, 454, 456, 457, 458, 459, 460, 461, 462, 463, 464, 465, 466, 467, 468, 469, 470, 471, 472, 473, 474, 475, 476, 477, 478, 479, 481, 482, 483, 484, 486, 487, 488, 489, 490, 491, 492, 493, 494, 495, 496, 497, 498, 499, 500, 501, 502, 503, 504, 505, 506, 507, 508, 509, 510, 511, 512, 513, 514, 515, 516, 518, 519, 520, 521, 522, 523, 524, 525, 526, 527, 528, 530, 531, 532, 533, 534, 535, 536, 537, 538, 539, 540, 541, 542, 543, 544, 545, 546, 547, 548, 549, 550, 551, 552, 553, 554, 555, 556, 557, 558, 559, 560, 561, 562, 563, 564, 565, 566, 567, 568, 569, 570, 571, 572, 573, 574, 575, 576, 577, 578, 580, 582, 583, 584, 585, 586, 590, 591, 592, 593, 594, 596, 597, 598, 599, 600, 601, 602, 603, 604, 605, 606, 607, 608, 609, 610, 611, 612, 613, 614, 616, 617, 618, 620, 621, 622, 623, 624, 625, 626, 627, 628, 629, 631, 632, 633, 634, 635, 636, 637, 638, 639, 640, 641, 642, 643, 644, 645, 646, 647, 648, 649, 650, 651, 652, 653, 654, 655, 656, 657, 658, 659, 660, 661, 662, 663, 664, 665, 666, 667, 668, 669, 670, 671, 672, 673, 674, 675, 676, 677, 678, 679, 680, 681, 682, 683, 684, 685, 686, 687, 688, 689, 690, 693, 695, 696, 697, 698, 699, 700, 701, 702, 703, 704, 705, 706, 707, 708, 709, 710, 711, 712, 713, 714, 715, 716, 717, 718, 719, 720, 721, 722, 723, 724, 725, 726, 727, 728, 729, 730, 731, 732, 733, 734, 735, 736, 737, 738, 739, 740, 741, 742, 743, 744, 745, 746, 748, 749, 750, 751, 752, 753, 754, 755, 756, 757, 758, 759, 760, 761, 762, 763, 764, 765, 766, 767, 768, 769, 770, 771, 773, 774, 775, 776, 777, 778, 779, 780, 781, 782, 783, 784, 785, 786, 787, 788, 789, 790, 791, 792, 794, 795, 796, 797, 798, 799, 800, 801, 802, 803, 804, 805, 806, 807, 808, 809, 810, 811, 812, 813, 814, 815, 816, 817, 819, 820, 821, 824, 825, 826, 828, 829, 830, 831, 832, 833, 834, 835, 836, 837, 838, 839, 840, 841, 842, 843, 844, 845, 846, 847, 848, 849, 850, 851, 852, 854, 855, 856, 857, 858, 859, 860, 861, 862, 864, 865, 866, 867, 868, 869, 870, 871, 872, 873, 874, 875, 876, 877, 878, 879, 880, 881, 882, 883, 884, 885, 886, 887, 888, 889, 890, 891, 892, 893, 894, 895, 896, 897, 898, 899, 900, 901, 902, 903, 904, 905, 906, 907, 908, 909, 910, 911, 912, 913, 914, 915, 916, 917, 918, 919, 920, 921, 922, 923, 924, 925, 926, 927, 928, 929, 930, 931, 932, 933, 935, 936, 937, 939, 940, 941, 942, 943, 944, 945, 946, 947, 948, 949, 950, 951, 952, 953, 954, 955, 956, 957, 958, 959, 960, 961, 962, 963, 964, 965, 966, 967, 968, 969, 970, 971, 972, 973, 974, 975, 976, 977, 978, 979, 980, 981, 982, 983, 984, 985, 986, 987, 988, 989, 990, 991, 992, 993, 994, 996, 997, 998, 999, 1000, 1001, 1002, 1003, 1004, 1005, 1006, 1007, 1008, 1009, 1010, 1011, 1012, 1013, 1014, 1015, 1016, 1017, 1018, 1019, 1020, 1021, 1022, 1023, 1024, 1025, 1026, 1028, 1029, 1030, 1031, 1032, 1033, 1034, 1036, 1037, 1038, 1039, 1040, 1041, 1042, 1043, 1044, 1045, 1046, 1047, 1048, 1050, 1051, 1052, 1053, 1054, 1055, 1056, 1057, 1058, 1059, 1060, 1061, 1063, 1064, 1065, 1066, 1067, 1069, 1070, 1071, 1072, 1073, 1074, 1075, 1076, 1077, 1078, 1079, 1080, 1081, 1082, 1083, 1085, 1086, 1087, 1088, 1089, 1090, 1092, 1093, 1094, 1095, 1096, 1097, 1098, 1099, 1100, 1101, 1103, 1104, 1105, 1106, 1107, 1108, 1109, 1110, 1111, 1112, 1113, 1114, 1115, 1116, 1117, 1118, 1119, 1120, 1121, 1122, 1123, 1124, 1125, 1126, 1127, 1128, 1129, 1130, 1131, 1132, 1133, 1134, 1135, 1136, 1137, 1138, 1139, 1140, 1141, 1142, 1143, 1144, 1145, 1146, 1147, 1148, 1149, 1150, 1151, 1152, 1153, 1154, 1155, 1156, 1157, 1158, 1159, 1160, 1161, 1162, 1163, 1164, 1165, 1166, 1167, 1168, 1169, 1170, 1171, 1172, 1173, 1174, 1175, 1176, 1177, 1178, 1179, 1180, 1181, 1182, 1183, 1184, 1185, 1186, 1187, 1188, 1189, 1190, 1191, 1192, 1193, 1194, 1195, 1196, 1197, 1198, 1199, 1200, 1201, 1202, 1203, 1204, 1205, 1206, 1207, 1208, 1209, 1210, 1211, 1212, 1213, 1214, 1215, 1216, 1217, 1218, 1219, 1220, 1221, 1222, 1223, 1224, 1225, 1226, 1227, 1228, 1229, 1230, 1231, 1232, 1233, 1234, 1235, 1236, 1237, 1238, 1239, 1240, 1241, 1242, 1243, 1244, 1245, 1246, 1247, 1248, 1249, 1250, 1251, 1252, 1253, 1254, 1255, 1258, 1259, 1260, 1262, 1263, 1264, 1265, 1267, 1268, 1269, 1270, 1271, 1272, 1273, 1274, 1275, 1276, 1277, 1278, 1279, 1280, 1281, 1282, 1283, 1284, 1285, 1286, 1287, 1288, 1289, 1290, 1291, 1292, 1293, 1294, 1295, 1297, 1298, 1299, 1300, 1301, 1302, 1303, 1304, 1305, 1306, 1307, 1308, 1309, 1310, 1311, 1313, 1314, 1315, 1316, 1317, 1318, 1320, 1321, 1323, 1324, 1325, 1326, 1327, 1328, 1329, 1330, 1331, 1332, 1333, 1334, 1335, 1336, 1337, 1338, 1339, 1340, 1342, 1343, 1344, 1345, 1346, 1347, 1348, 1349, 1350, 1351, 1352, 1353, 1354, 1355, 1356, 1357, 1358, 1359, 1360, 1361, 1362, 1363, 1364, 1365, 1366, 1367, 1368, 1369, 1370, 1371, 1372, 1373, 1374, 1375, 1376, 1377, 1378, 1379, 1380, 1381, 1382, 1383, 1384, 1385, 1386, 1387, 1388, 1389, 1390, 1391, 1392, 1393, 1394, 1395, 1396, 1397, 1399, 1400, 1401, 1402, 1403, 1404, 1405, 1406, 1407, 1408, 1409, 1410, 1411, 1412, 1413, 1414, 1415, 1416, 1418, 1419, 1420, 1421, 1422, 1423, 1424, 1426, 1427, 1428, 1429, 1430, 1431, 1432, 1433, 1434, 1435, 1436, 1437, 1439, 1440, 1441, 1442, 1443, 1445, 1446, 1447, 1448, 1449, 1450, 1451, 1452, 1453, 1454, 1455, 1456, 1457, 1458, 1459, 1460, 1461, 1462, 1464, 1465, 1466, 1467, 1468, 1469, 1470, 1471, 1472, 1473, 1474, 1475, 1476, 1477, 1478, 1479, 1481, 1482, 1483, 1484, 1485, 1487, 1488, 1489, 1490, 1491, 1492, 1493, 1494, 1495, 1496, 1499, 1500, 1501, 1502, 1503, 1504, 1505, 1506, 1507, 1508, 1509, 1510, 1511, 1512, 1513, 1514, 1515, 1516, 1517, 1518, 1519, 1520, 1521, 1522, 1523, 1524, 1525, 1526, 1527, 1528, 1529, 1530, 1531, 1532, 1533, 1534, 1535, 1536, 1538, 1539, 1540, 1541, 1542, 1543, 1544, 1545, 1546, 1548, 1549, 1550, 1551, 1552, 1553, 1554, 1556, 1557, 1558, 1559, 1560, 1561, 1562, 1563, 1564, 1565, 1566, 1567, 1568, 1569, 1570, 1571, 1572, 1573, 1574, 1575, 1576, 1577, 1578, 1579, 1580, 1581, 1582, 1583, 1584, 1585, 1586, 1587, 1588, 1589, 1590, 1591, 1592, 1593, 1594, 1595, 1596, 1597, 1598, 1599, 1600, 1601, 1602, 1603, 1604, 1605, 1606, 1607, 1608, 1609, 1610, 1612, 1613, 1614, 1615, 1616, 1617, 1618, 1619, 1620, 1621, 1622, 1623, 1624, 1625, 1626, 1627, 1628, 1629, 1630, 1631, 1632, 1633, 1634, 1635, 1636, 1637, 1638, 1639, 1640, 1641, 1642, 1643, 1644, 1645, 1646, 1647, 1648, 1649, 1650, 1651, 1652, 1653, 1654, 1655, 1656, 1657, 1658, 1659, 1660, 1661, 1662, 1663, 1664, 1665, 1666, 1667, 1668, 1669, 1670, 1671, 1672, 1673, 1674, 1675, 1676, 1678, 1679, 1680, 1681, 1682, 1683, 1684, 1685, 1686, 1687, 1688, 1689, 1690, 1691, 1692, 1693, 1694, 1695, 1696, 1697, 1698, 1699, 1700, 1701, 1702, 1703, 1704, 1705, 1706, 1707, 1708, 1709, 1710, 1711, 1712, 1713, 1714, 1715, 1716, 1717, 1718, 1719, 1720, 1721, 1722, 1723, 1724, 1725, 1726, 1727, 1728, 1729, 1730, 1731, 1732, 1734, 1735, 1736, 1737, 1738, 1739, 1740, 1741, 1742, 1743, 1744, 1745, 1746, 1747, 1748, 1749, 1752, 1753, 1754, 1755, 1756, 1757, 1758, 1759, 1760, 1761, 1762, 1764, 1765, 1766, 1767, 1768, 1769, 1770, 1771, 1772, 1773, 1774, 1775, 1776, 1778, 1779, 1780, 1781, 1782, 1783, 1784, 1785, 1786, 1787, 1788, 1789, 1790, 1791, 1792, 1793, 1795, 1796, 1797, 1798, 1799, 1800, 1801, 1802, 1803, 1804, 1805, 1806, 1807, 1808, 1809, 1810, 1811, 1812, 1813, 1814, 1815, 1816, 1817, 1818, 1819, 1820, 1821, 1822, 1823, 1824, 1825, 1826, 1827, 1828, 1829, 1830, 1831, 1832, 1833, 1834, 1835, 1836, 1837, 1838, 1839, 1840, 1841, 1842, 1843, 1844, 1845, 1846, 1847, 1848, 1849, 1850, 1851, 1852, 1853, 1854, 1855, 1857, 1858, 1859, 1860, 1861, 1862, 1863, 1864, 1865, 1866, 1867, 1868, 1869, 1870, 1871, 1872, 1873, 1874, 1875, 1876, 1877, 1878, 1879, 1880, 1881, 1882, 1883, 1884, 1885, 1886, 1887, 1888, 1889, 1890, 1891, 1892, 1893, 1894, 1895, 1896, 1897, 1898, 1899, 1900, 1901, 1902, 1903, 1904, 1905, 1907, 1908, 1909, 1910, 1911, 1912, 1914, 1915, 1916, 1918, 1919, 1920, 1921, 1922, 1923, 1924, 1925, 1926, 1927, 1928, 1929, 1930, 1931, 1932, 1934, 1936, 1937, 1938, 1939, 1940, 1941, 1942, 1943, 1944, 1945, 1946, 1947, 1948, 1949, 1950, 1951, 1952, 1954, 1955, 1956, 1957, 1958, 1959, 1960, 1961, 1962, 1963, 1964, 1965, 1966, 1967, 1968, 1969, 1970, 1971, 1972, 1973, 1974, 1975, 1976, 1977, 1978, 1979, 1980, 1981, 1982, 1983, 1984, 1985, 1986, 1987, 1988, 1990, 1991, 1992, 1993, 1994, 1995, 1996, 1997, 1998, 1999, 2000, 2001, 2002, 2003, 2004, 2005, 2006, 2007, 2008, 2009, 2010, 2011, 2012, 2014, 2015, 2016, 2017, 2018, 2019, 2020, 2021, 2022, 2023, 2024, 2025, 2026, 2027, 2028, 2029, 2030, 2031, 2032, 2033, 2034, 2035, 2036, 2037, 2038, 2039, 2040, 2041, 2042, 2043, 2044, 2045, 2046, 2047, 2048, 2049, 2050, 2051, 2052, 2053, 2055, 2056, 2057, 2058, 2059, 2060, 2061, 2062, 2063, 2064, 2065, 2066, 2067, 2068, 2069, 2070, 2071, 2073, 2074, 2075, 2076, 2077, 2079, 2080, 2081, 2082, 2083, 2084, 2085, 2086, 2087, 2088, 2089, 2090, 2091, 2092, 2094, 2095, 2096, 2097, 2098, 2099, 2100, 2101, 2102, 2103, 2104, 2106, 2107, 2108, 2109, 2110, 2111, 2112, 2113, 2114, 2115, 2116, 2117, 2118, 2119, 2120, 2121, 2122, 2123, 2124, 2125, 2126, 2128, 2129, 2130, 2131, 2132, 2133, 2134, 2135, 2137, 2138, 2139, 2140, 2141, 2142, 2143, 2144, 2146, 2147, 2148, 2149, 2150, 2151, 2152, 2153, 2154, 2155, 2156, 2157, 2158, 2159, 2160, 2161, 2162, 2163, 2164, 2166, 2167, 2168, 2169, 2170, 2171, 2172, 2173, 2174, 2175, 2176, 2177, 2178, 2179, 2180, 2181, 2182, 2183, 2184, 2185, 2186, 2187, 2188, 2189, 2190, 2191, 2192, 2193, 2194, 2195, 2196, 2197, 2198, 2200, 2201, 2202, 2203, 2204, 2205, 2206, 2207, 2208, 2209, 2210, 2211, 2212, 2213, 2214, 2215, 2216, 2217, 2218, 2219, 2220, 2221, 2222, 2223, 2224, 2225, 2226, 2228, 2229, 2230, 2231, 2232, 2233, 2234, 2235, 2236, 2237, 2239, 2240, 2241, 2242, 2243, 2244, 2245, 2246, 2247, 2248, 2249, 2250, 2251, 2252, 2253, 2254, 2255, 2259, 2260, 2261, 2262, 2263, 2264, 2265, 2266, 2267, 2268, 2269, 2270, 2271, 2272, 2273, 2274, 2275, 2276, 2277, 2280, 2281, 2282, 2283, 2284, 2285, 2287, 2288, 2289, 2290, 2291, 2292, 2293, 2294, 2295, 2296, 2297, 2298, 2299, 2300, 2301, 2302, 2303, 2304, 2305, 2306, 2307, 2309, 2310, 2311, 2312, 2313, 2315, 2316, 2317, 2318, 2319, 2320, 2321, 2322, 2323, 2324, 2325, 2327, 2328, 2329, 2330, 2331, 2332, 2333, 2334, 2335, 2336, 2337, 2338, 2339, 2340, 2341, 2342, 2344, 2345, 2346, 2347, 2348, 2349, 2350, 2351, 2352, 2353, 2354, 2355, 2356, 2357, 2358, 2359, 2360, 2361, 2362, 2363, 2364, 2365, 2366, 2367, 2368, 2369, 2370, 2371, 2373, 2374, 2375, 2376, 2377, 2378, 2379, 2380, 2381, 2382, 2383, 2384, 2385, 2386, 2387, 2388, 2389, 2390, 2391, 2392, 2393, 2394, 2395, 2396, 2397, 2398, 2399, 2401, 2402, 2403, 2404, 2405, 2406, 2407, 2408, 2409, 2410, 2411, 2412, 2413, 2414, 2415, 2416, 2419, 2420, 2421, 2422, 2423, 2424, 2425, 2426, 2427, 2428, 2429, 2430, 2431, 2432, 2433, 2434, 2435, 2436, 2437, 2438, 2439, 2440, 2441, 2442, 2443, 2444, 2445, 2446, 2448, 2449, 2450, 2452, 2453, 2454, 2455, 2456, 2457, 2458, 2459, 2460, 2461, 2462, 2463, 2464, 2465, 2466, 2467, 2469, 2470, 2471, 2472, 2473, 2474, 2475, 2476, 2477, 2478, 2479, 2480, 2481, 2482, 2483, 2484, 2485, 2486, 2487, 2488, 2489, 2490, 2491, 2492, 2494, 2495, 2496, 2497, 2499, 2500, 2501, 2503, 2504, 2505, 2506, 2508, 2509, 2510, 2511, 2512, 2513, 2514, 2515, 2516, 2517, 2518, 2519, 2520, 2521, 2522, 2523, 2524, 2525, 2526, 2527, 2528, 2529, 2530, 2531, 2532, 2533, 2534, 2535, 2536, 2537, 2538, 2540, 2541, 2542, 2543, 2544, 2546, 2547, 2548, 2549, 2550, 2551, 2552, 2553, 2554, 2555, 2556, 2557, 2558, 2559, 2560, 2561, 2562, 2563, 2564, 2566, 2567, 2568, 2569, 2570, 2572, 2574, 2575, 2576, 2577, 2578, 2579, 2580, 2581, 2582, 2583, 2584, 2585, 2586, 2587, 2590, 2591, 2592, 2593, 2594, 2595, 2596, 2597, 2598, 2599, 2600, 2601, 2603, 2604, 2605, 2606, 2607, 2608, 2609, 2610, 2611, 2612, 2613, 2614, 2615, 2616, 2617, 2620, 2621, 2622, 2623, 2624, 2625, 2626, 2627, 2628, 2629, 2630, 2631, 2632, 2633, 2635, 2636, 2637, 2638, 2639, 2640, 2641, 2642, 2643, 2644, 2645, 2646, 2647, 2648, 2649, 2650, 2652, 2653, 2654, 2655, 2656, 2657, 2658, 2659, 2660, 2662, 2664, 2666, 2667, 2668, 2669, 2671, 2672, 2673, 2674, 2677, 2679, 2680, 2681, 2682, 2683, 2684, 2685, 2686, 2687, 2688, 2689, 2690, 2691, 2692, 2693, 2694, 2695, 2696, 2697, 2698, 2699, 2700, 2701, 2703, 2704, 2705, 2706, 2707, 2708, 2709, 2710, 2711, 2712, 2713, 2715, 2716, 2717, 2718, 2720, 2721, 2723, 2724, 2725, 2726, 2727, 2728, 2729, 2730, 2731, 2732, 2733, 2734, 2735, 2736, 2737, 2738, 2739, 2740, 2741, 2744, 2745, 2746, 2747, 2748, 2749, 2750, 2751, 2753, 2754, 2755, 2756, 2757, 2758, 2759, 2760, 2761, 2762, 2763, 2764, 2765, 2766, 2768, 2769, 2770, 2771, 2772, 2773, 2774, 2775, 2776, 2777, 2779, 2780, 2782, 2783, 2784, 2785, 2786, 2787, 2789, 2790, 2791, 2792, 2793, 2794, 2795, 2796, 2797, 2798, 2799, 2800, 2801, 2802, 2803, 2804, 2805, 2806, 2807, 2808, 2809, 2811, 2812, 2813, 2814, 2815, 2816, 2817, 2818, 2819, 2820, 2821, 2822, 2823, 2825, 2826, 2827, 2828, 2830, 2831, 2832, 2833, 2834, 2835, 2836, 2837, 2838, 2839, 2840, 2841, 2842, 2843, 2844, 2845, 2846, 2847, 2848, 2849, 2850, 2851, 2852, 2853, 2854, 2855, 2856, 2857, 2858, 2859, 2860, 2861, 2862, 2863, 2865, 2866, 2867, 2868, 2869, 2870, 2871, 2872, 2873, 2874, 2875, 2877, 2878, 2880, 2883, 2884, 2886, 2887, 2888, 2889, 2890, 2891, 2892, 2893, 2894, 2895, 2896, 2897, 2898, 2899, 2900, 2901, 2902, 2903, 2904, 2905, 2906, 2907, 2908, 2909, 2910, 2911, 2912, 2914, 2915, 2916, 2917, 2918, 2919, 2920, 2921, 2923, 2924, 2925, 2926, 2927, 2930, 2931, 2932, 2933, 2934, 2935, 2937, 2938, 2939, 2940, 2941, 2942, 2943, 2944, 2945, 2946, 2947, 2949, 2950, 2951, 2952, 2953, 2955, 2956, 2957, 2959, 2960, 2961, 2962, 2963, 2965, 2966, 2967, 2968, 2969, 2970, 2971, 2972, 2973, 2974, 2975, 2976, 2977, 2978, 2979, 2980, 2981, 2982, 2983, 2984, 2985, 2986, 2987, 2988, 2989, 2990, 2991, 2992, 2993, 2994, 2995, 2996, 2997, 2998, 2999, 3000, 3001, 3002, 3003, 3004, 3005, 3006, 3007, 3008, 3009, 3010, 3011, 3012, 3014, 3015, 3016, 3017, 3018, 3019, 3020, 3022, 3023, 3024, 3025, 3026, 3027, 3028, 3029, 3030, 3031, 3032, 3033, 3034, 3035, 3036, 3037, 3038, 3039, 3040, 3042, 3043, 3044, 3045, 3046, 3047, 3048, 3049, 3050, 3051, 3052, 3053, 3054, 3055, 3057, 3058, 3059, 3060, 3061, 3062, 3063, 3064, 3065, 3066, 3067, 3068, 3070, 3071, 3072, 3073, 3074, 3075, 3076, 3077, 3079, 3080, 3081, 3082, 3083, 3084, 3086, 3087, 3088, 3089, 3090, 3091, 3093, 3094, 3095, 3096, 3097, 3098, 3099, 3100, 3101, 3102, 3103, 3104, 3105, 3106, 3107, 3108, 3109, 3110, 3111, 3112, 3113, 3114, 3115, 3116, 3118, 3119, 3120, 3121, 3122, 3123, 3124, 3125, 3126, 3127, 3128, 3131, 3132, 3133, 3134, 3135, 3136, 3137, 3138, 3139, 3141, 3142, 3143, 3144, 3146, 3147, 3149, 3150, 3151, 3152, 3153, 3155, 3156, 3157, 3158, 3159, 3160, 3162, 3163, 3164, 3165, 3166, 3167, 3169, 3170, 3171, 3172, 3173, 3174, 3175, 3176, 3177, 3178, 3179, 3180, 3181, 3182, 3183, 3184, 3185, 3186, 3187, 3188, 3189, 3190, 3191, 3192, 3193, 3194, 3195, 3196, 3197, 3198, 3199, 3200, 3201, 3202, 3203, 3204, 3205, 3206, 3207, 3208, 3209, 3210, 3211, 3212, 3213, 3214, 3215, 3216, 3217, 3218, 3219, 3222, 3223, 3224, 3225, 3226, 3227, 3228, 3229, 3231, 3232, 3233, 3234, 3236, 3240, 3241, 3242, 3243, 3244, 3245, 3247, 3248, 3249, 3250, 3251, 3252, 3253, 3254, 3255, 3256, 3257, 3258, 3259, 3260, 3261, 3262, 3263, 3265, 3269, 3270, 3271, 3272, 3273, 3276, 3277, 3279, 3280, 3281, 3282, 3283, 3284, 3285, 3286, 3287, 3288, 3289, 3291, 3292, 3293, 3294, 3295, 3296, 3298, 3299, 3300, 3301, 3302, 3303, 3304, 3305, 3306, 3307, 3310, 3311, 3312, 3313, 3314, 3316, 3317, 3318, 3319, 3320, 3321, 3322, 3323, 3325, 3326, 3327, 3328, 3329, 3330, 3331, 3332, 3333, 3334, 3335, 3337, 3338, 3339, 3340, 3341, 3342, 3343, 3344, 3345, 3346, 3347, 3349, 3350, 3351, 3352, 3353, 3354, 3355, 3356, 3357, 3358, 3359, 3360, 3362, 3363, 3364, 3366, 3367, 3368, 3369, 3370, 3371, 3372, 3373, 3374, 3375, 3376, 3377, 3378, 3379, 3380, 3381, 3382, 3383, 3384, 3386, 3387, 3388, 3389, 3390, 3391, 3392, 3393, 3394, 3396, 3397, 3398, 3399, 3400, 3401, 3402, 3403, 3404, 3405, 3406, 3407, 3408, 3410, 3411, 3412, 3413, 3414, 3415, 3416, 3417, 3418, 3419, 3421, 3422, 3423, 3424, 3426, 3427, 3428, 3429, 3430, 3431, 3432, 3433, 3434, 3435, 3436, 3437, 3438, 3439, 3440, 3441, 3442, 3443, 3444, 3445, 3446, 3447, 3448, 3449, 3450, 3451, 3452, 3453, 3454, 3455, 3456, 3457, 3459, 3460, 3461, 3462, 3465, 3466, 3467, 3468, 3469, 3470, 3471, 3472, 3473, 3474, 3476, 3477, 3480, 3481, 3482, 3483, 3484, 3485, 3486, 3487, 3488, 3489, 3490, 3491, 3492, 3493, 3494, 3495, 3497, 3498, 3499, 3500, 3501, 3502, 3503, 3504, 3505, 3506, 3507, 3509, 3510, 3511, 3512, 3513, 3514, 3515, 3516, 3519, 3520, 3521, 3522, 3523, 3525, 3526, 3527, 3528, 3529, 3530, 3531, 3532, 3533, 3534, 3535, 3536, 3538, 3539, 3540, 3541, 3542, 3543, 3544, 3545, 3546, 3547, 3548, 3549, 3550, 3551, 3552, 3553, 3554, 3556, 3557, 3558, 3559, 3562, 3563, 3564, 3565, 3566, 3567, 3568, 3569, 3570, 3571, 3572, 3573, 3574, 3575, 3576, 3577, 3578, 3580, 3581, 3582, 3583, 3584, 3585, 3586, 3588, 3589, 3591, 3592, 3593, 3594, 3595, 3596, 3598, 3599, 3600, 3601, 3602, 3603, 3604, 3605, 3606, 3607, 3608, 3609, 3610, 3611, 3612, 3613, 3614, 3615, 3616, 3617, 3618, 3620, 3621, 3622, 3623, 3624, 3625, 3626, 3627, 3628, 3629, 3630, 3631, 3632, 3633, 3634, 3635, 3636, 3637, 3638, 3639, 3640, 3642, 3644, 3645, 3646, 3647, 3648, 3649, 3650, 3651, 3652, 3653, 3655, 3656, 3657, 3658, 3660, 3661, 3662, 3663, 3664, 3665, 3666, 3667, 3668, 3669, 3670, 3671, 3672, 3673, 3674, 3675, 3676, 3677, 3678, 3679, 3680, 3681, 3682, 3683, 3684, 3685, 3686, 3687, 3688, 3689, 3690, 3691, 3692, 3693, 3694, 3696, 3697, 3698, 3699, 3700, 3701, 3702, 3703, 3704, 3705, 3706, 3707, 3708, 3709, 3710, 3711, 3712, 3713, 3716, 3717, 3718, 3719, 3721, 3722, 3724, 3728, 3729, 3730, 3731, 3732, 3733, 3734, 3735, 3736, 3737, 3738, 3739, 3740, 3743, 3744, 3748, 3749, 3750, 3751, 3752, 3753, 3754, 3756, 3757, 3758, 3759, 3760, 3761, 3762, 3763, 3764, 3765, 3766, 3767, 3768, 3769, 3770, 3772, 3773, 3774, 3775, 3776, 3777, 3778, 3779, 3781, 3782, 3783, 3784, 3785, 3786, 3787, 3788, 3789, 3790, 3791, 3792, 3793, 3794, 3795, 3796, 3797, 3798, 3799, 3800, 3801, 3802, 3803, 3804, 3805, 3806, 3807, 3808, 3809, 3810, 3811, 3812, 3813, 3814, 3815, 3817, 3818, 3819, 3820, 3821, 3822, 3823, 3825, 3826, 3827, 3828, 3829, 3830, 3831, 3832, 3833, 3834, 3835, 3836, 3837, 3838, 3839, 3840, 3841, 3843, 3844, 3845, 3846, 3847, 3848, 3849, 3850, 3851, 3852, 3853, 3854, 3855, 3856, 3857, 3858, 3859, 3860, 3861, 3862, 3863, 3864, 3866, 3867, 3868, 3869, 3870, 3871, 3872, 3873, 3874, 3875, 3877, 3878, 3879, 3880, 3884, 3886, 3887, 3888, 3889, 3890, 3891, 3892, 3893, 3894, 3895, 3896, 3897, 3898, 3899, 3900, 3901, 3902, 3903, 3904, 3905, 3906, 3907, 3908, 3910, 3912, 3913, 3915, 3917, 3918, 3919, 3920, 3921, 3922, 3923, 3924, 3925, 3926, 3927, 3928, 3929, 3930, 3932, 3933, 3934, 3935, 3936, 3937, 3938, 3939, 3940, 3941, 3943, 3944, 3945, 3946, 3947, 3948, 3949, 3950, 3951, 3952, 3953, 3954, 3955, 3956, 3957, 3958, 3959, 3960, 3962, 3963, 3964, 3965, 3966, 3967, 3969, 3972, 3973, 3974, 3975, 3976, 3977, 3978, 3979, 3980, 3981, 3982, 3983, 3984, 3985, 3986, 3987, 3988, 3989, 3990, 3991, 3992, 3993, 3994, 3995, 3996, 3997, 3998, 3999, 4000, 4001, 4002, 4003, 4004, 4005, 4006, 4007, 4008, 4009, 4010, 4011, 4012, 4013, 4014, 4016, 4017, 4018, 4019, 4020, 4021, 4022, 4023, 4024, 4025, 4026, 4027, 4028, 4029, 4030, 4031, 4032, 4033, 4034, 4037, 4038, 4039, 4040, 4041, 4042, 4043, 4044, 4045, 4046, 4047, 4049, 4050, 4053, 4054, 4055, 4056, 4057, 4058, 4059, 4060, 4061, 4062, 4063, 4067, 4068, 4069, 4070, 4071, 4072, 4073, 4074, 4075, 4076, 4077, 4078, 4079, 4080, 4081, 4082, 4083, 4084, 4085, 4086, 4087, 4088, 4089, 4090, 4091, 4092, 4093, 4094, 4095, 4096, 4097, 4098, 4099, 4100, 4101, 4102, 4103, 4104, 4105, 4106, 4107, 4108, 4109, 4111, 4112, 4113, 4114, 4115, 4116, 4117, 4118, 4119, 4120, 4121, 4122, 4123, 4124, 4125, 4126, 4127, 4128, 4129, 4130, 4131, 4132, 4133, 4134, 4135, 4136, 4137, 4138, 4139, 4140, 4141, 4142, 4143, 4144, 4145, 4147, 4148, 4149, 4150, 4151, 4152, 4153, 4154, 4155, 4156, 4157, 4158, 4159, 4160, 4161, 4163, 4164, 4165, 4166, 4167, 4168, 4169, 4170, 4171, 4172, 4173, 4174, 4175, 4176, 4177, 4178, 4179, 4181, 4182, 4183, 4184, 4185, 4186, 4187, 4188, 4189, 4190, 4191, 4192, 4193, 4194, 4195, 4196, 4197, 4198, 4200, 4201, 4202, 4203, 4204, 4205, 4206, 4207, 4208, 4209, 4210, 4211, 4212, 4213, 4214, 4215, 4216, 4217, 4218, 4219, 4221, 4222, 4223, 4224, 4225, 4226, 4227, 4228, 4229, 4230, 4231, 4232, 4233, 4234, 4235, 4237, 4238, 4239, 4240, 4241, 4242, 4243, 4244, 4245, 4246, 4247, 4248, 4249, 4250, 4251, 4252, 4253, 4254, 4255, 4256, 4257, 4258, 4259, 4260, 4261, 4262, 4263, 4264, 4265, 4266, 4267, 4269, 4270, 4271, 4272, 4273, 4275, 4276, 4277, 4278, 4279, 4280, 4281, 4282, 4283, 4284, 4286, 4287, 4288, 4289, 4290, 4292, 4293, 4294, 4295, 4297, 4298, 4299, 4300, 4301, 4302, 4303, 4304, 4305, 4306, 4307, 4308, 4309, 4310, 4311, 4312, 4313, 4314, 4315, 4316, 4317, 4318, 4319, 4320, 4321, 4322, 4323, 4325, 4326, 4327, 4328, 4329, 4330, 4331, 4332, 4333, 4334, 4335, 4336, 4337, 4339, 4340, 4341, 4342, 4343, 4344, 4345, 4346, 4347, 4348, 4349, 4350, 4351, 4352, 4353, 4354, 4356, 4357, 4358, 4359, 4361, 4362, 4363, 4364, 4365, 4366, 4367, 4368, 4369, 4370, 4371, 4372, 4373, 4374, 4375, 4376, 4377, 4378, 4379, 4380, 4381, 4382, 4383, 4384, 4385, 4386, 4387, 4388, 4389, 4390, 4391, 4392, 4393, 4394, 4395, 4396, 4397, 4398, 4399, 4400, 4401, 4402, 4403, 4404, 4405, 4406, 4407, 4408, 4409, 4410, 4411, 4412, 4413, 4414, 4415, 4416, 4417, 4418, 4419, 4420, 4421, 4422, 4423, 4424, 4425, 4426, 4427, 4428, 4429, 4430, 4432, 4433, 4434, 4435, 4436, 4437, 4438, 4439, 4440, 4441, 4442, 4443, 4444, 4445, 4446, 4447, 4448, 4449, 4450, 4451, 4452, 4453, 4455, 4456, 4457, 4458, 4459, 4460, 4461, 4463, 4465, 4466, 4467, 4468, 4469, 4471, 4472, 4473, 4474, 4477, 4478, 4479, 4480, 4481, 4482, 4483, 4484, 4485, 4486, 4487, 4488, 4489, 4490, 4491, 4492, 4493, 4494, 4495, 4496, 4497, 4498, 4499, 4500, 4501, 4502, 4503, 4504, 4505, 4506, 4507, 4508, 4509, 4510, 4511, 4512, 4513, 4514, 4515, 4516, 4517, 4518, 4519, 4520, 4521, 4522, 4523, 4524, 4525, 4526, 4527, 4528, 4529, 4530, 4531, 4532, 4533, 4534, 4535, 4536, 4537, 4538, 4539, 4540, 4541, 4542, 4543, 4544, 4545, 4546, 4547, 4548, 4549, 4551, 4552, 4553, 4554, 4555, 4556, 4557, 4558, 4559, 4560, 4561, 4562, 4563, 4564, 4565, 4566, 4567, 4568, 4569, 4570, 4571, 4572, 4573, 4574, 4575, 4576, 4577, 4578, 4579, 4580, 4581, 4582, 4583, 4584, 4585, 4586, 4587, 4588, 4589, 4590, 4591, 4593, 4594, 4595, 4596, 4597, 4598, 4599, 4600, 4601, 4602, 4603, 4604, 4605, 4606, 4607, 4608, 4610, 4611, 4612, 4613, 4614, 4615, 4616, 4618, 4619, 4620, 4621, 4622, 4623, 4624, 4625, 4626, 4627, 4628, 4629, 4630, 4632, 4633, 4634, 4635, 4636, 4637, 4639, 4640, 4641, 4642, 4643, 4644, 4645, 4646, 4647, 4648, 4650, 4651, 4652, 4653, 4654, 4655, 4656, 4657, 4658, 4659, 4660, 4661, 4662, 4663, 4664, 4665, 4666, 4667, 4668, 4669, 4670, 4671, 4672, 4673, 4674, 4675, 4676, 4677, 4678, 4679, 4680, 4681, 4682, 4683, 4684, 4685, 4686, 4687, 4688, 4689, 4690, 4691, 4692, 4693, 4694, 4695, 4696, 4697, 4698, 4699, 4700, 4701, 4702, 4703, 4704, 4705, 4706, 4707, 4708, 4709, 4710, 4711, 4712, 4713, 4714, 4715, 4716, 4717, 4718, 4719, 4720, 4722, 4723, 4724, 4725, 4726, 4727, 4728, 4729, 4730, 4731, 4732, 4733, 4734, 4735, 4736, 4737, 4738, 4739, 4740, 4741, 4742, 4743, 4744, 4745, 4746, 4747, 4748, 4749, 4750, 4751, 4752, 4753, 4754, 4755, 4756, 4757, 4758, 4759, 4760, 4761, 4762, 4763, 4764, 4765, 4767, 4768, 4770, 4771, 4772, 4773, 4774, 4775, 4776, 4777, 4778, 4779, 4780, 4781, 4783, 4784, 4785, 4788, 4789, 4790, 4791, 4792, 4793, 4794, 4795, 4796, 4797, 4798, 4799, 4800, 4801, 4802, 4803, 4804, 4805, 4806, 4807, 4808, 4809, 4810, 4811, 4813, 4814, 4815, 4816, 4817, 4818, 4819, 4820, 4821, 4822, 4823, 4826, 4827, 4828, 4829, 4831, 4832, 4833, 4834, 4835, 4836, 4837, 4838, 4839, 4840, 4841, 4842, 4843, 4844, 4845, 4846, 4847, 4848, 4849, 4850, 4851, 4852, 4853, 4854, 4855, 4856, 4857, 4858, 4859, 4860, 4861, 4862, 4863, 4864, 4865, 4866, 4867, 4868, 4869, 4871, 4872, 4873, 4874, 4875, 4876, 4877, 4878, 4879, 4880, 4881, 4882, 4883, 4884, 4885, 4887, 4888, 4889, 4890, 4891, 4892, 4893, 4894, 4895, 4897, 4898, 4899, 4900, 4901, 4902, 4903, 4904, 4905, 4906, 4907, 4908, 4909, 4910, 4911, 4912, 4914, 4915, 4916, 4917, 4918, 4919, 4920, 4921, 4922, 4923, 4925, 4926, 4927, 4928, 4929, 4930, 4931, 4932, 4933, 4934, 4935, 4936, 4937, 4938, 4939, 4940, 4942, 4943, 4944, 4945, 4946, 4947, 4948, 4949, 4950, 4951, 4952, 4953, 4954, 4955, 4956, 4957, 4958, 4959, 4960, 4961, 4962, 4963, 4964, 4965, 4967, 4968, 4969, 4970, 4971, 4972, 4973, 4974, 4975, 4977, 4978, 4979, 4980, 4981, 4982, 4983, 4984, 4986, 4987, 4988, 4989, 4990, 4991, 4993, 4994, 4995, 4996, 4997, 4998, 4999, 5000, 5001, 5002, 5003, 5004, 5005, 5006, 5007, 5009, 5010, 5011, 5012, 5013, 5014, 5015, 5016, 5017, 5018, 5019, 5020, 5021, 5022, 5023, 5024, 5025, 5026, 5027, 5028, 5029, 5031, 5032, 5033, 5034, 5035, 5036, 5037, 5038, 5039, 5040, 5041, 5042, 5043, 5044, 5045, 5046, 5047, 5048, 5049, 5050, 5051, 5052, 5053, 5055, 5056, 5057, 5058, 5059, 5060, 5061, 5062, 5063, 5064, 5065, 5066, 5067, 5068, 5069, 5070, 5071, 5072, 5073, 5074, 5075, 5076, 5077, 5078, 5079, 5080, 5081, 5082, 5083, 5084, 5085, 5086, 5087, 5090, 5091, 5092, 5093, 5095, 5096, 5097, 5098, 5099, 5100, 5101, 5102, 5103, 5104, 5105, 5106, 5107, 5108, 5109, 5110, 5111, 5112, 5113, 5114, 5115, 5116, 5117, 5118, 5119, 5120, 5121, 5122, 5123, 5124, 5125, 5126, 5127, 5128, 5129, 5130, 5131, 5132, 5133, 5134, 5135, 5136, 5137, 5138, 5139, 5140, 5141, 5142, 5143, 5144, 5145, 5148, 5149, 5150, 5151, 5152, 5153, 5155, 5156, 5157, 5158, 5159, 5160, 5161, 5162, 5163, 5164, 5165, 5166, 5167, 5168, 5169, 5170, 5171, 5172, 5174, 5175, 5176, 5178, 5179, 5181, 5182, 5183, 5185, 5186, 5187, 5188, 5190, 5191, 5192, 5193, 5194, 5195, 5196, 5197, 5198, 5199, 5200, 5201, 5202, 5203, 5204, 5205, 5206, 5207, 5208, 5209, 5210, 5211, 5212, 5213, 5214, 5215, 5216, 5217, 5218, 5219, 5220, 5221, 5224, 5225, 5226, 5229, 5230, 5231, 5232, 5233, 5236, 5237, 5238, 5239, 5240, 5241, 5242, 5243, 5245, 5246, 5247, 5248, 5249, 5250, 5251, 5252, 5253, 5254, 5256, 5257, 5258, 5259, 5260, 5261, 5262, 5263, 5264, 5265, 5266, 5267, 5268, 5269, 5270, 5271, 5272, 5273, 5274, 5275, 5276, 5277, 5278, 5279, 5280, 5281, 5282, 5283, 5284, 5285, 5286, 5287, 5288, 5289, 5290, 5291, 5292, 5294, 5295, 5296, 5297, 5298, 5299, 5300, 5301, 5302, 5303, 5304, 5305, 5306, 5307, 5308, 5309, 5310, 5311, 5312, 5313, 5314, 5315, 5316, 5317, 5319, 5320, 5321, 5323, 5324, 5325, 5326, 5327, 5328, 5329, 5330, 5331, 5333, 5334, 5335, 5336, 5337, 5338, 5339, 5340, 5341, 5342, 5343, 5344, 5345, 5346, 5347, 5348, 5350, 5351, 5352, 5353, 5354, 5355, 5356, 5357, 5358, 5359, 5361, 5362, 5363, 5364, 5365, 5366, 5367, 5368, 5369, 5370, 5371, 5372, 5373, 5375, 5376, 5377, 5378, 5379, 5380, 5381, 5383, 5384, 5385, 5386, 5387, 5388, 5389, 5390, 5391, 5392, 5393, 5394, 5396, 5397, 5398, 5399, 5400, 5401, 5402, 5403, 5404, 5405, 5406, 5407, 5408, 5409, 5410, 5411, 5412, 5413, 5414, 5416, 5417, 5418, 5419, 5420, 5422, 5423, 5424, 5425, 5426, 5427, 5428, 5429, 5430, 5431, 5432, 5433, 5434, 5435, 5437, 5438, 5439, 5440, 5441, 5442, 5443, 5444, 5445, 5446, 5447, 5448, 5449, 5450, 5451, 5452, 5453, 5454, 5455, 5456, 5457, 5458, 5459, 5460, 5461, 5462, 5463, 5464, 5465, 5466, 5467, 5468, 5469, 5470, 5471, 5472, 5473, 5474, 5475, 5476, 5477, 5478, 5479, 5480, 5481, 5482, 5483, 5484, 5485, 5486, 5487, 5488, 5489, 5490, 5491, 5492, 5493, 5494, 5495, 5496, 5497, 5498, 5499, 5500, 5501, 5502, 5503, 5504, 5505, 5506, 5507, 5508, 5509, 5510, 5511, 5512, 5513, 5514, 5515, 5516, 5517, 5518, 5519, 5520, 5521, 5522, 5523, 5524, 5525, 5526, 5527, 5529, 5530, 5531, 5532, 5533, 5534, 5535, 5536, 5537, 5538, 5539, 5540, 5541, 5542, 5543, 5544, 5545, 5547, 5548, 5549, 5550, 5551, 5552, 5554, 5555, 5556, 5557, 5558, 5559, 5560, 5561, 5562, 5563, 5564, 5565, 5566, 5567, 5568, 5569, 5570, 5571, 5572, 5573, 5574, 5575, 5576, 5577, 5578, 5579, 5580, 5581, 5582, 5583, 5584, 5585, 5586, 5587, 5588, 5589, 5590, 5591, 5592, 5593, 5594, 5595, 5596, 5597, 5598, 5600, 5601, 5602, 5603, 5604, 5605, 5606, 5607, 5608, 5609, 5610, 5612, 5613, 5614, 5615, 5616, 5617, 5618, 5620, 5621, 5622, 5623, 5624, 5625, 5626, 5627, 5628, 5629, 5630, 5631, 5633, 5634, 5635, 5636, 5637, 5639, 5640, 5642, 5643, 5645, 5646, 5647, 5648, 5649, 5650, 5651, 5652, 5653, 5654, 5655, 5656, 5657, 5658, 5659, 5660, 5661, 5662, 5663, 5664, 5665, 5666, 5667, 5668, 5669, 5670, 5671, 5672, 5673, 5674, 5676, 5677, 5678, 5679, 5680, 5681, 5682, 5683, 5684, 5685, 5686, 5688, 5689, 5690, 5691, 5692, 5693, 5694, 5695, 5696, 5697, 5698, 5699, 5700, 5701, 5702, 5703, 5704, 5705, 5706, 5707, 5708, 5709, 5711, 5712, 5713, 5714, 5716, 5717, 5718, 5720, 5721, 5722, 5723, 5724, 5726, 5728, 5729, 5730, 5731, 5732, 5733, 5734, 5735, 5736, 5737, 5739, 5740, 5741, 5742, 5743, 5744, 5745, 5746, 5747, 5748, 5749, 5751, 5752, 5753, 5754, 5755, 5756, 5757, 5758, 5759, 5760, 5761, 5762, 5763, 5764, 5765, 5766, 5767, 5768, 5769, 5771, 5772, 5773, 5774, 5775, 5776, 5777, 5778, 5779, 5780, 5781, 5782, 5783, 5784, 5785, 5786, 5787, 5788, 5789, 5791, 5792, 5793, 5794, 5795, 5796, 5797, 5798, 5799, 5800, 5801, 5802, 5803, 5804, 5805, 5806, 5808, 5809, 5810, 5811, 5813, 5814, 5815, 5816, 5817, 5819, 5820, 5821, 5822, 5823, 5825, 5826, 5827, 5828, 5829, 5830, 5831, 5832, 5833, 5834, 5835, 5836, 5837, 5838, 5839, 5840, 5841, 5842, 5843, 5844, 5846, 5847, 5848, 5849, 5850, 5851, 5852, 5853, 5854, 5855, 5856, 5857, 5858, 5859, 5860, 5861, 5862, 5863, 5864, 5865, 5866, 5868, 5869, 5870, 5871, 5872, 5874, 5875, 5876, 5877, 5878, 5880, 5881, 5882, 5883, 5884, 5886, 5887, 5888, 5889, 5890, 5891, 5892, 5893, 5894, 5895, 5896, 5897, 5898, 5899, 5900, 5901, 5902, 5903, 5904, 5905, 5906, 5907, 5908, 5909, 5910, 5912, 5913, 5914, 5915, 5916, 5917, 5918, 5919, 5920, 5921, 5922, 5924, 5925, 5926, 5927, 5928, 5929, 5932, 5933, 5934, 5935, 5936, 5937, 5938, 5939, 5940, 5942, 5943, 5944, 5945, 5946, 5947, 5948, 5949, 5950, 5952, 5953, 5954, 5955, 5956, 5957, 5960, 5962, 5963, 5965, 5966, 5967, 5968, 5969, 5970, 5971, 5972, 5973, 5974, 5975, 5976, 5977, 5978, 5979, 5980, 5981, 5983, 5984, 5985, 5986, 5987, 5988, 5989, 5990, 5991, 5992, 5993, 5994, 5995, 5996, 5997, 5998, 5999, 6000, 6001, 6002, 6003, 6004, 6005, 6006, 6007, 6008, 6009, 6010, 6011, 6012, 6013, 6015, 6016, 6017, 6018, 6019, 6021, 6022, 6023, 6024, 6025, 6027, 6028, 6029, 6030, 6031, 6032, 6034, 6036, 6037, 6040, 6041, 6042, 6043, 6044, 6045, 6046, 6047, 6048, 6049, 6051, 6052, 6053, 6055, 6056, 6057, 6058, 6059, 6060, 6061, 6063, 6064, 6065, 6066, 6067, 6068, 6069, 6070, 6071, 6072, 6073, 6074, 6075, 6076, 6077, 6078, 6079, 6080, 6081, 6083, 6084, 6085, 6086, 6087, 6088, 6089, 6090, 6091, 6092, 6093, 6094, 6095, 6096, 6097, 6099, 6100, 6101, 6102, 6103, 6104, 6105, 6106, 6107, 6108, 6109, 6111, 6112, 6113, 6114, 6115, 6116, 6117, 6118, 6119, 6120, 6121, 6122, 6123, 6124, 6126, 6127, 6128, 6129, 6130, 6131, 6132, 6133, 6134, 6135, 6136, 6137, 6139, 6140, 6141, 6142, 6143, 6144, 6145, 6146, 6147, 6148, 6149, 6150, 6151, 6152, 6153, 6154, 6155, 6156, 6157, 6158, 6159, 6160, 6161, 6162, 6163, 6164, 6165, 6166, 6167, 6168, 6169, 6170, 6171, 6172, 6173, 6174, 6175, 6176, 6178, 6179, 6180, 6181, 6182, 6183, 6184, 6185, 6186, 6187, 6189, 6190, 6191, 6192, 6193, 6194, 6195, 6196, 6197, 6198, 6200, 6201, 6202, 6203, 6204, 6205, 6206, 6207, 6208, 6209, 6210, 6211, 6212, 6213, 6214, 6215, 6216, 6217, 6218, 6219, 6220, 6221, 6222, 6223, 6224, 6225, 6226, 6227, 6228, 6229, 6230, 6231, 6232, 6233, 6234, 6235, 6236, 6237, 6238, 6239, 6240, 6241, 6242, 6243, 6244, 6245, 6246, 6247, 6248, 6249, 6250, 6251, 6252, 6253, 6254, 6255, 6256, 6257, 6258, 6259, 6260, 6261, 6262, 6263, 6264, 6265, 6266, 6267, 6269, 6270, 6271, 6272, 6273, 6274, 6275, 6276, 6277, 6278, 6279, 6280, 6281, 6282, 6283, 6284, 6285, 6286, 6287, 6288, 6289, 6290, 6291, 6292, 6293, 6294, 6295, 6296, 6297, 6298, 6300, 6301, 6302, 6303, 6304, 6305, 6306, 6307, 6308, 6309, 6310, 6311, 6313, 6314, 6315, 6316, 6317, 6318, 6319, 6320, 6321, 6322, 6323, 6324, 6325, 6326, 6327, 6328, 6329, 6330, 6331, 6332, 6333, 6334, 6335, 6336, 6338, 6339, 6340, 6341, 6342, 6343, 6344, 6345, 6346, 6347, 6348, 6349, 6350, 6351, 6352, 6353, 6354, 6355, 6356, 6357, 6358, 6359, 6360, 6361, 6362, 6363, 6364, 6369, 6370, 6371, 6372, 6373, 6374, 6375, 6376, 6377, 6378, 6379, 6380, 6381, 6382, 6383, 6384, 6385, 6386, 6387, 6388, 6389, 6390, 6391, 6392, 6393, 6394, 6395, 6396, 6398, 6399, 6401, 6402, 6404, 6405, 6407, 6408, 6410, 6411, 6412, 6413, 6414, 6415, 6416, 6417, 6418, 6419, 6420, 6421, 6422, 6423, 6424, 6425, 6426, 6427, 6428, 6429, 6430, 6431, 6433, 6434, 6435, 6436, 6437, 6438, 6439, 6440, 6441, 6442, 6443, 6444, 6445, 6446, 6447, 6448, 6449, 6450, 6452, 6453, 6454, 6455, 6457, 6458, 6460, 6461, 6462, 6463, 6464, 6466, 6467, 6468, 6469, 6470, 6471, 6472, 6473, 6474, 6475, 6476, 6477, 6478, 6479, 6481, 6482, 6483, 6484, 6485, 6486, 6487, 6488, 6489, 6491, 6492, 6493, 6494, 6495, 6496, 6497, 6498, 6499, 6500, 6501, 6502, 6503, 6504, 6505, 6506, 6507, 6508, 6509, 6510, 6511, 6512, 6513, 6514, 6515, 6516, 6517, 6518, 6519, 6520, 6521, 6522, 6523, 6524, 6525, 6526, 6527, 6528, 6529, 6530, 6531, 6532, 6533, 6534, 6535, 6536, 6537, 6538, 6539, 6540, 6541, 6542, 6543, 6544, 6545, 6547, 6548, 6552, 6553, 6554, 6555, 6556, 6557, 6558, 6559, 6560, 6561, 6562, 6563, 6564, 6565, 6566, 6567, 6568, 6569, 6570, 6571, 6572, 6573, 6575, 6576, 6577, 6578, 6579, 6580, 6581, 6582, 6583, 6584, 6585, 6586, 6587, 6589, 6590, 6591, 6592, 6593, 6594, 6595, 6596, 6597, 6598, 6600, 6601, 6602, 6603, 6604, 6605, 6606, 6607, 6608, 6609, 6610, 6611, 6612, 6613, 6614, 6615, 6616, 6617, 6618, 6619, 6620, 6621, 6622, 6623, 6624, 6625, 6626, 6627, 6628, 6629, 6630, 6631, 6632, 6633, 6634, 6635, 6636, 6637, 6639, 6640, 6641, 6642, 6643, 6644, 6645, 6646, 6647, 6648, 6649, 6650, 6651, 6652, 6653, 6654, 6655, 6656, 6657, 6658, 6659, 6660, 6661, 6662, 6663, 6664, 6665, 6666, 6667, 6668, 6669, 6670, 6671, 6672, 6673, 6675, 6676, 6677, 6678, 6679, 6680, 6681, 6682, 6683, 6684, 6685, 6686, 6687, 6688, 6689, 6690, 6691, 6692, 6693, 6694, 6695, 6696, 6697, 6698, 6699, 6700, 6701, 6702, 6703, 6704, 6705, 6706, 6707, 6708, 6709, 6710, 6711, 6712, 6713, 6714, 6715, 6716, 6717, 6718, 6719, 6720, 6721, 6722, 6723, 6724, 6725, 6726, 6727, 6728, 6729, 6730, 6731, 6732, 6733, 6734, 6735, 6736, 6737, 6738, 6739, 6740, 6741, 6742, 6743, 6744, 6745, 6747, 6748, 6750, 6751, 6752, 6753, 6754, 6755, 6756, 6757, 6758, 6759, 6760, 6762, 6764, 6765, 6766, 6767, 6768, 6769, 6770, 6771, 6772, 6773, 6774, 6775, 6776, 6777, 6778, 6779, 6780, 6781, 6782, 6783, 6784, 6785, 6786, 6787, 6788, 6789, 6790, 6791, 6792, 6793}",6300,"{989, 1078, 1081, 1094, 1113, 1121, 1132, 1133, 1139, 1140, 1141, 1143, 1145, 1146, 1147, 1150, 1152, 1154, 1159, 1160, 1166, 1167, 1168, 1170, 1174, 1175, 1178, 1180, 1183, 1184, 1187, 1188, 1189, 1191, 1192, 1195, 1196, 1197, 1198, 1199, 1200, 1201, 1202, 1205, 1206, 1208, 1209, 1215, 1216, 1222, 1225, 1227, 1230, 1232, 1234, 1235, 1236, 1237, 1238, 1239, 1240, 1241, 1244, 1245, 1246, 1247, 1249, 1250, 1251, 1252, 1253, 1258, 1259, 1260, 1263, 1264, 1265, 1267, 1268, 1274, 1275, 1280, 1283, 1285, 1286, 1290, 1291, 1293, 1294, 1295, 1299, 1300, 1304, 1306, 1307, 1308, 1309, 1310, 1313, 1314, 1315, 1316, 1320, 1321, 1327, 1329, 1334, 1335, 1338, 1339, 1340, 1343, 1345, 1346, 1350, 1352, 1353, 1355, 1356, 1357, 1363, 1364, 1367, 1368, 1372, 1375, 1379, 1381, 1383, 1385, 1386, 1396, 1400, 1401, 1403, 1407, 1408, 1409, 1410, 1411, 1416, 1419, 1420, 1421, 1423, 1428, 1429, 1433, 1435, 1439, 1440, 1443, 1446, 1447, 1450, 1451, 1452, 1453, 1454, 1455, 1456, 1457, 1459, 1460, 1461, 1462, 1464, 1465, 1466, 1470, 1471, 1472, 1475, 1476, 1477, 1478, 1481, 1482, 1484, 1485, 1488, 1489, 1490, 1492, 1493, 1494, 1495, 1496, 1500, 1501, 1503, 1505, 1507, 1508, 1510, 1513, 1515, 1516, 1519, 1522, 1523, 1524, 1525, 1528, 1531, 1532, 1533, 1536, 1538, 1540, 1541, 1544, 1545, 1554, 1557, 1558, 1560, 1564, 1565, 1569, 1570, 1572, 1577, 1579, 1580, 1581, 1582, 1587, 1593, 1596, 1598, 1599, 1600, 1602, 1603, 1604, 1605, 1607, 1609, 1612, 1616, 1617, 1618, 1620, 1621, 1622, 1623, 1629, 1631, 1632, 1634, 1636, 1637, 1639, 1640, 1642, 1644, 1645, 1646, 1647, 1648, 1649, 1659, 1666, 1669, 1670, 1675, 1676, 1688, 1689, 1690, 1692, 1694, 1696, 1697, 1698, 1705, 1707, 1711, 1712, 1714, 1716, 1720, 1723, 1724, 1725, 1732, 1735, 1737, 1738, 1739, 1740, 1742, 1743, 1747, 1748, 1753, 1756, 1759, 1761, 1762, 1767, 1768, 1773, 1774, 1775, 1776, 1779, 1780, 1782, 1783, 1785, 1787, 1788, 1789, 1790, 1795, 1799, 1800, 1801, 1802, 1803, 1804, 1805, 1806, 1807, 1808, 1809, 1810, 1811, 1812, 1814, 1815, 1816, 1817, 1818, 1819, 1820, 1821, 1823, 1824, 1826, 1828, 1830, 1831, 1832, 1833, 1834, 1837, 1838, 1839, 1841, 1842, 1843, 1846, 1848, 1849, 1850, 1852, 1853, 1857, 1863, 1865, 1866, 1867, 1871, 1872, 1874, 1875, 1876, 1878, 1879, 1880, 1881, 1883, 1889, 1890, 1891, 1894, 1895, 1897, 1898, 1899, 1900, 1903, 1911, 1916, 1918, 1922, 1923, 1924, 1925, 1926, 1930, 1931, 1932, 1934, 1937, 1939, 1941, 1945, 1946, 1951, 1952, 1958, 1962, 1963, 1966, 1967, 1970, 1975, 1981, 1982, 1984, 1990, 1991, 1994, 1997, 1998, 1999, 2001, 2003, 2005, 2006, 2009, 2016, 2018, 2019, 2023, 2024, 2027, 2028, 2034, 2040, 2043, 2045, 2046, 2047, 2051, 2056, 2057, 2058, 2060, 2061, 2062, 2066, 2067, 2070, 2071, 2073, 2075, 2077, 2079, 2082, 2083, 2087, 2094, 2097, 2098, 2100, 2107, 2108, 2111, 2112, 2114, 2117, 2120, 2122, 2123, 2125, 2130, 2131, 2132, 2139, 2140, 2142, 2146, 2147, 2149, 2152, 2154, 2155, 2156, 2158, 2160, 2162, 2163, 2164, 2166, 2168, 2169, 2170, 2171, 2172, 2173, 2174, 2176, 2177, 2178, 2179, 2180, 2181, 2182, 2183, 2184, 2185, 2187, 2188, 2189, 2190, 2191, 2192, 2194, 2197, 2198, 2201, 2202, 2204, 2206, 2207, 2208, 2209, 2210, 2211, 2213, 2214, 2216, 2217, 2221, 2222, 2223, 2226, 2228, 2230, 2232, 2233, 2235, 2237, 2241, 2243, 2244, 2249, 2250, 2251, 2255, 2259, 2261, 2265, 2269, 2270, 2271, 2273, 2275, 2276, 2277, 2280, 2288, 2290, 2293, 2294, 2295, 2296, 2297, 2298, 2299, 2300, 2301, 2302, 2304, 2305, 2306, 2309, 2311, 2312, 2313, 2315, 2317, 2320, 2321, 2322, 2327, 2328, 2329, 2330, 2331, 2332, 2333, 2334, 2336, 2337, 2338, 2339, 2340, 2341, 2342, 2344, 2347, 2349, 2350, 2351, 2353, 2354, 2356, 2357, 2358, 2359, 2360, 2362, 2367, 2368, 2369, 2370, 2371, 2373, 2375, 2376, 2378, 2380, 2383, 2384, 2385, 2387, 2389, 2390, 2391, 2392, 2393, 2396, 2399, 2401, 2402, 2403, 2404, 2405, 2407, 2409, 2410, 2411, 2412, 2414, 2419, 2424, 2428, 2430, 2437, 2438, 2439, 2440, 2441, 2443, 2444, 2445, 2460, 2463, 2467, 2469, 2474, 2476, 2479, 2480, 2483, 2484, 2485, 2486, 2487, 2488, 2489, 2490, 2491, 2492, 2494, 2501, 2504, 2505, 2506, 2510, 2513, 2514, 2515, 2516, 2517, 2520, 2522, 2524, 2525, 2526, 2527, 2529, 2531, 2533, 2537, 2538, 2540, 2544, 2546, 2552, 2553, 2557, 2559, 2562, 2563, 2569, 2575, 2581, 2583, 2587, 2590, 2591, 2593, 2594, 2595, 2596, 2597, 2598, 2599, 2600, 2601, 2606, 2607, 2610, 2611, 2613, 2615, 2616, 2617, 2621, 2623, 2625, 2628, 2629, 2631, 2633, 2635, 2636, 2638, 2639, 2642, 2648, 2668, 2671, 2699, 2711, 2715, 2720, 2723, 2724, 2725, 2726, 2729, 2731, 2733, 2735, 2736, 2737, 2739, 2745, 2746, 2747, 2751, 2756, 2757, 2758, 2759, 2760, 2761, 2762, 2763, 2764, 2765, 2766, 2768, 2769, 2770, 2771, 2773, 2775, 2777, 2779, 2783, 2784, 2785, 2786, 2787, 2789, 2790, 2791, 2792, 2793, 2794, 2795, 2796, 2798, 2799, 2805, 2806, 2807, 2808, 2809, 2812, 2817, 2819, 2820, 2822, 2823, 2826, 2827, 2828, 2830, 2831, 2832, 2833, 2834, 2835, 2836, 2837, 2838, 2841, 2844, 2845, 2847, 2851, 2852, 2853, 2854, 2855, 2856, 2857, 2861, 2862, 2863, 2866, 2867, 2868, 2869, 2870, 2871, 2873, 2875, 2877, 2883, 2884, 2886, 2888, 2889, 2890, 2891, 2892, 2894, 2896, 2897, 2898, 2899, 2900, 2904, 2905, 2906, 2910, 2911, 2912, 2914, 2916, 2917, 2918, 2923, 2927, 2930, 2932, 2933, 2934, 2938, 2939, 2940, 2941, 2943, 2944, 2945, 2946, 2949, 2950, 2956, 2957, 2963, 2971, 2974, 2975, 2977, 3101, 3133, 3139, 3163, 3164, 3222, 3227, 3232, 3233, 3240, 3251, 3259, 3263, 3277, 3281, 3284, 3286, 3292, 3298, 3299, 3301, 3310, 3317, 3321, 3322, 3329, 3338, 3339, 3340, 3344, 3350, 3351, 3352, 3354, 3356, 3359, 3360, 3364, 3366, 3370, 3371, 3372, 3375, 3376, 3377, 3379, 3381, 3382, 3383, 3396, 3399, 3400, 3402, 3403, 3406, 3407, 3411, 3424, 3427, 3433, 3434, 3436, 3444, 3446, 3448, 3454, 3455, 3456, 3457, 3462, 3466, 3468, 3481, 3488, 3489, 3491, 3492, 3493, 3494, 3497, 3499, 3502, 3503, 3504, 3507, 3511, 3513, 3520, 3521, 3525, 3526, 3531, 3533, 3535, 3536, 3538, 3541, 3544, 3545, 3546, 3558, 3559, 3563, 3564, 3565, 3569, 3570, 3571, 3572, 3574, 3576, 3577, 3582, 3583, 3584, 3588, 3591, 3592, 3594, 3604, 3606, 3607, 3609, 3611, 3614, 3625, 3626, 3627, 3630, 3631, 3632, 3634, 3636, 3640, 3644, 3645, 3651, 3656, 3658, 3660, 3663, 3668, 3670, 3677, 3678, 3680, 3682, 3684, 3686, 3687, 3689, 3690, 3693, 3700, 3704, 3705, 3706, 3709, 3710, 3711, 3712, 3713, 3717, 3728, 3729, 3730, 3732, 3736, 3738, 3740, 3744, 3749, 3750, 3751, 3752, 3761, 3763, 3764, 3765, 3766, 3767, 3770, 3772, 3776, 3777, 3778, 3779, 3785, 3787, 3789, 3791, 3792, 3794, 3795, 3799, 3801, 3802, 3803, 3806, 3807, 3808, 3809, 3811, 3812, 3813, 3814, 3818, 3819, 3820, 3822, 3825, 3827, 3828, 3829, 3830, 3831, 3832, 3834, 3835, 3836, 3837, 3839, 3841, 3843, 3844, 3846, 3847, 3848, 3849, 3850, 3851, 3852, 3854, 3855, 3856, 3857, 3858, 3859, 3860, 3861, 3862, 3863, 3864, 3866, 3867, 3868, 3869, 3870, 3872, 3874, 3875, 3878, 3879, 3884, 3886, 3887, 3888, 3889, 3890, 3891, 3892, 3893, 3896, 3897, 3900, 3901, 3903, 3904, 3905, 3906, 3907, 3908, 3910, 3912, 3913, 3915, 3917, 3919, 3920, 3922, 3925, 3926, 3928, 3930, 3933, 3935, 3937, 3940, 3941, 3946, 3947, 3948, 3949, 3950, 3952, 3953, 3954, 3956, 3959, 3963, 3964, 3966, 3967, 3969, 3973, 3974, 3975, 3976, 3977, 3979, 3980, 3981, 3982, 3983, 3984, 3986, 3987, 3988, 3990, 3991, 3993, 3994, 3998, 4000, 4001, 4002, 4003, 4004, 4005, 4006, 4012, 4020, 4021, 4022, 4023, 4024, 4028, 4031, 4032, 4037, 4038, 4039, 4041, 4043, 4044, 4045, 4047, 4049, 4056, 4057, 4061, 4063, 4068, 4069, 4072, 4073, 4074, 4077, 4081, 4082, 4090, 4091, 4093, 4097, 4108, 4109, 4120, 4125, 4127, 4128, 4129, 4130, 4131, 4133, 4137, 4138, 4144, 4147, 4148, 4149, 4150, 4151, 4152, 4153, 4157, 4165, 4167, 4170, 4171, 4172, 4173, 4177, 4179, 4186, 4187, 4189, 4190, 4192, 4193, 4194, 4216, 4221, 4222, 4246, 4249, 4267, 4278, 4290, 4292, 4299, 4301, 4303, 4307, 4319, 4322, 4332, 4345, 4376, 4379, 4392, 4393, 4394, 4398, 4399, 4403, 4407, 4419, 4422, 4433, 4435, 4437, 4439, 4440, 4442, 4444, 4445, 4450, 4451, 4455, 4456, 4457, 4459, 4460, 4461, 4466, 4467, 4469, 4471, 4477, 4480, 4482, 4483, 4484, 4485, 4486, 4487, 4488, 4489, 4490, 4491, 4494, 4496, 4497, 4499, 4505, 4517, 4529, 4537, 4544, 4546, 4547, 4555, 4557, 4560, 4561, 4562, 4563, 4575, 4577, 4578, 4579, 4582, 4585, 4587, 4588, 4594, 4598, 4600, 4601, 4606, 4610, 4611, 4614, 4618, 4619, 4620, 4621, 4624, 4632, 4633, 4634, 4637, 4642, 4643, 4644, 4647, 4653, 4654, 4663, 4664, 4667, 4671, 4673, 4677, 4682, 4683, 4685, 4687, 4690, 4691, 4692, 4695, 4696, 4701, 4702, 4703, 4705, 4706, 4708, 4709, 4710, 4711, 4712, 4713, 4715, 4716, 4717, 4719, 4720, 4722, 4724, 4725, 4727, 4729, 4730, 4731, 4732, 4733, 4734, 4736, 4737, 4738, 4739, 4740, 4741, 4742, 4743, 4744, 4746, 4749, 4751, 4753, 4754, 4755, 4757, 4763, 4764, 4767, 4770, 4772, 4773, 4774, 4776, 4778, 4779, 4780, 4784, 4789, 4790, 4791, 4793, 4794, 4796, 4802, 4803, 4805, 4808, 4809, 4810, 4811, 4817, 4818, 4819, 4820, 4821, 4823, 4826, 4829, 4832, 4833, 4835, 4836, 4838, 4840, 4841, 4843, 4844, 4847, 4848, 4851, 4854, 4855, 4856, 4857, 4861, 4862, 4864, 4865, 4868, 4869, 4871, 4872, 4873, 4884, 4887, 4893, 4897, 4906, 4914, 4920, 4921, 4923, 4925, 4929, 4930, 4931, 4932, 4933, 4934, 4937, 4938, 4939, 4943, 4944, 4945, 4946, 4952, 4953, 4956, 4960, 4961, 4962, 4968, 4972, 4973, 4974, 4975, 4977, 4978, 4979, 4986, 4987, 4988, 4989, 4990, 4993, 4994, 4996, 4997, 4999, 5001, 5002, 5003, 5006, 5011, 5012, 5013, 5014, 5016, 5017, 5018, 5019, 5020, 5024, 5025, 5027, 5028, 5031, 5034, 5035, 5038, 5039, 5040, 5043, 5044, 5045, 5046, 5048, 5049, 5056, 5057, 5059, 5062, 5066, 5067, 5068, 5070, 5071, 5072, 5073, 5074, 5075, 5076, 5078, 5079, 5080, 5081, 5082, 5085, 5086, 5087, 5090, 5091, 5092, 5093, 5096, 5097, 5098, 5099, 5102, 5103, 5104, 5107, 5108, 5109, 5110, 5111, 5114, 5117, 5120, 5121, 5122, 5130, 5131, 5132, 5135, 5136, 5137, 5138, 5139, 5140, 5142, 5143, 5145, 5148, 5149, 5150, 5152, 5153, 5156, 5159, 5160, 5162, 5163, 5165, 5166, 5168, 5169, 5171, 5176, 5178, 5179, 5181, 5182, 5183, 5185, 5186, 5187, 5191, 5192, 5194, 5197, 5198, 5200, 5201, 5202, 5203, 5206, 5207, 5208, 5209, 5210, 5213, 5214, 5215, 5219, 5220, 5224, 5225, 5229, 5230, 5233, 5238, 5239, 5240, 5241, 5243, 5245, 5246, 5247, 5248, 5249, 5250, 5251, 5252, 5254, 5256, 5262, 5264, 5265, 5266, 5267, 5268, 5269, 5270, 5272, 5275, 5278, 5279, 5285, 5287, 5288, 5289, 5290, 5291, 5292, 5294, 5295, 5296, 5297, 5298, 5301, 5302, 5304, 5305, 5313, 5316, 5317, 5320, 5321, 5323, 5328, 5329, 5333, 5336, 5337, 5339, 5340, 5343, 5350, 5351, 5352, 5353, 5354, 5355, 5356, 5358, 5359, 5361, 5362, 5366, 5371, 5372, 5376, 5377, 5384, 5385, 5386, 5387, 5388, 5389, 5390, 5391, 5393, 5396, 5398, 5402, 5404, 5405, 5406, 5407, 5408, 5409, 5411, 5414, 5417, 5424, 5428, 5429, 5430, 5431, 5432, 5434, 5439, 5442, 5443, 5446, 5449, 5451, 5452, 5454, 5455, 5456, 5462, 5463, 5465, 5466, 5467, 5468, 5472, 5473, 5474, 5475, 5477, 5482, 5484, 5485, 5486, 5487, 5488, 5489, 5494, 5495, 5496, 5498, 5500, 5502, 5508, 5509, 5510, 5511, 5512, 5513, 5516, 5518, 5519, 5520, 5525, 5526, 5527, 5529, 5533, 5534, 5535, 5536, 5540, 5541, 5543, 5544, 5545, 5549, 5550, 5551, 5552, 5554, 5555, 5556, 5558, 5559, 5560, 5561, 5562, 5568, 5569, 5570, 5571, 5572, 5573, 5575, 5576, 5577, 5578, 5579, 5580, 5581, 5583, 5584, 5586, 5587, 5589, 5591, 5592, 5593, 5594, 5598, 5602, 5603, 5604, 5608, 5609, 5610, 5613, 5614, 5616, 5618, 5620, 5621, 5622, 5623, 5624, 5630, 5631, 5637, 5643, 5646, 5647, 5651, 5652, 5653, 5654, 5655, 5657, 5658, 5659, 5662, 5663, 5664, 5665, 5666, 5667, 5668, 5669, 5670, 5671, 5676, 5677, 5678, 5680, 5681, 5682, 5683, 5684, 5685, 5686, 5690, 5691, 5692, 5693, 5698, 5699, 5701, 5702, 5704, 5705, 5706, 5707, 5708, 5709, 5711, 5712, 5716, 5721, 5723, 5728, 5731, 5734, 5735, 5736, 5737, 5742, 5745, 5747, 5748, 5751, 5752, 5755, 5756, 5757, 5758, 5759, 5760, 5761, 5763, 5764, 5766, 5772, 5774, 5775, 5776, 5780, 5782, 5785, 5788, 5789, 5791, 5798, 5799, 5800, 5801, 5803, 5805, 5808, 5810, 5811, 5813, 5814, 5815, 5816, 5819, 5820, 5822, 5823, 5825, 5827, 5828, 5829, 5830, 5833, 5835, 5837, 5838, 5842, 5843, 5844, 5846, 5847, 5849, 5850, 5851, 5852, 5853, 5855, 5857, 5860, 5861, 5862, 5864, 5866, 5870, 5872, 5874, 5876, 5878, 5881, 5882, 5884, 5891, 5894, 5896, 5901, 5902, 5904, 5905, 5906, 5908, 5913, 5916, 5917, 5918, 5920, 5921, 5924, 5929, 5932, 5933, 5935, 5936, 5937, 5938, 5939, 5944, 5945, 5946, 5947, 5948, 5949, 5950, 5952, 5953, 5954, 5955, 5957, 5962, 5965, 5966, 5967, 5968, 5969, 5970, 5972, 5973, 5974, 5975, 5976, 5977, 5978, 5979, 5983, 5984, 5985, 5987, 5989, 5992, 5993, 5994, 5995, 6001, 6002, 6003, 6004, 6005, 6006, 6008, 6010, 6011, 6013, 6015, 6016, 6018, 6022, 6023, 6024, 6028, 6029, 6032, 6036, 6037, 6041, 6042, 6043, 6044, 6045, 6046, 6051, 6052, 6053, 6055, 6057, 6058, 6059, 6060, 6064, 6065, 6066, 6068, 6069, 6073, 6074, 6075, 6076, 6077, 6079, 6080, 6081, 6083, 6085, 6088, 6089, 6090, 6091, 6093, 6094, 6095, 6096, 6097, 6099, 6100, 6101, 6102, 6103, 6105, 6107, 6108, 6109, 6114, 6115, 6117, 6119, 6120, 6122, 6126, 6127, 6128, 6129, 6130, 6131, 6133, 6135, 6136, 6137, 6140, 6142, 6143, 6144, 6148, 6150, 6151, 6152, 6156, 6157, 6158, 6161, 6162, 6163, 6164, 6165, 6167, 6171, 6172, 6175, 6176, 6179, 6180, 6186, 6187, 6189, 6190, 6194, 6196, 6198, 6200, 6202, 6203, 6204, 6205, 6206, 6207, 6208, 6209, 6211, 6212, 6213, 6214, 6215, 6216, 6217, 6218, 6219, 6220, 6222, 6224, 6225, 6226, 6227, 6230, 6232, 6235, 6237, 6238, 6240, 6241, 6242, 6243, 6244, 6245, 6249, 6250, 6251, 6255, 6256, 6257, 6259, 6260, 6262, 6266, 6269, 6270, 6271, 6273, 6278, 6280, 6281, 6283, 6284, 6288, 6289, 6293, 6294, 6295, 6296, 6297, 6300, 6301, 6305, 6306, 6307, 6308, 6309, 6310, 6314, 6316, 6317, 6318, 6319, 6320, 6322, 6323, 6325, 6326, 6327, 6328, 6333, 6334, 6335, 6336, 6340, 6342, 6344, 6347, 6348, 6350, 6351, 6352, 6355, 6357, 6359, 6360, 6361, 6362, 6363, 6364, 6369, 6370, 6371, 6372, 6373, 6374, 6377, 6378, 6379, 6380, 6382, 6383, 6385, 6386, 6387, 6388, 6389, 6390, 6391, 6392, 6393, 6394, 6395, 6398, 6399, 6401, 6404, 6405, 6408, 6410, 6411, 6414, 6416, 6417, 6418, 6423, 6424, 6425, 6428, 6430, 6431, 6435, 6437, 6439, 6441, 6442, 6443, 6445, 6447, 6448, 6449, 6450, 6457, 6458, 6460, 6461, 6462, 6463, 6467, 6469, 6470, 6471, 6472, 6473, 6475, 6476, 6477, 6478, 6481, 6482, 6484, 6486, 6489, 6491, 6493, 6500, 6501, 6502, 6503, 6504, 6505, 6507, 6508, 6510, 6511, 6514, 6518, 6519, 6520, 6521, 6522, 6523, 6524, 6525, 6526, 6527, 6530, 6536, 6537, 6538, 6539, 6540, 6541, 6542, 6544, 6545, 6547, 6548, 6552, 6553, 6554, 6555, 6556, 6557, 6558, 6562, 6564, 6565, 6567, 6568, 6569, 6571, 6572, 6573, 6575, 6576, 6577, 6578, 6580, 6581, 6582, 6583, 6584, 6585, 6586, 6589, 6590, 6591, 6592, 6593, 6594, 6595, 6596, 6598, 6600, 6601, 6602, 6603, 6604, 6605, 6606, 6607, 6608, 6609, 6610, 6612, 6613, 6614, 6618, 6619, 6620, 6621, 6622, 6625, 6626, 6627, 6628, 6630, 6631, 6635, 6636, 6637, 6640, 6642, 6643, 6644, 6648, 6650, 6653, 6658, 6660, 6661, 6662, 6663, 6664, 6666, 6669, 6670, 6671, 6673, 6677, 6682, 6683, 6685, 6686, 6687, 6688, 6689, 6690, 6693, 6694, 6695, 6696, 6697, 6699, 6701, 6702, 6708, 6710, 6711, 6713, 6715, 6716, 6748, 6753, 6783}",2523,"{0, 1, 2, 3, 4, 5, 6, 7, 8, 9, 10, 11, 12, 13, 14, 15, 16, 17, 18, 20, 21, 22, 23, 24, 25, 27, 28, 29, 30, 31, 32, 33, 34, 35, 36, 37, 38, 39, 42, 43, 44, 45, 46, 47, 48, 49, 50, 51, 52, 53, 54, 55, 56, 57, 58, 59, 60, 61, 62, 64, 65, 66, 67, 68, 69, 70, 71, 72, 73, 74, 75, 78, 79, 80, 81, 83, 84, 85, 86, 88, 89, 90, 91, 92, 93, 94, 95, 96, 97, 98, 99, 100, 101, 102, 103, 104, 105, 106, 107, 108, 109, 110, 111, 112, 113, 114, 115, 116, 117, 118, 123, 124, 125, 126, 127, 128, 129, 130, 131, 132, 133, 134, 135, 136, 137, 138, 139, 140, 141, 143, 144, 145, 146, 147, 148, 149, 150, 151, 153, 154, 155, 156, 158, 159, 160, 161, 162, 163, 164, 165, 166, 167, 168, 169, 171, 172, 175, 176, 179, 180, 181, 182, 183, 184, 185, 186, 187, 188, 189, 190, 191, 192, 193, 194, 195, 196, 198, 199, 200, 201, 202, 203, 204, 205, 206, 207, 208, 209, 210, 211, 212, 213, 214, 215, 216, 217, 218, 219, 220, 221, 222, 223, 224, 225, 226, 227, 228, 229, 230, 231, 232, 234, 235, 236, 237, 238, 239, 240, 241, 242, 243, 244, 245, 246, 247, 248, 249, 250, 251, 252, 253, 254, 256, 257, 258, 259, 260, 261, 262, 263, 264, 265, 266, 267, 268, 269, 271, 272, 273, 274, 275, 276, 277, 278, 279, 280, 281, 282, 283, 284, 285, 286, 287, 288, 289, 290, 291, 292, 293, 294, 295, 296, 297, 298, 300, 301, 302, 303, 305, 307, 310, 311, 312, 313, 314, 315, 316, 317, 318, 321, 322, 323, 324, 325, 326, 327, 331, 332, 333, 334, 335, 336, 337, 338, 339, 340, 341, 342, 343, 344, 345, 346, 348, 349, 350, 351, 352, 353, 356, 357, 358, 359, 360, 361, 362, 363, 364, 365, 366, 367, 368, 369, 370, 372, 373, 375, 376, 377, 378, 379, 380, 382, 383, 384, 385, 386, 387, 388, 389, 390, 391, 392, 393, 394, 395, 396, 397, 398, 399, 400, 401, 402, 403, 404, 405, 406, 407, 408, 409, 410, 411, 414, 415, 416, 417, 418, 419, 420, 421, 422, 423, 424, 425, 426, 427, 428, 429, 430, 431, 433, 434, 435, 436, 437, 438, 439, 440, 441, 443, 444, 445, 446, 447, 449, 450, 451, 452, 453, 454, 456, 457, 458, 459, 460, 461, 462, 463, 464, 465, 466, 467, 468, 469, 470, 471, 472, 473, 474, 475, 476, 477, 478, 479, 481, 482, 483, 484, 486, 487, 488, 489, 490, 491, 492, 493, 494, 495, 496, 497, 498, 499, 500, 501, 502, 503, 504, 505, 506, 507, 508, 509, 510, 511, 512, 513, 514, 515, 516, 518, 519, 520, 521, 522, 523, 524, 525, 526, 527, 528, 530, 531, 532, 533, 534, 535, 536, 537, 538, 539, 540, 541, 542, 543, 544, 545, 546, 547, 548, 549, 550, 551, 552, 553, 554, 555, 556, 557, 558, 559, 560, 561, 562, 563, 564, 565, 566, 567, 568, 569, 570, 571, 572, 573, 574, 575, 576, 577, 578, 580, 582, 583, 584, 585, 586, 590, 591, 592, 593, 594, 596, 597, 598, 599, 600, 601, 602, 603, 604, 605, 606, 607, 608, 609, 610, 611, 612, 613, 614, 616, 617, 618, 620, 621, 622, 623, 624, 625, 626, 627, 628, 629, 631, 632, 633, 634, 635, 636, 637, 638, 639, 640, 641, 642, 643, 644, 645, 646, 647, 648, 649, 650, 651, 652, 653, 654, 655, 656, 657, 658, 659, 660, 661, 662, 663, 664, 665, 666, 667, 668, 669, 670, 671, 672, 673, 674, 675, 676, 677, 678, 679, 680, 681, 682, 683, 684, 685, 686, 687, 688, 689, 690, 693, 695, 696, 697, 698, 699, 700, 701, 702, 703, 704, 705, 706, 707, 708, 709, 710, 711, 712, 713, 714, 715, 716, 717, 718, 719, 720, 721, 722, 723, 724, 725, 726, 727, 728, 729, 730, 731, 732, 733, 734, 735, 736, 737, 738, 739, 740, 741, 742, 743, 744, 745, 746, 748, 749, 750, 751, 752, 753, 754, 755, 756, 757, 758, 759, 760, 761, 762, 763, 764, 765, 766, 767, 768, 769, 770, 771, 773, 774, 775, 776, 777, 778, 779, 780, 781, 782, 783, 784, 785, 786, 787, 788, 789, 790, 791, 792, 794, 795, 796, 797, 798, 799, 800, 801, 802, 803, 804, 805, 806, 807, 808, 809, 810, 811, 812, 813, 814, 815, 816, 817, 819, 820, 821, 824, 825, 826, 828, 829, 830, 831, 832, 833, 834, 835, 836, 837, 838, 839, 840, 841, 842, 843, 844, 845, 846, 847, 848, 849, 850, 851, 852, 854, 855, 856, 857, 858, 859, 860, 861, 862, 864, 865, 866, 867, 868, 869, 870, 871, 872, 873, 874, 875, 876, 877, 878, 879, 880, 881, 882, 883, 884, 885, 886, 887, 888, 889, 890, 891, 892, 893, 894, 895, 896, 897, 898, 899, 900, 901, 902, 903, 904, 905, 906, 907, 908, 909, 910, 911, 912, 913, 914, 915, 916, 917, 918, 919, 920, 921, 922, 923, 924, 925, 926, 927, 928, 929, 930, 931, 932, 933, 935, 936, 937, 939, 940, 941, 942, 943, 944, 945, 946, 947, 948, 949, 950, 951, 952, 953, 954, 955, 956, 957, 958, 959, 960, 961, 962, 963, 964, 965, 966, 967, 968, 969, 970, 971, 972, 973, 974, 975, 976, 977, 978, 979, 980, 981, 982, 983, 984, 985, 986, 987, 988, 990, 991, 992, 993, 994, 996, 997, 998, 999, 1000, 1001, 1002, 1003, 1004, 1005, 1006, 1007, 1008, 1009, 1010, 1011, 1012, 1013, 1014, 1015, 1016, 1017, 1018, 1019, 1020, 1021, 1022, 1023, 1024, 1025, 1026, 1028, 1029, 1030, 1031, 1032, 1033, 1034, 1036, 1037, 1038, 1039, 1040, 1041, 1042, 1043, 1044, 1045, 1046, 1047, 1048, 1050, 1051, 1052, 1053, 1054, 1055, 1056, 1057, 1058, 1059, 1060, 1061, 1063, 1064, 1065, 1066, 1067, 1069, 1070, 1071, 1072, 1073, 1074, 1075, 1076, 1077, 1079, 1080, 1082, 1083, 1085, 1086, 1087, 1088, 1089, 1090, 1092, 1093, 1095, 1096, 1097, 1098, 1099, 1100, 1101, 1103, 1104, 1105, 1106, 1107, 1108, 1109, 1110, 1111, 1112, 1114, 1115, 1116, 1117, 1118, 1119, 1120, 1122, 1123, 1124, 1125, 1126, 1127, 1128, 1129, 1130, 1131, 1134, 1135, 1136, 1137, 1138, 1142, 1144, 1148, 1149, 1151, 1153, 1155, 1156, 1157, 1158, 1161, 1162, 1163, 1164, 1165, 1169, 1171, 1172, 1173, 1176, 1177, 1179, 1181, 1182, 1185, 1186, 1190, 1193, 1194, 1203, 1204, 1207, 1210, 1211, 1212, 1213, 1214, 1217, 1218, 1219, 1220, 1221, 1223, 1224, 1226, 1228, 1229, 1231, 1233, 1242, 1243, 1248, 1254, 1255, 1262, 1269, 1270, 1271, 1272, 1273, 1276, 1277, 1278, 1279, 1281, 1282, 1284, 1287, 1288, 1289, 1292, 1297, 1298, 1301, 1302, 1303, 1305, 1311, 1317, 1318, 1323, 1324, 1325, 1326, 1328, 1330, 1331, 1332, 1333, 1336, 1337, 1342, 1344, 1347, 1348, 1349, 1351, 1354, 1358, 1359, 1360, 1361, 1362, 1365, 1366, 1369, 1370, 1371, 1373, 1374, 1376, 1377, 1378, 1380, 1382, 1384, 1387, 1388, 1389, 1390, 1391, 1392, 1393, 1394, 1395, 1397, 1399, 1402, 1404, 1405, 1406, 1412, 1413, 1414, 1415, 1418, 1422, 1424, 1426, 1427, 1430, 1431, 1432, 1434, 1436, 1437, 1441, 1442, 1445, 1448, 1449, 1458, 1467, 1468, 1469, 1473, 1474, 1479, 1483, 1487, 1491, 1499, 1502, 1504, 1506, 1509, 1511, 1512, 1514, 1517, 1518, 1520, 1521, 1526, 1527, 1529, 1530, 1534, 1535, 1539, 1542, 1543, 1546, 1548, 1549, 1550, 1551, 1552, 1553, 1556, 1559, 1561, 1562, 1563, 1566, 1567, 1568, 1571, 1573, 1574, 1575, 1576, 1578, 1583, 1584, 1585, 1586, 1588, 1589, 1590, 1591, 1592, 1594, 1595, 1597, 1601, 1606, 1608, 1610, 1613, 1614, 1615, 1619, 1624, 1625, 1626, 1627, 1628, 1630, 1633, 1635, 1638, 1641, 1643, 1650, 1651, 1652, 1653, 1654, 1655, 1656, 1657, 1658, 1660, 1661, 1662, 1663, 1664, 1665, 1667, 1668, 1671, 1672, 1673, 1674, 1678, 1679, 1680, 1681, 1682, 1683, 1684, 1685, 1686, 1687, 1691, 1693, 1695, 1699, 1700, 1701, 1702, 1703, 1704, 1706, 1708, 1709, 1710, 1713, 1715, 1717, 1718, 1719, 1721, 1722, 1726, 1727, 1728, 1729, 1730, 1731, 1734, 1736, 1741, 1744, 1745, 1746, 1749, 1752, 1754, 1755, 1757, 1758, 1760, 1764, 1765, 1766, 1769, 1770, 1771, 1772, 1778, 1781, 1784, 1786, 1791, 1792, 1793, 1796, 1797, 1798, 1813, 1822, 1825, 1827, 1829, 1835, 1836, 1840, 1844, 1845, 1847, 1851, 1854, 1855, 1858, 1859, 1860, 1861, 1862, 1864, 1868, 1869, 1870, 1873, 1877, 1882, 1884, 1885, 1886, 1887, 1888, 1892, 1893, 1896, 1901, 1902, 1904, 1905, 1907, 1908, 1909, 1910, 1912, 1914, 1915, 1919, 1920, 1921, 1927, 1928, 1929, 1936, 1938, 1940, 1942, 1943, 1944, 1947, 1948, 1949, 1950, 1954, 1955, 1956, 1957, 1959, 1960, 1961, 1964, 1965, 1968, 1969, 1971, 1972, 1973, 1974, 1976, 1977, 1978, 1979, 1980, 1983, 1985, 1986, 1987, 1988, 1992, 1993, 1995, 1996, 2000, 2002, 2004, 2007, 2008, 2010, 2011, 2012, 2014, 2015, 2017, 2020, 2021, 2022, 2025, 2026, 2029, 2030, 2031, 2032, 2033, 2035, 2036, 2037, 2038, 2039, 2041, 2042, 2044, 2048, 2049, 2050, 2052, 2053, 2055, 2059, 2063, 2064, 2065, 2068, 2069, 2074, 2076, 2080, 2081, 2084, 2085, 2086, 2088, 2089, 2090, 2091, 2092, 2095, 2096, 2099, 2101, 2102, 2103, 2104, 2106, 2109, 2110, 2113, 2115, 2116, 2118, 2119, 2121, 2124, 2126, 2128, 2129, 2133, 2134, 2135, 2137, 2138, 2141, 2143, 2144, 2148, 2150, 2151, 2153, 2157, 2159, 2161, 2167, 2175, 2186, 2193, 2195, 2196, 2200, 2203, 2205, 2212, 2215, 2218, 2219, 2220, 2224, 2225, 2229, 2231, 2234, 2236, 2239, 2240, 2242, 2245, 2246, 2247, 2248, 2252, 2253, 2254, 2260, 2262, 2263, 2264, 2266, 2267, 2268, 2272, 2274, 2281, 2282, 2283, 2284, 2285, 2287, 2289, 2291, 2292, 2303, 2307, 2310, 2316, 2318, 2319, 2323, 2324, 2325, 2335, 2345, 2346, 2348, 2352, 2355, 2361, 2363, 2364, 2365, 2366, 2374, 2377, 2379, 2381, 2382, 2386, 2388, 2394, 2395, 2397, 2398, 2406, 2408, 2413, 2415, 2416, 2420, 2421, 2422, 2423, 2425, 2426, 2427, 2429, 2431, 2432, 2433, 2434, 2435, 2436, 2442, 2446, 2448, 2449, 2450, 2452, 2453, 2454, 2455, 2456, 2457, 2458, 2459, 2461, 2462, 2464, 2465, 2466, 2470, 2471, 2472, 2473, 2475, 2477, 2478, 2481, 2482, 2495, 2496, 2497, 2499, 2500, 2503, 2508, 2509, 2511, 2512, 2518, 2519, 2521, 2523, 2528, 2530, 2532, 2534, 2535, 2536, 2541, 2542, 2543, 2547, 2548, 2549, 2550, 2551, 2554, 2555, 2556, 2558, 2560, 2561, 2564, 2566, 2567, 2568, 2570, 2572, 2574, 2576, 2577, 2578, 2579, 2580, 2582, 2584, 2585, 2586, 2592, 2603, 2604, 2605, 2608, 2609, 2612, 2614, 2620, 2622, 2624, 2626, 2627, 2630, 2632, 2637, 2640, 2641, 2643, 2644, 2645, 2646, 2647, 2649, 2650, 2652, 2653, 2654, 2655, 2656, 2657, 2658, 2659, 2660, 2662, 2664, 2666, 2667, 2669, 2672, 2673, 2674, 2677, 2679, 2680, 2681, 2682, 2683, 2684, 2685, 2686, 2687, 2688, 2689, 2690, 2691, 2692, 2693, 2694, 2695, 2696, 2697, 2698, 2700, 2701, 2703, 2704, 2705, 2706, 2707, 2708, 2709, 2710, 2712, 2713, 2716, 2717, 2718, 2721, 2727, 2728, 2730, 2732, 2734, 2738, 2740, 2741, 2744, 2748, 2749, 2750, 2753, 2754, 2755, 2772, 2774, 2776, 2780, 2782, 2797, 2800, 2801, 2802, 2803, 2804, 2811, 2813, 2814, 2815, 2816, 2818, 2821, 2825, 2839, 2840, 2842, 2843, 2846, 2848, 2849, 2850, 2858, 2859, 2860, 2865, 2872, 2874, 2878, 2880, 2887, 2893, 2895, 2901, 2902, 2903, 2907, 2908, 2909, 2915, 2919, 2920, 2921, 2924, 2925, 2926, 2931, 2935, 2937, 2942, 2947, 2951, 2952, 2953, 2955, 2959, 2960, 2961, 2962, 2965, 2966, 2967, 2968, 2969, 2970, 2972, 2973, 2976, 2978, 2979, 2980, 2981, 2982, 2983, 2984, 2985, 2986, 2987, 2988, 2989, 2990, 2991, 2992, 2993, 2994, 2995, 2996, 2997, 2998, 2999, 3000, 3001, 3002, 3003, 3004, 3005, 3006, 3007, 3008, 3009, 3010, 3011, 3012, 3014, 3015, 3016, 3017, 3018, 3019, 3020, 3022, 3023, 3024, 3025, 3026, 3027, 3028, 3029, 3030, 3031, 3032, 3033, 3034, 3035, 3036, 3037, 3038, 3039, 3040, 3042, 3043, 3044, 3045, 3046, 3047, 3048, 3049, 3050, 3051, 3052, 3053, 3054, 3055, 3057, 3058, 3059, 3060, 3061, 3062, 3063, 3064, 3065, 3066, 3067, 3068, 3070, 3071, 3072, 3073, 3074, 3075, 3076, 3077, 3079, 3080, 3081, 3082, 3083, 3084, 3086, 3087, 3088, 3089, 3090, 3091, 3093, 3094, 3095, 3096, 3097, 3098, 3099, 3100, 3102, 3103, 3104, 3105, 3106, 3107, 3108, 3109, 3110, 3111, 3112, 3113, 3114, 3115, 3116, 3118, 3119, 3120, 3121, 3122, 3123, 3124, 3125, 3126, 3127, 3128, 3131, 3132, 3134, 3135, 3136, 3137, 3138, 3141, 3142, 3143, 3144, 3146, 3147, 3149, 3150, 3151, 3152, 3153, 3155, 3156, 3157, 3158, 3159, 3160, 3162, 3165, 3166, 3167, 3169, 3170, 3171, 3172, 3173, 3174, 3175, 3176, 3177, 3178, 3179, 3180, 3181, 3182, 3183, 3184, 3185, 3186, 3187, 3188, 3189, 3190, 3191, 3192, 3193, 3194, 3195, 3196, 3197, 3198, 3199, 3200, 3201, 3202, 3203, 3204, 3205, 3206, 3207, 3208, 3209, 3210, 3211, 3212, 3213, 3214, 3215, 3216, 3217, 3218, 3219, 3223, 3224, 3225, 3226, 3228, 3229, 3231, 3234, 3236, 3241, 3242, 3243, 3244, 3245, 3247, 3248, 3249, 3250, 3252, 3253, 3254, 3255, 3256, 3257, 3258, 3260, 3261, 3262, 3265, 3269, 3270, 3271, 3272, 3273, 3276, 3279, 3280, 3282, 3283, 3285, 3287, 3288, 3289, 3291, 3293, 3294, 3295, 3296, 3300, 3302, 3303, 3304, 3305, 3306, 3307, 3311, 3312, 3313, 3314, 3316, 3318, 3319, 3320, 3323, 3325, 3326, 3327, 3328, 3330, 3331, 3332, 3333, 3334, 3335, 3337, 3341, 3342, 3343, 3345, 3346, 3347, 3349, 3353, 3355, 3357, 3358, 3362, 3363, 3367, 3368, 3369, 3373, 3374, 3378, 3380, 3384, 3386, 3387, 3388, 3389, 3390, 3391, 3392, 3393, 3394, 3397, 3398, 3401, 3404, 3405, 3408, 3410, 3412, 3413, 3414, 3415, 3416, 3417, 3418, 3419, 3421, 3422, 3423, 3426, 3428, 3429, 3430, 3431, 3432, 3435, 3437, 3438, 3439, 3440, 3441, 3442, 3443, 3445, 3447, 3449, 3450, 3451, 3452, 3453, 3459, 3460, 3461, 3465, 3467, 3469, 3470, 3471, 3472, 3473, 3474, 3476, 3477, 3480, 3482, 3483, 3484, 3485, 3486, 3487, 3490, 3495, 3498, 3500, 3501, 3505, 3506, 3509, 3510, 3512, 3514, 3515, 3516, 3519, 3522, 3523, 3527, 3528, 3529, 3530, 3532, 3534, 3539, 3540, 3542, 3543, 3547, 3548, 3549, 3550, 3551, 3552, 3553, 3554, 3556, 3557, 3562, 3566, 3567, 3568, 3573, 3575, 3578, 3580, 3581, 3585, 3586, 3589, 3593, 3595, 3596, 3598, 3599, 3600, 3601, 3602, 3603, 3605, 3608, 3610, 3612, 3613, 3615, 3616, 3617, 3618, 3620, 3621, 3622, 3623, 3624, 3628, 3629, 3633, 3635, 3637, 3638, 3639, 3642, 3646, 3647, 3648, 3649, 3650, 3652, 3653, 3655, 3657, 3661, 3662, 3664, 3665, 3666, 3667, 3669, 3671, 3672, 3673, 3674, 3675, 3676, 3679, 3681, 3683, 3685, 3688, 3691, 3692, 3694, 3696, 3697, 3698, 3699, 3701, 3702, 3703, 3707, 3708, 3716, 3718, 3719, 3721, 3722, 3724, 3731, 3733, 3734, 3735, 3737, 3739, 3743, 3748, 3753, 3754, 3756, 3757, 3758, 3759, 3760, 3762, 3768, 3769, 3773, 3774, 3775, 3781, 3782, 3783, 3784, 3786, 3788, 3790, 3793, 3796, 3797, 3798, 3800, 3804, 3805, 3810, 3815, 3817, 3821, 3823, 3826, 3833, 3838, 3840, 3845, 3853, 3871, 3873, 3877, 3880, 3894, 3895, 3898, 3899, 3902, 3918, 3921, 3923, 3924, 3927, 3929, 3932, 3934, 3936, 3938, 3939, 3943, 3944, 3945, 3951, 3955, 3957, 3958, 3960, 3962, 3965, 3972, 3978, 3985, 3989, 3992, 3995, 3996, 3997, 3999, 4007, 4008, 4009, 4010, 4011, 4013, 4014, 4016, 4017, 4018, 4019, 4025, 4026, 4027, 4029, 4030, 4033, 4034, 4040, 4042, 4046, 4050, 4053, 4054, 4055, 4058, 4059, 4060, 4062, 4067, 4070, 4071, 4075, 4076, 4078, 4079, 4080, 4083, 4084, 4085, 4086, 4087, 4088, 4089, 4092, 4094, 4095, 4096, 4098, 4099, 4100, 4101, 4102, 4103, 4104, 4105, 4106, 4107, 4111, 4112, 4113, 4114, 4115, 4116, 4117, 4118, 4119, 4121, 4122, 4123, 4124, 4126, 4132, 4134, 4135, 4136, 4139, 4140, 4141, 4142, 4143, 4145, 4154, 4155, 4156, 4158, 4159, 4160, 4161, 4163, 4164, 4166, 4168, 4169, 4174, 4175, 4176, 4178, 4181, 4182, 4183, 4184, 4185, 4188, 4191, 4195, 4196, 4197, 4198, 4200, 4201, 4202, 4203, 4204, 4205, 4206, 4207, 4208, 4209, 4210, 4211, 4212, 4213, 4214, 4215, 4217, 4218, 4219, 4223, 4224, 4225, 4226, 4227, 4228, 4229, 4230, 4231, 4232, 4233, 4234, 4235, 4237, 4238, 4239, 4240, 4241, 4242, 4243, 4244, 4245, 4247, 4248, 4250, 4251, 4252, 4253, 4254, 4255, 4256, 4257, 4258, 4259, 4260, 4261, 4262, 4263, 4264, 4265, 4266, 4269, 4270, 4271, 4272, 4273, 4275, 4276, 4277, 4279, 4280, 4281, 4282, 4283, 4284, 4286, 4287, 4288, 4289, 4293, 4294, 4295, 4297, 4298, 4300, 4302, 4304, 4305, 4306, 4308, 4309, 4310, 4311, 4312, 4313, 4314, 4315, 4316, 4317, 4318, 4320, 4321, 4323, 4325, 4326, 4327, 4328, 4329, 4330, 4331, 4333, 4334, 4335, 4336, 4337, 4339, 4340, 4341, 4342, 4343, 4344, 4346, 4347, 4348, 4349, 4350, 4351, 4352, 4353, 4354, 4356, 4357, 4358, 4359, 4361, 4362, 4363, 4364, 4365, 4366, 4367, 4368, 4369, 4370, 4371, 4372, 4373, 4374, 4375, 4377, 4378, 4380, 4381, 4382, 4383, 4384, 4385, 4386, 4387, 4388, 4389, 4390, 4391, 4395, 4396, 4397, 4400, 4401, 4402, 4404, 4405, 4406, 4408, 4409, 4410, 4411, 4412, 4413, 4414, 4415, 4416, 4417, 4418, 4420, 4421, 4423, 4424, 4425, 4426, 4427, 4428, 4429, 4430, 4432, 4434, 4436, 4438, 4441, 4443, 4446, 4447, 4448, 4449, 4452, 4453, 4458, 4463, 4465, 4468, 4472, 4473, 4474, 4478, 4479, 4481, 4492, 4493, 4495, 4498, 4500, 4501, 4502, 4503, 4504, 4506, 4507, 4508, 4509, 4510, 4511, 4512, 4513, 4514, 4515, 4516, 4518, 4519, 4520, 4521, 4522, 4523, 4524, 4525, 4526, 4527, 4528, 4530, 4531, 4532, 4533, 4534, 4535, 4536, 4538, 4539, 4540, 4541, 4542, 4543, 4545, 4548, 4549, 4551, 4552, 4553, 4554, 4556, 4558, 4559, 4564, 4565, 4566, 4567, 4568, 4569, 4570, 4571, 4572, 4573, 4574, 4576, 4580, 4581, 4583, 4584, 4586, 4589, 4590, 4591, 4593, 4595, 4596, 4597, 4599, 4602, 4603, 4604, 4605, 4607, 4608, 4612, 4613, 4615, 4616, 4622, 4623, 4625, 4626, 4627, 4628, 4629, 4630, 4635, 4636, 4639, 4640, 4641, 4645, 4646, 4648, 4650, 4651, 4652, 4655, 4656, 4657, 4658, 4659, 4660, 4661, 4662, 4665, 4666, 4668, 4669, 4670, 4672, 4674, 4675, 4676, 4678, 4679, 4680, 4681, 4684, 4686, 4688, 4689, 4693, 4694, 4697, 4698, 4699, 4700, 4704, 4707, 4714, 4718, 4723, 4726, 4728, 4735, 4745, 4747, 4748, 4750, 4752, 4756, 4758, 4759, 4760, 4761, 4762, 4765, 4768, 4771, 4775, 4777, 4781, 4783, 4785, 4788, 4792, 4795, 4797, 4798, 4799, 4800, 4801, 4804, 4806, 4807, 4813, 4814, 4815, 4816, 4822, 4827, 4828, 4831, 4834, 4837, 4839, 4842, 4845, 4846, 4849, 4850, 4852, 4853, 4858, 4859, 4860, 4863, 4866, 4867, 4874, 4875, 4876, 4877, 4878, 4879, 4880, 4881, 4882, 4883, 4885, 4888, 4889, 4890, 4891, 4892, 4894, 4895, 4898, 4899, 4900, 4901, 4902, 4903, 4904, 4905, 4907, 4908, 4909, 4910, 4911, 4912, 4915, 4916, 4917, 4918, 4919, 4922, 4926, 4927, 4928, 4935, 4936, 4940, 4942, 4947, 4948, 4949, 4950, 4951, 4954, 4955, 4957, 4958, 4959, 4963, 4964, 4965, 4967, 4969, 4970, 4971, 4980, 4981, 4982, 4983, 4984, 4991, 4995, 4998, 5000, 5004, 5005, 5007, 5009, 5010, 5015, 5021, 5022, 5023, 5026, 5029, 5032, 5033, 5036, 5037, 5041, 5042, 5047, 5050, 5051, 5052, 5053, 5055, 5058, 5060, 5061, 5063, 5064, 5065, 5069, 5077, 5083, 5084, 5095, 5100, 5101, 5105, 5106, 5112, 5113, 5115, 5116, 5118, 5119, 5123, 5124, 5125, 5126, 5127, 5128, 5129, 5133, 5134, 5141, 5144, 5151, 5155, 5157, 5158, 5161, 5164, 5167, 5170, 5172, 5174, 5175, 5188, 5190, 5193, 5195, 5196, 5199, 5204, 5205, 5211, 5212, 5216, 5217, 5218, 5221, 5226, 5231, 5232, 5236, 5237, 5242, 5253, 5257, 5258, 5259, 5260, 5261, 5263, 5271, 5273, 5274, 5276, 5277, 5280, 5281, 5282, 5283, 5284, 5286, 5299, 5300, 5303, 5306, 5307, 5308, 5309, 5310, 5311, 5312, 5314, 5315, 5319, 5324, 5325, 5326, 5327, 5330, 5331, 5334, 5335, 5338, 5341, 5342, 5344, 5345, 5346, 5347, 5348, 5357, 5363, 5364, 5365, 5367, 5368, 5369, 5370, 5373, 5375, 5378, 5379, 5380, 5381, 5383, 5392, 5394, 5397, 5399, 5400, 5401, 5403, 5410, 5412, 5413, 5416, 5418, 5419, 5420, 5422, 5423, 5425, 5426, 5427, 5433, 5435, 5437, 5438, 5440, 5441, 5444, 5445, 5447, 5448, 5450, 5453, 5457, 5458, 5459, 5460, 5461, 5464, 5469, 5470, 5471, 5476, 5478, 5479, 5480, 5481, 5483, 5490, 5491, 5492, 5493, 5497, 5499, 5501, 5503, 5504, 5505, 5506, 5507, 5514, 5515, 5517, 5521, 5522, 5523, 5524, 5530, 5531, 5532, 5537, 5538, 5539, 5542, 5547, 5548, 5557, 5563, 5564, 5565, 5566, 5567, 5574, 5582, 5585, 5588, 5590, 5595, 5596, 5597, 5600, 5601, 5605, 5606, 5607, 5612, 5615, 5617, 5625, 5626, 5627, 5628, 5629, 5633, 5634, 5635, 5636, 5639, 5640, 5642, 5645, 5648, 5649, 5650, 5656, 5660, 5661, 5672, 5673, 5674, 5679, 5688, 5689, 5694, 5695, 5696, 5697, 5700, 5703, 5713, 5714, 5717, 5718, 5720, 5722, 5724, 5726, 5729, 5730, 5732, 5733, 5739, 5740, 5741, 5743, 5744, 5746, 5749, 5753, 5754, 5762, 5765, 5767, 5768, 5769, 5771, 5773, 5777, 5778, 5779, 5781, 5783, 5784, 5786, 5787, 5792, 5793, 5794, 5795, 5796, 5797, 5802, 5804, 5806, 5809, 5817, 5821, 5826, 5831, 5832, 5834, 5836, 5839, 5840, 5841, 5848, 5854, 5856, 5858, 5859, 5863, 5865, 5868, 5869, 5871, 5875, 5877, 5880, 5883, 5886, 5887, 5888, 5889, 5890, 5892, 5893, 5895, 5897, 5898, 5899, 5900, 5903, 5907, 5909, 5910, 5912, 5914, 5915, 5919, 5922, 5925, 5926, 5927, 5928, 5934, 5940, 5942, 5943, 5956, 5960, 5963, 5971, 5980, 5981, 5986, 5988, 5990, 5991, 5996, 5997, 5998, 5999, 6000, 6007, 6009, 6012, 6017, 6019, 6021, 6025, 6027, 6030, 6031, 6034, 6040, 6047, 6048, 6049, 6056, 6061, 6063, 6067, 6070, 6071, 6072, 6078, 6084, 6086, 6087, 6092, 6104, 6106, 6111, 6112, 6113, 6116, 6118, 6121, 6123, 6124, 6132, 6134, 6139, 6141, 6145, 6146, 6147, 6149, 6153, 6154, 6155, 6159, 6160, 6166, 6168, 6169, 6170, 6173, 6174, 6178, 6181, 6182, 6183, 6184, 6185, 6191, 6192, 6193, 6195, 6197, 6201, 6210, 6221, 6223, 6228, 6229, 6231, 6233, 6234, 6236, 6239, 6246, 6247, 6248, 6252, 6253, 6254, 6258, 6261, 6263, 6264, 6265, 6267, 6272, 6274, 6275, 6276, 6277, 6279, 6282, 6285, 6286, 6287, 6290, 6291, 6292, 6298, 6302, 6303, 6304, 6311, 6313, 6315, 6321, 6324, 6329, 6330, 6331, 6332, 6338, 6339, 6341, 6343, 6345, 6346, 6349, 6353, 6354, 6356, 6358, 6375, 6376, 6381, 6384, 6396, 6402, 6407, 6412, 6413, 6415, 6419, 6420, 6421, 6422, 6426, 6427, 6429, 6433, 6434, 6436, 6438, 6440, 6444, 6446, 6452, 6453, 6454, 6455, 6464, 6466, 6468, 6474, 6479, 6483, 6485, 6487, 6488, 6492, 6494, 6495, 6496, 6497, 6498, 6499, 6506, 6509, 6512, 6513, 6515, 6516, 6517, 6528, 6529, 6531, 6532, 6533, 6534, 6535, 6543, 6559, 6560, 6561, 6563, 6566, 6570, 6579, 6587, 6597, 6611, 6615, 6616, 6617, 6623, 6624, 6629, 6632, 6633, 6634, 6639, 6641, 6645, 6646, 6647, 6649, 6651, 6652, 6654, 6655, 6656, 6657, 6659, 6665, 6667, 6668, 6672, 6675, 6676, 6678, 6679, 6680, 6681, 6684, 6691, 6692, 6698, 6700, 6703, 6704, 6705, 6706, 6707, 6709, 6712, 6714, 6717, 6718, 6719, 6720, 6721, 6722, 6723, 6724, 6725, 6726, 6727, 6728, 6729, 6730, 6731, 6732, 6733, 6734, 6735, 6736, 6737, 6738, 6739, 6740, 6741, 6742, 6743, 6744, 6745, 6747, 6750, 6751, 6752, 6754, 6755, 6756, 6757, 6758, 6759, 6760, 6762, 6764, 6765, 6766, 6767, 6768, 6769, 6770, 6771, 6772, 6773, 6774, 6775, 6776, 6777, 6778, 6779, 6780, 6781, 6782, 6784, 6785, 6786, 6787, 6788, 6789, 6790, 6791, 6792, 6793}",3777
16,"(('batch', ('Request For Payment APPROVED by ADMINISTRATION', 'Request For Payment APPROVED by BUDGET OWNER')),)",1,62,"{1081, 1086, 1087, 1110, 1111, 1113, 1119, 1132, 1133, 1139, 1141, 1143, 1144, 1146, 1154, 1157, 1159, 1166, 1168, 1173, 1174, 1175, 1178, 1189, 1191, 1192, 1193, 1194, 1195, 1202, 1206, 1211, 1212, 1217, 1220, 1224, 1226, 1227, 1232, 1235, 1236, 1243, 1245, 1248, 1249, 1251, 1252, 1253, 1258, 1259, 1260, 1262, 1264, 1267, 1269, 1270, 1271, 1278, 1279, 1283, 1286, 1288, 1289, 1292, 1293, 1295, 1296, 1298, 1299, 1303, 1306, 1316, 1317, 1326, 1329, 1333, 1337, 1339, 1340, 1343, 1344, 1348, 1350, 1351, 1352, 1354, 1355, 1356, 1358, 1359, 1361, 1362, 1364, 1366, 1371, 1372, 1375, 1376, 1381, 1383, 1384, 1394, 1399, 1400, 1403, 1407, 1408, 1411, 1412, 1416, 1418, 1419, 1422, 1426, 1427, 1428, 1433, 1436, 1437, 1445, 1447, 1449, 1451, 1463, 1465, 1466, 1474, 1475, 1479, 1481, 1482, 1488, 1492, 1494, 1500, 1506, 1514, 1517, 1519, 1525, 1527, 1529, 1534, 1535, 1539, 1541, 1548, 1550, 1557, 1559, 1561, 1564, 1570, 1571, 1572, 1575, 1576, 1577, 1585, 1586, 1590, 1599, 1600, 1603, 1608, 1609, 1613, 1615, 1616, 1617, 1618, 1623, 1626, 1631, 1632, 1634, 1635, 1636, 1638, 1641, 1649, 1650, 1651, 1652, 1653, 1654, 1656, 1657, 1659, 1660, 1664, 1668, 1672, 1673, 1675, 1676, 1679, 1680, 1684, 1685, 1686, 1688, 1689, 1690, 1692, 1695, 1696, 1697, 1698, 1703, 1705, 1711, 1719, 1720, 1721, 1722, 1723, 1724, 1725, 1729, 1734, 1735, 1738, 1740, 1741, 1742, 1747, 1749, 1755, 1759, 1762, 1765, 1766, 1767, 1768, 1770, 1781, 1782, 1783, 1784, 1785, 1787, 1788, 1789, 1791, 1792, 1793, 1795, 1797, 1798, 1800, 1806, 1807, 1809, 1813, 1815, 1816, 1820, 1823, 1824, 1826, 1832, 1833, 1838, 1839, 1844, 1845, 1846, 1851, 1852, 1853, 1854, 1855, 1857, 1858, 1860, 1861, 1862, 1864, 1866, 1868, 1872, 1873, 1876, 1877, 1879, 1882, 1884, 1887, 1889, 1890, 1891, 1894, 1899, 1904, 1908, 1914, 1916, 1925, 1926, 1927, 1930, 1932, 1936, 1938, 1939, 1942, 1943, 1949, 1950, 1952, 1954, 1959, 1961, 1963, 1966, 1970, 1973, 1974, 1975, 1977, 1980, 1982, 1984, 1985, 1988, 1990, 1991, 1995, 1998, 2003, 2008, 2009, 2012, 2014, 2015, 2016, 2018, 2021, 2022, 2027, 2028, 2029, 2030, 2035, 2036, 2037, 2038, 2042, 2045, 2046, 2055, 2057, 2058, 2059, 2060, 2061, 2062, 2066, 2067, 2068, 2069, 2070, 2076, 2081, 2086, 2088, 2089, 2090, 2092, 2095, 2096, 2097, 2098, 2099, 2101, 2102, 2104, 2106, 2107, 2108, 2110, 2112, 2118, 2120, 2123, 2132, 2139, 2140, 2142, 2146, 2147, 2149, 2152, 2153, 2156, 2160, 2161, 2162, 2163, 2170, 2171, 2179, 2184, 2185, 2187, 2190, 2192, 2193, 2198, 2206, 2207, 2208, 2212, 2215, 2217, 2220, 2221, 2224, 2225, 2228, 2229, 2231, 2233, 2236, 2240, 2243, 2245, 2249, 2250, 2266, 2267, 2270, 2271, 2273, 2274, 2275, 2276, 2281, 2282, 2283, 2290, 2298, 2300, 2301, 2307, 2309, 2311, 2312, 2316, 2317, 2318, 2319, 2322, 2323, 2325, 2330, 2332, 2333, 2334, 2335, 2339, 2340, 2344, 2347, 2355, 2356, 2361, 2362, 2367, 2368, 2369, 2371, 2376, 2378, 2379, 2381, 2382, 2384, 2394, 2395, 2399, 2402, 2406, 2413, 2414, 2415, 2419, 2424, 2431, 2432, 2433, 2434, 2435, 2436, 2438, 2439, 2441, 2442, 2444, 2445, 2446, 2449, 2456, 2457, 2458, 2461, 2462, 2463, 2464, 2465, 2467, 2469, 2474, 2479, 2483, 2499, 2500, 2505, 2506, 2509, 2512, 2513, 2514, 2521, 2532, 2533, 2534, 2536, 2537, 2538, 2541, 2542, 2546, 2547, 2548, 2549, 2550, 2555, 2556, 2558, 2560, 2563, 2566, 2567, 2568, 2572, 2575, 2576, 2577, 2578, 2581, 2582, 2583, 2585, 2587, 2590, 2594, 2598, 2600, 2601, 2605, 2609, 2610, 2611, 2612, 2613, 2617, 2621, 2626, 2630, 2631, 2632, 2639, 2641, 2642, 2644, 2645, 2646, 2647, 2649, 2654, 2655, 2657, 2658, 2659, 2664, 2668, 2671, 2674, 2682, 2684, 2689, 2691, 2695, 2706, 2709, 2711, 2715, 2716, 2721, 2723, 2725, 2726, 2728, 2729, 2730, 2731, 2737, 2741, 2744, 2749, 2750, 2751, 2761, 2762, 2764, 2766, 2769, 2775, 2776, 2780, 2785, 2786, 2791, 2796, 2797, 2798, 2799, 2801, 2803, 2805, 2806, 2807, 2809, 2812, 2814, 2815, 2816, 2818, 2822, 2823, 2825, 2826, 2827, 2834, 2839, 2840, 2844, 2848, 2849, 2852, 2853, 2854, 2871, 2874, 2875, 2880, 2884, 2886, 2889, 2890, 2892, 2893, 2894, 2895, 2896, 2902, 2903, 2905, 2906, 2907, 2915, 2919, 2920, 2925, 2927, 2933, 2935, 2937, 2939, 2940, 2951, 2955, 2956, 2957, 2960, 2961, 2966, 2968, 2972, 2973, 2978, 2981, 2988, 2990, 2994, 2996, 3000, 3002, 3003, 3007, 3009, 3011, 3014, 3017, 3019, 3032, 3033, 3035, 3037, 3044, 3045, 3051, 3054, 3055, 3064, 3065, 3068, 3074, 3083, 3090, 3095, 3096, 3099, 3102, 3105, 3106, 3110, 3118, 3120, 3127, 3133, 3138, 3139, 3141, 3143, 3149, 3150, 3153, 3158, 3162, 3167, 3169, 3173, 3177, 3183, 3185, 3186, 3189, 3190, 3191, 3193, 3194, 3201, 3203, 3204, 3207, 3208, 3209, 3211, 3214, 3222, 3223, 3225, 3229, 3233, 3245, 3250, 3251, 3257, 3258, 3259, 3261, 3270, 3272, 3280, 3281, 3282, 3286, 3299, 3301, 3303, 3310, 3311, 3312, 3313, 3314, 3316, 3317, 3321, 3322, 3327, 3329, 3332, 3333, 3334, 3336, 3337, 3339, 3340, 3342, 3344, 3345, 3347, 3352, 3353, 3354, 3356, 3360, 3362, 3367, 3374, 3376, 3379, 3384, 3386, 3388, 3389, 3392, 3401, 3408, 3412, 3415, 3419, 3421, 3424, 3427, 3430, 3431, 3432, 3433, 3434, 3436, 3441, 3443, 3445, 3448, 3450, 3451, 3455, 3457, 3461, 3472, 3473, 3477, 3484, 3486, 3488, 3489, 3491, 3492, 3500, 3501, 3510, 3511, 3512, 3513, 3519, 3521, 3528, 3530, 3533, 3534, 3535, 3539, 3540, 3543, 3545, 3558, 3562, 3567, 3570, 3571, 3572, 3573, 3574, 3575, 3585, 3588, 3603, 3606, 3607, 3609, 3616, 3617, 3618, 3623, 3624, 3626, 3628, 3630, 3631, 3634, 3636, 3637, 3638, 3639, 3647, 3648, 3649, 3655, 3656, 3657, 3661, 3662, 3663, 3666, 3668, 3670, 3671, 3673, 3675, 3678, 3679, 3685, 3687, 3690, 3691, 3693, 3698, 3700, 3701, 3702, 3703, 3704, 3705, 3706, 3709, 3719, 3724, 3730, 3732, 3734, 3736, 3738, 3739, 3748, 3750, 3756, 3761, 3763, 3764, 3766, 3769, 3772, 3774, 3777, 3781, 3784, 3786, 3789, 3790, 3794, 3797, 3799, 3801, 3804, 3813, 3818, 3819, 3820, 3821, 3823, 3825, 3827, 3829, 3830, 3831, 3832, 3833, 3837, 3838, 3843, 3844, 3856, 3857, 3858, 3868, 3870, 3873, 3875, 3894, 3895, 3896, 3897, 3899, 3903, 3907, 3910, 3920, 3923, 3925, 3927, 3935, 3936, 3938, 3939, 3940, 3947, 3948, 3950, 3953, 3957, 3958, 3960, 3962, 3965, 3967, 3969, 3973, 3975, 3976, 3977, 3978, 3985, 3986, 3990, 3991, 3994, 3996, 3997, 3998, 4000, 4002, 4004, 4005, 4006, 4007, 4008, 4009, 4019, 4026, 4027, 4029, 4030, 4031, 4034, 4046, 4047, 4049, 4050, 4054, 4055, 4061, 4062, 4063, 4076, 4079, 4080, 4082, 4087, 4089, 4096, 4100, 4101, 4102, 4103, 4105, 4116, 4117, 4119, 4122, 4123, 4125, 4126, 4131, 4138, 4140, 4141, 4143, 4154, 4155, 4158, 4159, 4161, 4163, 4166, 4167, 4169, 4183, 4184, 4188, 4191, 4194, 4196, 4197, 4200, 4206, 4208, 4212, 4214, 4215, 4216, 4223, 4224, 4226, 4228, 4233, 4238, 4241, 4242, 4244, 4246, 4249, 4250, 4253, 4256, 4258, 4262, 4263, 4270, 4273, 4275, 4277, 4278, 4279, 4280, 4286, 4289, 4290, 4293, 4297, 4299, 4304, 4308, 4309, 4314, 4315, 4316, 4317, 4318, 4319, 4320, 4321, 4325, 4327, 4330, 4331, 4333, 4335, 4336, 4342, 4345, 4349, 4352, 4358, 4363, 4364, 4368, 4370, 4371, 4372, 4375, 4377, 4379, 4381, 4382, 4386, 4388, 4392, 4398, 4399, 4401, 4407, 4409, 4411, 4413, 4417, 4420, 4422, 4425, 4426, 4427, 4430, 4432, 4433, 4435, 4438, 4440, 4441, 4445, 4447, 4460, 4461, 4463, 4468, 4469, 4471, 4472, 4478, 4492, 4493, 4494, 4497, 4508, 4509, 4510, 4518, 4524, 4527, 4536, 4540, 4543, 4544, 4553, 4554, 4563, 4564, 4565, 4571, 4572, 4573, 4574, 4576, 4578, 4580, 4582, 4585, 4586, 4587, 4589, 4590, 4591, 4594, 4596, 4597, 4602, 4603, 4606, 4607, 4608, 4610, 4613, 4614, 4616, 4618, 4619, 4620, 4621, 4624, 4626, 4627, 4629, 4632, 4633, 4634, 4643, 4644, 4650, 4653, 4655, 4656, 4662, 4665, 4667, 4669, 4673, 4677, 4682, 4683, 4684, 4692, 4694, 4702, 4723, 4725, 4726, 4732, 4733, 4734, 4735, 4737, 4738, 4741, 4754, 4756, 4758, 4759, 4760, 4763, 4768, 4770, 4771, 4772, 4775, 4776, 4778, 4780, 4783, 4789, 4801, 4803, 4804, 4806, 4813, 4816, 4817, 4818, 4819, 4820, 4822, 4826, 4830, 4831, 4838, 4839, 4840, 4841, 4847, 4852, 4853, 4858, 4864, 4865, 4866, 4867, 4875, 4878, 4881, 4883, 4884, 4887, 4890, 4895, 4897, 4899, 4900, 4902, 4916, 4917, 4918, 4922, 4924, 4925, 4928, 4932, 4933, 4934, 4936, 4938, 4939, 4943, 4944, 4945, 4946, 4947, 4952, 4953, 4956, 4957, 4960, 4961, 4965, 4967, 4977, 4978, 4979, 4986, 4988, 4989, 4990, 4991, 4993, 4994, 4996, 4997, 4999, 5001, 5010, 5013, 5016, 5022, 5026, 5028, 5031, 5034, 5035, 5046, 5048, 5049, 5050, 5053, 5061, 5062, 5064, 5065, 5069, 5071, 5073, 5074, 5076, 5078, 5079, 5098, 5099, 5100, 5101, 5102, 5103, 5104, 5106, 5111, 5112, 5113, 5116, 5131, 5138, 5139, 5144, 5148, 5151, 5152, 5156, 5159, 5165, 5168, 5172, 5175, 5179, 5181, 5186, 5188, 5192, 5193, 5200, 5204, 5206, 5207, 5208, 5213, 5216, 5218, 5219, 5233, 5240, 5241, 5245, 5247, 5249, 5250, 5251, 5252, 5256, 5261, 5266, 5271, 5272, 5276, 5277, 5280, 5282, 5285, 5286, 5289, 5290, 5294, 5295, 5298, 5299, 5306, 5309, 5310, 5311, 5313, 5317, 5324, 5325, 5326, 5329, 5331, 5335, 5338, 5341, 5348, 5350, 5351, 5352, 5355, 5356, 5358, 5359, 5363, 5366, 5367, 5381, 5386, 5393, 5396, 5398, 5400, 5401, 5405, 5410, 5417, 5424, 5431, 5432, 5433, 5434, 5435, 5439, 5451, 5455, 5456, 5465, 5467, 5470, 5472, 5473, 5475, 5478, 5479, 5488, 5492, 5494, 5495, 5497, 5498, 5499, 5500, 5503, 5507, 5508, 5509, 5510, 5517, 5519, 5524, 5525, 5526, 5527, 5531, 5532, 5533, 5542, 5547, 5550, 5552, 5554, 5555, 5556, 5559, 5560, 5563, 5564, 5565, 5566, 5567, 5568, 5569, 5570, 5572, 5574, 5578, 5580, 5586, 5588, 5596, 5597, 5604, 5605, 5612, 5613, 5616, 5620, 5623, 5624, 5625, 5626, 5627, 5629, 5632, 5633, 5634, 5635, 5636, 5643, 5646, 5649, 5658, 5661, 5674, 5676, 5682, 5684, 5685, 5688, 5695, 5697, 5702, 5704, 5706, 5708, 5711, 5713, 5717, 5718, 5731, 5732, 5733, 5734, 5735, 5740, 5753, 5757, 5760, 5764, 5765, 5767, 5769, 5771, 5775, 5777, 5780, 5782, 5783, 5787, 5799, 5800, 5801, 5804, 5805, 5806, 5810, 5820, 5821, 5822, 5825, 5826, 5827, 5829, 5831, 5833, 5835, 5836, 5839, 5840, 5841, 5842, 5843, 5846, 5847, 5850, 5852, 5856, 5857, 5858, 5859, 5863, 5869, 5870, 5871, 5872, 5875, 5876, 5877, 5878, 5880, 5883, 5884, 5889, 5890, 5891, 5893, 5894, 5895, 5896, 5901, 5904, 5908, 5914, 5917, 5919, 5924, 5926, 5929, 5937, 5938, 5946, 5969, 5972, 5973, 5974, 5975, 5976, 5977, 5978, 5981, 5986, 5990, 5991, 5999, 6001, 6005, 6009, 6015, 6016, 6018, 6019, 6022, 6024, 6030, 6031, 6036, 6037, 6041, 6047, 6048, 6056, 6057, 6059, 6060, 6061, 6063, 6065, 6067, 6068, 6070, 6074, 6075, 6076, 6077, 6080, 6085, 6087, 6090, 6092, 6095, 6101, 6102, 6104, 6111, 6114, 6116, 6119, 6120, 6121, 6124, 6126, 6128, 6129, 6131, 6135, 6136, 6137, 6140, 6141, 6145, 6146, 6164, 6165, 6175, 6176, 6178, 6179, 6189, 6194, 6196, 6200, 6203, 6204, 6205, 6206, 6208, 6209, 6210, 6211, 6212, 6213, 6214, 6215, 6216, 6217, 6218, 6219, 6220, 6221, 6222, 6225, 6226, 6227, 6228, 6229, 6231, 6232, 6233, 6248, 6250, 6252, 6257, 6262, 6272, 6273, 6274, 6278, 6279, 6280, 6286, 6289, 6292, 6295, 6296, 6298, 6302, 6311, 6314, 6316, 6317, 6319, 6325, 6328, 6334, 6336, 6338, 6340, 6343, 6350, 6353, 6358, 6360, 6362, 6363, 6365, 6373, 6374, 6378, 6379, 6380, 6381, 6382, 6383, 6384, 6385, 6387, 6389, 6390, 6391, 6392, 6395, 6396, 6402, 6419, 6420, 6421, 6425, 6427, 6429, 6435, 6437, 6439, 6442, 6446, 6448, 6450, 6453, 6455, 6457, 6468, 6469, 6476, 6481, 6482, 6489, 6493, 6497, 6500, 6501, 6503, 6505, 6511, 6512, 6513, 6515, 6518, 6519, 6520, 6521, 6522, 6523, 6524, 6525, 6530, 6536, 6537, 6538, 6539, 6540, 6541, 6542, 6544, 6554, 6555, 6556, 6558, 6562, 6563, 6564, 6565, 6567, 6568, 6569, 6570, 6573, 6575, 6576, 6584, 6591, 6592, 6594, 6595, 6596, 6597, 6600, 6601, 6603, 6606, 6607, 6608, 6610, 6612, 6615, 6616, 6617, 6620, 6623, 6624, 6625, 6630, 6631, 6634, 6636, 6639, 6640, 6641, 6642, 6646, 6650, 6658, 6662, 6665, 6667, 6668, 6670, 6673, 6675, 6676, 6678, 6679, 6683, 6684, 6685, 6691, 6692, 6695, 6700, 6706, 6709, 6711, 6712, 6716, 6720, 6721, 6722, 6723, 6726, 6727, 6729, 6730, 6731, 6732, 6734, 6735, 6736, 6737, 6744, 6747, 6752, 6754, 6757, 6762, 6768, 6771, 6774, 6782, 6786, 6787, 6792, 6793}",1989,"{4100, 4101, 4102, 4103, 2057, 2058, 2059, 2060, 2061, 2062, 2068, 3095, 3105, 3106, 3110, 5165, 5168, 6200, 2104, 5179, 6203, 5181, 6204, 6205, 6206, 2110, 5186, 6208, 6209, 6210, 6211, 6212, 5192, 5193, 6213, 6216, 6217, 6221, 6222, 6226, 5204, 5206, 5208, 6232, 5218, 2161, 2162, 2163, 2170, 2171, 2179, 6286, 2212, 1189, 2215, 1192, 2217, 1193, 1194, 2220, 2221, 1195, 1202, 4275, 2250, 3282, 4315, 2275, 2276, 6373, 6374, 6378, 6379, 6380, 6387, 6389, 6390, 6391, 6392, 6402, 3332, 3333, 3336, 3337, 3342, 6419, 6420, 6421, 6425, 6427, 6429, 6435, 2339, 6437, 2340, 6439, 2344, 2347, 6446, 6450, 6453, 4407, 3392, 6468, 6469, 1350, 1352, 4425, 4426, 4427, 4432, 4433, 1361, 4435, 1362, 1364, 1366, 5470, 5488, 5492, 5495, 1400, 5499, 5500, 1403, 2431, 2432, 2433, 2434, 5507, 5508, 5509, 2435, 2436, 6536, 6537, 6538, 6539, 4492, 4493, 4494, 6540, 6541, 4497, 6542, 1418, 6544, 5525, 5526, 5531, 6558, 6562, 6564, 6565, 6569, 6575, 5552, 6576, 5556, 5559, 5560, 5563, 5564, 5565, 5566, 6591, 6592, 5570, 6600, 6601, 6610, 6615, 6620, 1500, 6623, 6624, 6625, 5604, 6630, 6631, 6634, 2538, 6636, 5613, 1514, 2541, 2542, 6641, 6642, 1517, 4596, 4597, 5620, 1519, 5623, 5624, 5625, 6650, 5626, 5627, 1529, 2555, 4608, 5633, 4610, 6658, 6662, 2566, 2567, 6665, 2568, 6667, 3603, 2581, 2582, 3607, 3609, 2587, 2590, 3616, 3617, 3626, 2605, 3631, 3637, 3638, 3639, 5688, 6712, 5695, 6722, 6723, 6726, 6727, 5704, 5706, 6730, 5708, 6732, 1649, 1650, 1651, 1656, 1659, 1664, 1668, 1672, 1675, 1676, 1679, 1680, 3736, 3738, 5799, 5800, 5801, 3756, 5804, 5805, 3761, 3763, 3764, 2744, 1720, 1721, 1722, 1723, 5822, 2750, 2751, 1729, 5829, 1734, 1735, 2761, 2762, 1738, 2764, 1740, 2766, 1741, 1742, 2769, 1747, 1749, 5846, 5847, 5850, 3804, 5852, 5856, 5857, 2786, 5859, 5863, 5871, 1781, 1782, 1783, 1788, 1789, 1791, 1792, 5889, 5890, 1793, 2818, 5893, 5894, 5895, 5896, 2822, 2825, 2826, 2827, 5929, 3894, 3895, 3897, 1857, 1858, 3907, 1862, 1864, 2890, 1866, 2892, 2894, 4943, 4944, 4945, 4946, 2896, 5969, 1872, 5972, 5973, 5974, 5975, 5976, 5977, 5978, 2902, 1879, 4965, 4967, 5999, 4978, 4979, 4988, 4991, 4996, 5001, 2955, 6030, 6031, 6036, 6037, 3990, 3994, 3997, 3998, 6048, 5026, 6059, 1408, 6065, 6070, 6074, 6075, 1412, 5076, 2008, 2012, 2014, 4063, 2018, 3044, 2022, 2029, 2030, 4082, 2042, 2046}",384,"{4096, 4105, 4116, 4117, 4119, 4122, 4123, 4125, 4126, 4131, 4138, 4140, 4141, 4143, 4154, 4155, 4158, 4159, 4161, 4163, 4166, 4167, 4169, 4183, 4184, 4188, 4191, 4194, 4196, 4197, 4200, 4206, 4208, 4212, 4214, 4215, 4216, 4223, 4224, 4226, 4228, 4233, 4238, 4241, 4242, 4244, 4246, 4249, 4250, 4253, 4256, 4258, 4262, 4263, 4270, 4273, 4277, 4278, 4279, 4280, 4286, 4289, 4290, 4293, 4297, 4299, 4304, 4308, 4309, 4314, 4316, 4317, 4318, 4319, 4320, 4321, 4325, 4327, 4330, 4331, 4333, 4335, 4336, 4342, 4345, 4349, 4352, 4358, 4363, 4364, 4368, 4370, 4371, 4372, 4375, 4377, 4379, 4381, 4382, 4386, 4388, 4392, 4398, 4399, 4401, 4409, 4411, 4413, 4417, 4420, 4422, 4430, 4438, 4440, 4441, 4445, 4447, 4460, 4461, 4463, 4468, 4469, 4471, 4472, 4478, 4508, 4509, 4510, 4518, 4524, 4527, 4536, 4540, 4543, 4544, 4553, 4554, 4563, 4564, 4565, 4571, 4572, 4573, 4574, 4576, 4578, 4580, 4582, 4585, 4586, 4587, 4589, 4590, 4591, 4594, 4602, 4603, 4606, 4607, 4613, 4614, 4616, 4618, 4619, 4620, 4621, 4624, 4626, 4627, 4629, 4632, 4633, 4634, 4643, 4644, 4650, 4653, 4655, 4656, 4662, 4665, 4667, 4669, 4673, 4677, 4682, 4683, 4684, 4692, 4694, 4702, 4723, 4725, 4726, 4732, 4733, 4734, 4735, 4737, 4738, 4741, 4754, 4756, 4758, 4759, 4760, 4763, 4768, 4770, 4771, 4772, 4775, 4776, 4778, 4780, 4783, 4789, 4801, 4803, 4804, 4806, 4813, 4816, 4817, 4818, 4819, 4820, 4822, 4826, 4830, 4831, 4838, 4839, 4840, 4841, 4847, 4852, 4853, 4858, 4864, 4865, 4866, 4867, 4875, 4878, 4881, 4883, 4884, 4887, 4890, 4895, 4897, 4899, 4900, 4902, 4916, 4917, 4918, 4922, 4924, 4925, 4928, 4932, 4933, 4934, 4936, 4938, 4939, 4947, 4952, 4953, 4956, 4957, 4960, 4961, 4977, 4986, 4989, 4990, 4993, 4994, 4997, 4999, 5880, 5010, 5013, 5016, 5022, 5028, 5031, 5034, 5035, 5046, 5048, 5049, 5050, 5053, 5061, 5062, 5064, 5065, 5069, 5071, 5073, 5074, 5078, 5079, 5098, 5099, 5100, 5101, 5102, 5103, 5104, 5106, 5111, 5112, 5113, 5116, 5131, 5138, 5139, 5144, 5148, 5151, 5152, 5156, 5159, 5172, 5175, 1081, 1086, 1087, 5188, 5200, 1110, 1111, 1113, 5207, 5213, 1119, 5216, 5219, 1132, 1133, 5233, 1139, 1141, 1143, 1144, 5240, 1146, 5241, 5245, 5247, 5249, 1154, 5250, 5251, 1157, 5252, 1159, 5256, 5261, 1166, 1168, 5266, 1173, 1174, 1175, 5271, 5272, 1178, 5276, 5277, 5280, 5282, 5285, 1191, 5286, 5289, 5290, 5294, 5295, 5298, 5299, 1206, 5306, 1211, 1212, 5309, 5310, 5311, 1217, 5313, 1220, 5317, 1224, 1226, 1227, 5324, 5325, 5326, 1232, 5329, 1235, 1236, 5331, 5335, 5338, 1243, 1245, 5341, 1248, 1249, 1251, 1252, 1253, 5348, 5350, 5351, 5352, 1258, 1259, 1260, 5355, 1262, 5356, 1264, 5358, 5359, 1267, 5363, 1269, 1270, 1271, 5366, 5367, 1278, 1279, 1283, 5381, 1286, 1288, 1289, 5386, 1292, 1293, 1295, 1296, 5393, 1298, 1299, 5396, 5398, 1303, 5400, 5401, 1306, 5405, 5410, 1316, 1317, 5417, 1326, 5424, 1329, 1333, 5431, 5432, 1337, 5433, 1339, 1340, 5434, 5435, 1343, 1344, 5439, 1348, 1351, 1354, 1355, 1356, 5451, 1358, 1359, 5455, 5456, 5465, 1371, 1372, 5467, 1375, 1376, 5472, 5473, 5475, 1381, 5478, 1383, 1384, 5479, 1394, 5494, 1399, 5497, 5498, 1407, 5503, 1411, 1416, 5510, 1419, 5517, 1422, 5519, 1426, 1427, 1428, 5524, 5527, 1433, 1436, 1437, 5532, 5533, 1445, 5542, 1447, 1449, 1451, 5547, 5550, 5554, 5555, 1463, 1465, 1466, 5567, 5568, 1474, 1475, 5569, 5572, 1479, 5574, 1481, 1482, 5578, 5580, 1488, 5586, 1492, 5588, 1494, 5596, 5597, 1506, 5605, 5612, 5616, 1525, 1527, 1534, 1535, 5629, 5632, 1539, 5634, 1541, 5635, 5636, 5643, 1548, 1550, 5646, 5649, 1557, 1559, 1561, 5658, 1564, 5661, 1570, 1571, 1572, 1575, 1576, 1577, 5674, 5676, 1585, 1586, 5682, 5684, 5685, 1590, 1599, 1600, 5697, 1603, 5702, 1608, 1609, 1613, 1615, 1616, 1617, 1618, 5711, 5713, 5717, 5718, 1623, 1626, 1631, 1632, 1634, 1635, 1636, 5731, 1638, 5732, 5733, 1641, 5734, 5735, 5740, 1652, 1653, 1654, 1657, 5753, 1660, 5757, 5760, 5764, 5765, 5767, 1673, 5769, 5771, 5775, 5777, 1684, 1685, 1686, 5780, 1688, 1689, 1690, 5782, 1692, 5783, 5787, 1695, 1696, 1697, 1698, 1703, 1705, 5806, 1711, 5810, 1719, 1724, 1725, 5820, 5821, 5825, 5826, 5827, 5831, 5833, 5835, 5836, 5839, 5840, 5841, 5842, 5843, 1755, 1759, 1762, 5858, 1765, 1766, 1767, 1768, 1770, 5869, 5870, 5872, 5875, 5876, 1784, 1785, 5877, 1787, 5878, 5883, 1795, 5884, 1797, 1798, 1800, 5891, 1806, 1807, 1809, 5901, 5904, 5908, 1813, 1815, 1816, 5914, 1820, 5917, 1823, 1824, 5919, 1826, 5924, 5926, 1832, 1833, 1838, 1839, 5937, 5938, 1844, 1845, 1846, 5946, 1851, 1852, 1853, 1854, 1855, 1860, 1861, 1868, 1873, 1876, 1877, 1882, 1884, 1887, 1889, 1890, 1891, 5981, 5986, 1894, 5990, 5991, 1899, 1904, 6001, 1908, 6005, 6009, 1914, 1916, 6015, 6016, 6018, 6019, 1925, 1926, 1927, 6022, 6024, 1930, 1932, 1936, 1938, 1939, 1942, 1943, 6041, 1949, 1950, 6047, 1952, 1954, 1959, 6056, 1961, 6057, 1963, 6060, 1966, 6061, 6063, 1970, 6067, 6068, 1973, 1974, 1975, 1977, 1980, 6076, 1982, 6077, 1984, 1985, 6080, 1988, 6085, 1990, 1991, 6087, 6090, 1995, 6092, 1998, 6095, 2003, 6101, 6102, 2009, 6104, 2015, 2016, 6111, 6114, 6116, 2021, 6119, 6120, 6121, 2027, 2028, 6124, 6126, 6128, 6129, 2035, 2036, 2037, 2038, 6131, 6135, 6136, 6137, 6140, 2045, 6141, 6145, 6146, 2055, 2066, 2067, 2069, 2070, 6164, 6165, 2076, 6175, 6176, 2081, 6178, 6179, 2086, 2088, 2089, 2090, 2092, 6189, 2095, 2096, 2097, 2098, 2099, 6194, 2101, 2102, 6196, 2106, 2107, 2108, 2112, 2118, 2120, 2123, 6214, 6215, 6218, 6219, 6220, 2132, 6225, 6227, 6228, 6229, 2139, 2140, 6231, 2142, 6233, 2146, 2147, 2149, 2152, 2153, 6248, 6250, 2156, 6252, 2160, 6257, 6262, 6272, 6273, 6274, 6278, 6279, 2184, 2185, 6280, 2187, 2190, 2192, 2193, 6289, 6292, 2198, 6295, 6296, 6298, 2206, 2207, 2208, 6302, 6311, 6314, 6316, 6317, 2224, 2225, 6319, 2228, 2229, 6325, 2231, 6328, 2233, 2236, 6334, 2240, 6336, 6338, 2243, 6340, 2245, 6343, 2249, 6350, 6353, 6358, 6360, 2266, 2267, 6362, 6363, 2270, 2271, 6365, 2273, 2274, 2281, 2282, 2283, 6381, 6382, 6383, 2290, 6384, 6385, 2298, 6395, 2300, 2301, 6396, 2307, 2309, 2311, 2312, 2316, 2317, 2318, 2319, 2322, 2323, 2325, 2330, 2332, 2333, 2334, 2335, 6442, 6448, 2355, 2356, 6455, 2361, 2362, 6457, 2367, 2368, 2369, 2371, 2376, 2378, 2379, 6476, 2381, 2382, 2384, 6481, 6482, 6489, 2394, 2395, 6493, 2399, 6497, 2402, 6500, 6501, 2406, 6503, 6505, 2413, 2414, 2415, 6511, 6512, 6513, 2419, 6515, 6518, 6519, 2424, 6520, 6521, 6522, 6523, 6524, 6525, 6530, 2438, 2439, 2441, 2442, 2444, 2445, 2446, 2449, 2456, 2457, 2458, 6554, 6555, 2461, 2462, 2463, 2464, 2465, 6556, 2467, 2469, 6563, 2474, 6567, 6568, 6570, 2479, 6573, 2483, 6584, 6594, 2499, 2500, 6595, 6596, 6597, 2505, 2506, 6603, 2509, 6606, 6607, 2512, 2513, 2514, 6608, 6612, 6616, 2521, 6617, 2532, 2533, 2534, 2536, 2537, 6639, 6640, 2546, 2547, 2548, 2549, 2550, 6646, 2556, 2558, 2560, 2563, 2572, 6668, 6670, 2575, 2576, 2577, 2578, 6673, 6675, 2583, 6676, 2585, 6678, 6679, 6683, 6684, 6685, 2594, 6691, 6692, 2598, 6695, 2600, 2601, 6700, 2609, 2610, 2611, 2612, 2613, 6706, 6709, 6711, 2617, 6716, 2621, 6720, 6721, 2626, 2630, 2631, 2632, 6729, 6731, 2639, 6734, 2641, 2642, 6735, 2644, 2645, 2646, 2647, 6736, 2649, 6737, 6744, 6747, 2654, 2655, 6752, 2657, 2658, 2659, 6754, 6757, 2664, 6762, 2668, 2671, 6768, 2674, 6771, 6774, 2682, 2684, 6782, 2689, 6786, 2691, 6787, 2695, 6792, 6793, 2706, 2709, 2711, 2715, 2716, 2721, 2723, 2725, 2726, 2728, 2729, 2730, 2731, 2737, 2741, 2749, 2775, 2776, 2780, 2785, 2791, 2796, 2797, 2798, 2799, 2801, 2803, 2805, 2806, 2807, 2809, 2812, 2814, 2815, 2816, 2823, 2834, 2839, 2840, 2844, 2848, 2849, 2852, 2853, 2854, 2871, 2874, 2875, 2880, 2884, 2886, 2889, 2893, 2895, 2903, 2905, 2906, 2907, 2915, 2919, 2920, 2925, 2927, 2933, 2935, 2937, 2939, 2940, 2951, 2956, 2957, 2960, 2961, 2966, 2968, 2972, 2973, 2978, 2981, 2988, 2990, 2994, 2996, 3000, 3002, 3003, 3007, 3009, 3011, 3014, 3017, 3019, 3032, 3033, 3035, 3037, 3045, 3051, 3054, 3055, 3064, 3065, 3068, 3074, 3083, 3090, 3096, 3099, 3102, 3118, 3120, 3127, 3133, 3138, 3139, 3141, 3143, 3149, 3150, 3153, 3158, 3162, 3167, 3169, 3173, 3177, 3183, 3185, 3186, 3189, 3190, 3191, 3193, 3194, 3201, 3203, 3204, 3207, 3208, 3209, 3211, 3214, 3222, 3223, 3225, 3229, 3233, 3245, 3250, 3251, 3257, 3258, 3259, 3261, 3270, 3272, 3280, 3281, 3286, 3299, 3301, 3303, 3310, 3311, 3312, 3313, 3314, 3316, 3317, 3321, 3322, 3327, 3329, 3334, 3339, 3340, 3344, 3345, 3347, 3352, 3353, 3354, 3356, 3360, 3362, 3367, 3374, 3376, 3379, 3384, 3386, 3388, 3389, 3401, 3408, 3412, 3415, 3419, 3421, 3424, 3427, 3430, 3431, 3432, 3433, 3434, 3436, 3441, 3443, 3445, 3448, 3450, 3451, 3455, 3457, 3461, 3472, 3473, 3477, 3484, 3486, 3488, 3489, 3491, 3492, 3500, 3501, 3510, 3511, 3512, 3513, 3519, 3521, 3528, 3530, 3533, 3534, 3535, 3539, 3540, 3543, 3545, 3558, 3562, 3567, 3570, 3571, 3572, 3573, 3574, 3575, 3585, 3588, 3606, 3618, 3623, 3624, 3628, 3630, 3634, 3636, 3647, 3648, 3649, 3655, 3656, 3657, 3661, 3662, 3663, 3666, 3668, 3670, 3671, 3673, 3675, 3678, 3679, 3685, 3687, 3690, 3691, 3693, 3698, 3700, 3701, 3702, 3703, 3704, 3705, 3706, 3709, 3719, 3724, 3730, 3732, 3734, 3739, 3748, 3750, 3766, 3769, 3772, 3774, 3777, 3781, 3784, 3786, 3789, 3790, 3794, 3797, 3799, 3801, 3813, 3818, 3819, 3820, 3821, 3823, 3825, 3827, 3829, 3830, 3831, 3832, 3833, 3837, 3838, 3843, 3844, 3856, 3857, 3858, 3868, 3870, 3873, 3875, 3896, 3899, 3903, 3910, 3920, 3923, 3925, 3927, 3935, 3936, 3938, 3939, 3940, 3947, 3948, 3950, 3953, 3957, 3958, 3960, 3962, 3965, 3967, 3969, 3973, 3975, 3976, 3977, 3978, 3985, 3986, 3991, 3996, 4000, 4002, 4004, 4005, 4006, 4007, 4008, 4009, 4019, 4026, 4027, 4029, 4030, 4031, 4034, 4046, 4047, 4049, 4050, 4054, 4055, 4061, 4062, 4076, 4079, 4080, 4087, 4089}",1605
17,"(('batch', ('Request For Payment FINAL_APPROVED by SUPERVISOR', 'Request Payment')), ('batch', ('Request Payment', 'Payment Handled')))",2,10,"{0, 1, 2, 3, 4, 5, 6, 7, 8, 9, 10, 11, 12, 14, 15, 16, 17, 18, 20, 21, 22, 23, 24, 25, 27, 28, 29, 30, 31, 32, 33, 34, 35, 36, 37, 38, 39, 42, 43, 44, 45, 46, 47, 48, 49, 50, 51, 52, 53, 54, 55, 56, 57, 58, 59, 60, 61, 62, 64, 65, 66, 67, 68, 69, 70, 71, 72, 73, 74, 75, 78, 79, 80, 81, 83, 84, 85, 86, 88, 89, 90, 91, 92, 93, 94, 95, 96, 97, 98, 99, 100, 101, 102, 103, 104, 105, 106, 107, 108, 109, 110, 111, 112, 113, 114, 116, 118, 123, 124, 125, 126, 127, 128, 129, 130, 131, 132, 133, 134, 135, 136, 137, 138, 139, 140, 141, 143, 144, 145, 146, 147, 148, 149, 150, 151, 153, 154, 155, 156, 158, 159, 160, 161, 162, 163, 164, 165, 166, 167, 168, 169, 171, 172, 175, 176, 179, 180, 181, 182, 183, 184, 185, 186, 187, 188, 189, 190, 191, 192, 193, 194, 195, 196, 198, 199, 200, 201, 202, 203, 204, 205, 206, 207, 208, 209, 210, 211, 212, 213, 214, 215, 216, 217, 218, 219, 220, 221, 222, 223, 224, 225, 226, 227, 228, 229, 230, 231, 232, 234, 235, 236, 237, 238, 239, 240, 241, 242, 243, 244, 245, 246, 247, 248, 249, 250, 251, 252, 253, 254, 256, 257, 258, 259, 260, 261, 262, 263, 264, 265, 266, 267, 268, 269, 271, 272, 273, 274, 275, 276, 277, 278, 279, 280, 281, 282, 283, 284, 285, 286, 287, 288, 289, 290, 291, 292, 293, 294, 295, 296, 297, 298, 300, 301, 302, 303, 305, 307, 310, 311, 312, 313, 314, 315, 316, 317, 318, 321, 322, 323, 324, 325, 326, 327, 331, 332, 333, 334, 335, 336, 337, 338, 339, 340, 341, 342, 343, 344, 345, 346, 348, 349, 350, 351, 352, 353, 356, 357, 358, 359, 360, 361, 362, 363, 364, 365, 366, 367, 368, 369, 370, 372, 373, 375, 376, 377, 378, 379, 380, 382, 383, 384, 385, 386, 387, 388, 389, 390, 391, 392, 393, 394, 395, 396, 397, 398, 399, 400, 401, 402, 403, 404, 405, 406, 407, 408, 409, 410, 411, 414, 415, 416, 417, 418, 419, 420, 421, 422, 423, 424, 425, 426, 427, 428, 429, 430, 431, 433, 434, 435, 436, 437, 438, 439, 440, 441, 443, 444, 445, 446, 447, 449, 450, 451, 452, 453, 454, 456, 457, 458, 459, 460, 461, 462, 463, 464, 466, 467, 468, 469, 470, 471, 473, 474, 475, 476, 477, 478, 479, 481, 482, 483, 484, 486, 487, 488, 489, 490, 491, 492, 493, 494, 495, 496, 497, 498, 499, 500, 501, 502, 503, 504, 505, 506, 508, 509, 510, 511, 512, 513, 514, 515, 516, 518, 519, 520, 521, 522, 523, 524, 525, 526, 527, 528, 530, 531, 533, 534, 535, 536, 537, 538, 539, 540, 541, 542, 543, 544, 545, 546, 547, 548, 549, 550, 551, 552, 553, 554, 555, 556, 557, 558, 559, 560, 561, 562, 563, 565, 566, 567, 568, 569, 570, 571, 572, 573, 574, 575, 576, 577, 578, 580, 582, 583, 584, 585, 586, 590, 591, 593, 594, 596, 597, 598, 599, 600, 601, 602, 603, 604, 605, 606, 607, 608, 610, 611, 612, 613, 614, 616, 617, 618, 620, 621, 622, 623, 624, 625, 626, 627, 628, 629, 631, 632, 633, 634, 635, 636, 637, 638, 639, 640, 641, 642, 643, 644, 645, 646, 647, 648, 649, 650, 651, 652, 653, 654, 655, 656, 657, 658, 659, 660, 661, 662, 663, 664, 665, 666, 667, 668, 669, 670, 671, 672, 673, 674, 675, 676, 677, 678, 679, 680, 681, 682, 683, 684, 685, 686, 687, 688, 689, 690, 693, 695, 696, 697, 698, 699, 700, 701, 702, 703, 704, 705, 706, 707, 708, 709, 710, 711, 712, 713, 714, 715, 716, 717, 718, 719, 720, 721, 722, 723, 724, 725, 726, 727, 728, 729, 730, 731, 732, 733, 734, 735, 736, 737, 738, 739, 740, 741, 742, 743, 744, 745, 746, 748, 749, 750, 751, 752, 753, 754, 755, 756, 757, 758, 759, 760, 761, 762, 763, 764, 765, 766, 767, 768, 769, 770, 771, 773, 774, 775, 776, 777, 778, 779, 780, 781, 782, 783, 784, 785, 786, 787, 788, 789, 790, 791, 792, 794, 795, 796, 797, 798, 799, 800, 801, 802, 803, 804, 805, 806, 807, 808, 809, 810, 811, 812, 813, 814, 815, 816, 817, 819, 820, 821, 824, 825, 826, 828, 829, 830, 831, 832, 833, 834, 835, 836, 837, 838, 839, 840, 841, 842, 843, 844, 845, 846, 847, 848, 849, 850, 851, 852, 854, 855, 856, 857, 858, 859, 860, 861, 862, 864, 865, 866, 867, 868, 869, 870, 871, 872, 873, 874, 875, 876, 877, 878, 879, 880, 881, 882, 883, 884, 885, 886, 887, 888, 889, 890, 891, 892, 893, 894, 895, 896, 897, 898, 899, 900, 901, 902, 903, 904, 905, 906, 907, 908, 909, 910, 911, 912, 913, 914, 915, 916, 917, 918, 919, 920, 921, 922, 923, 924, 925, 926, 927, 928, 929, 930, 931, 932, 933, 935, 936, 937, 939, 940, 941, 942, 943, 944, 945, 946, 947, 948, 949, 950, 951, 952, 953, 954, 955, 956, 957, 958, 959, 960, 961, 962, 963, 964, 965, 966, 967, 968, 969, 970, 971, 972, 973, 974, 975, 976, 977, 978, 979, 980, 981, 982, 983, 984, 985, 986, 987, 988, 989, 990, 991, 992, 993, 994, 996, 997, 999, 1000, 1001, 1002, 1003, 1004, 1005, 1006, 1007, 1008, 1009, 1010, 1011, 1012, 1013, 1014, 1015, 1016, 1017, 1018, 1019, 1020, 1021, 1022, 1023, 1024, 1025, 1026, 1028, 1029, 1030, 1031, 1032, 1033, 1034, 1036, 1037, 1038, 1039, 1040, 1041, 1042, 1043, 1044, 1045, 1046, 1047, 1048, 1050, 1051, 1052, 1053, 1054, 1055, 1056, 1057, 1058, 1059, 1060, 1061, 1063, 1064, 1065, 1066, 1067, 1069, 1070, 1071, 1073, 1074, 1075, 1076, 1077, 1078, 1079, 1080, 1081, 1082, 1083, 1085, 1086, 1087, 1088, 1089, 1090, 1092, 1093, 1094, 1095, 1096, 1097, 1098, 1099, 1100, 1101, 1103, 1104, 1105, 1106, 1107, 1108, 1109, 1110, 1111, 1112, 1113, 1114, 1115, 1116, 1117, 1118, 1119, 1120, 1121, 1122, 1123, 1124, 1125, 1126, 1127, 1128, 1129, 1130, 1131, 1132, 1133, 1134, 1135, 1136, 1137, 1138, 1140, 1141, 1142, 1143, 1144, 1145, 1146, 1147, 1148, 1149, 1150, 1151, 1152, 1153, 1154, 1155, 1156, 1157, 1158, 1159, 1160, 1161, 1162, 1163, 1165, 1166, 1167, 1168, 1169, 1170, 1171, 1172, 1173, 1174, 1175, 1176, 1177, 1178, 1179, 1180, 1181, 1182, 1183, 1184, 1185, 1186, 1187, 1188, 1189, 1190, 1191, 1192, 1193, 1194, 1195, 1196, 1197, 1198, 1199, 1200, 1201, 1202, 1203, 1204, 1205, 1206, 1207, 1208, 1209, 1210, 1211, 1212, 1213, 1214, 1215, 1216, 1217, 1218, 1219, 1220, 1221, 1222, 1223, 1224, 1225, 1226, 1227, 1228, 1229, 1230, 1231, 1232, 1233, 1234, 1235, 1236, 1237, 1238, 1239, 1240, 1241, 1242, 1243, 1244, 1245, 1246, 1247, 1248, 1249, 1250, 1251, 1252, 1253, 1254, 1255, 1258, 1259, 1260, 1262, 1263, 1264, 1265, 1267, 1268, 1269, 1270, 1271, 1272, 1273, 1274, 1275, 1276, 1277, 1278, 1279, 1280, 1281, 1282, 1283, 1284, 1285, 1286, 1287, 1288, 1289, 1290, 1291, 1292, 1293, 1294, 1295, 1298, 1299, 1300, 1301, 1302, 1303, 1304, 1305, 1306, 1307, 1308, 1309, 1310, 1311, 1313, 1314, 1315, 1316, 1317, 1318, 1320, 1321, 1323, 1324, 1325, 1326, 1327, 1328, 1329, 1330, 1331, 1332, 1333, 1334, 1335, 1336, 1337, 1338, 1339, 1340, 1342, 1343, 1344, 1345, 1346, 1347, 1348, 1349, 1350, 1351, 1352, 1353, 1354, 1355, 1356, 1357, 1358, 1359, 1360, 1361, 1362, 1364, 1365, 1366, 1367, 1368, 1369, 1370, 1371, 1372, 1373, 1374, 1375, 1376, 1377, 1378, 1379, 1380, 1381, 1382, 1383, 1384, 1385, 1386, 1387, 1388, 1389, 1390, 1391, 1392, 1393, 1394, 1395, 1396, 1397, 1399, 1400, 1401, 1402, 1403, 1404, 1405, 1406, 1407, 1408, 1409, 1410, 1411, 1412, 1413, 1414, 1415, 1416, 1418, 1419, 1420, 1421, 1422, 1423, 1424, 1426, 1427, 1428, 1429, 1430, 1431, 1432, 1433, 1434, 1435, 1436, 1437, 1439, 1440, 1441, 1442, 1443, 1445, 1446, 1447, 1448, 1449, 1450, 1451, 1452, 1453, 1454, 1455, 1456, 1457, 1458, 1459, 1460, 1461, 1462, 1464, 1465, 1466, 1467, 1468, 1469, 1470, 1471, 1472, 1473, 1474, 1475, 1476, 1477, 1478, 1479, 1481, 1482, 1483, 1484, 1485, 1487, 1488, 1489, 1491, 1492, 1493, 1494, 1495, 1496, 1499, 1500, 1501, 1502, 1503, 1504, 1505, 1506, 1507, 1508, 1509, 1510, 1511, 1512, 1513, 1514, 1515, 1516, 1517, 1518, 1519, 1520, 1521, 1522, 1523, 1524, 1525, 1526, 1527, 1528, 1529, 1530, 1531, 1532, 1533, 1534, 1535, 1536, 1538, 1539, 1540, 1541, 1542, 1543, 1544, 1545, 1546, 1548, 1549, 1550, 1551, 1552, 1553, 1554, 1556, 1557, 1558, 1559, 1560, 1561, 1562, 1563, 1564, 1565, 1566, 1567, 1568, 1569, 1570, 1571, 1572, 1573, 1574, 1575, 1576, 1577, 1578, 1579, 1580, 1581, 1582, 1583, 1584, 1585, 1586, 1587, 1588, 1589, 1590, 1591, 1592, 1593, 1594, 1595, 1596, 1597, 1598, 1599, 1600, 1601, 1602, 1603, 1604, 1605, 1606, 1607, 1608, 1609, 1610, 1612, 1613, 1614, 1615, 1616, 1617, 1618, 1619, 1620, 1621, 1622, 1623, 1624, 1625, 1626, 1627, 1628, 1629, 1630, 1631, 1632, 1633, 1634, 1635, 1636, 1637, 1638, 1639, 1640, 1641, 1642, 1643, 1644, 1645, 1646, 1647, 1648, 1649, 1650, 1651, 1652, 1653, 1654, 1655, 1656, 1657, 1658, 1659, 1660, 1661, 1662, 1663, 1664, 1665, 1666, 1667, 1668, 1669, 1670, 1671, 1672, 1673, 1674, 1675, 1676, 1678, 1679, 1680, 1681, 1682, 1683, 1684, 1685, 1686, 1687, 1688, 1689, 1690, 1691, 1692, 1693, 1694, 1695, 1696, 1697, 1698, 1699, 1700, 1701, 1702, 1703, 1704, 1705, 1706, 1707, 1708, 1709, 1710, 1711, 1712, 1713, 1714, 1715, 1716, 1717, 1718, 1719, 1720, 1721, 1722, 1723, 1724, 1725, 1726, 1727, 1728, 1729, 1730, 1731, 1732, 1734, 1735, 1736, 1737, 1738, 1739, 1740, 1741, 1742, 1743, 1744, 1745, 1746, 1747, 1748, 1749, 1752, 1753, 1754, 1755, 1756, 1757, 1758, 1759, 1760, 1761, 1762, 1764, 1765, 1766, 1767, 1768, 1769, 1770, 1771, 1772, 1773, 1774, 1775, 1776, 1778, 1779, 1780, 1781, 1782, 1783, 1784, 1785, 1786, 1787, 1788, 1789, 1790, 1791, 1792, 1793, 1795, 1796, 1797, 1798, 1799, 1800, 1801, 1802, 1803, 1804, 1805, 1806, 1807, 1808, 1809, 1810, 1811, 1812, 1813, 1814, 1815, 1816, 1817, 1818, 1819, 1820, 1821, 1822, 1823, 1824, 1825, 1826, 1827, 1828, 1829, 1830, 1831, 1832, 1833, 1834, 1835, 1836, 1837, 1838, 1839, 1840, 1841, 1842, 1843, 1844, 1845, 1846, 1847, 1848, 1849, 1850, 1851, 1852, 1853, 1854, 1855, 1857, 1858, 1859, 1860, 1861, 1862, 1863, 1864, 1865, 1866, 1867, 1868, 1869, 1870, 1871, 1872, 1873, 1874, 1875, 1876, 1877, 1878, 1879, 1880, 1881, 1882, 1883, 1884, 1885, 1886, 1887, 1888, 1889, 1890, 1891, 1892, 1893, 1894, 1895, 1896, 1897, 1898, 1899, 1900, 1901, 1902, 1903, 1904, 1905, 1907, 1908, 1909, 1910, 1911, 1912, 1914, 1915, 1916, 1918, 1919, 1920, 1921, 1922, 1923, 1924, 1925, 1926, 1927, 1928, 1929, 1930, 1931, 1932, 1934, 1936, 1937, 1938, 1939, 1940, 1941, 1942, 1943, 1944, 1945, 1946, 1947, 1948, 1949, 1950, 1951, 1952, 1954, 1955, 1956, 1957, 1958, 1959, 1960, 1961, 1962, 1963, 1964, 1965, 1966, 1967, 1968, 1969, 1970, 1971, 1972, 1973, 1974, 1975, 1976, 1977, 1978, 1979, 1980, 1981, 1982, 1983, 1984, 1985, 1986, 1987, 1988, 1990, 1991, 1992, 1993, 1994, 1995, 1996, 1997, 1998, 1999, 2000, 2001, 2002, 2003, 2004, 2005, 2006, 2007, 2008, 2009, 2010, 2011, 2012, 2014, 2015, 2016, 2017, 2018, 2019, 2020, 2021, 2022, 2023, 2024, 2025, 2026, 2027, 2028, 2029, 2030, 2031, 2032, 2033, 2034, 2035, 2036, 2037, 2038, 2039, 2040, 2041, 2042, 2043, 2044, 2045, 2046, 2047, 2049, 2050, 2051, 2052, 2053, 2055, 2056, 2057, 2058, 2059, 2060, 2061, 2062, 2063, 2064, 2065, 2066, 2067, 2068, 2069, 2070, 2071, 2073, 2074, 2075, 2076, 2077, 2079, 2080, 2081, 2082, 2083, 2084, 2085, 2086, 2087, 2088, 2089, 2090, 2091, 2092, 2094, 2095, 2096, 2097, 2098, 2099, 2100, 2101, 2102, 2103, 2104, 2106, 2107, 2108, 2109, 2110, 2111, 2112, 2113, 2114, 2115, 2116, 2117, 2118, 2119, 2120, 2121, 2122, 2123, 2124, 2125, 2126, 2128, 2129, 2130, 2131, 2132, 2133, 2134, 2135, 2137, 2138, 2139, 2140, 2141, 2142, 2143, 2144, 2146, 2147, 2148, 2149, 2150, 2151, 2152, 2153, 2154, 2155, 2156, 2157, 2158, 2159, 2160, 2161, 2162, 2163, 2164, 2166, 2167, 2168, 2169, 2170, 2171, 2172, 2173, 2174, 2175, 2176, 2177, 2178, 2179, 2180, 2181, 2182, 2183, 2184, 2185, 2186, 2187, 2188, 2189, 2190, 2191, 2192, 2193, 2194, 2195, 2196, 2197, 2198, 2200, 2201, 2202, 2203, 2204, 2205, 2206, 2207, 2208, 2209, 2210, 2211, 2212, 2213, 2214, 2215, 2216, 2217, 2218, 2219, 2220, 2221, 2222, 2223, 2224, 2225, 2226, 2228, 2229, 2230, 2231, 2232, 2233, 2234, 2235, 2236, 2237, 2239, 2240, 2241, 2242, 2243, 2244, 2245, 2246, 2247, 2248, 2249, 2250, 2251, 2252, 2253, 2254, 2255, 2259, 2260, 2261, 2262, 2263, 2264, 2265, 2266, 2267, 2268, 2269, 2270, 2271, 2272, 2273, 2274, 2275, 2276, 2277, 2280, 2281, 2282, 2283, 2284, 2285, 2287, 2288, 2289, 2290, 2291, 2292, 2293, 2294, 2295, 2296, 2297, 2298, 2299, 2300, 2301, 2302, 2303, 2304, 2305, 2306, 2307, 2309, 2310, 2311, 2312, 2313, 2315, 2316, 2317, 2318, 2319, 2320, 2321, 2322, 2323, 2324, 2325, 2327, 2328, 2329, 2330, 2331, 2332, 2333, 2334, 2335, 2336, 2337, 2338, 2339, 2340, 2341, 2342, 2344, 2345, 2346, 2347, 2348, 2349, 2350, 2351, 2352, 2353, 2354, 2355, 2356, 2357, 2358, 2359, 2360, 2361, 2362, 2363, 2364, 2365, 2366, 2367, 2368, 2369, 2370, 2371, 2373, 2374, 2375, 2376, 2377, 2378, 2379, 2380, 2381, 2382, 2383, 2384, 2385, 2386, 2387, 2388, 2389, 2390, 2391, 2392, 2393, 2394, 2395, 2396, 2397, 2398, 2399, 2401, 2402, 2403, 2404, 2405, 2406, 2407, 2408, 2409, 2410, 2411, 2412, 2413, 2414, 2415, 2416, 2419, 2420, 2421, 2422, 2423, 2424, 2425, 2426, 2427, 2428, 2429, 2430, 2431, 2432, 2433, 2434, 2435, 2436, 2437, 2438, 2439, 2440, 2441, 2442, 2443, 2444, 2445, 2448, 2449, 2450, 2452, 2453, 2454, 2455, 2456, 2457, 2458, 2459, 2460, 2461, 2462, 2463, 2464, 2465, 2466, 2467, 2469, 2470, 2471, 2472, 2473, 2474, 2475, 2476, 2477, 2478, 2479, 2480, 2481, 2482, 2483, 2484, 2485, 2486, 2487, 2488, 2489, 2490, 2491, 2492, 2494, 2495, 2496, 2497, 2499, 2500, 2501, 2503, 2504, 2505, 2506, 2508, 2509, 2510, 2511, 2512, 2513, 2514, 2515, 2516, 2517, 2518, 2519, 2520, 2521, 2522, 2523, 2524, 2525, 2526, 2527, 2528, 2529, 2530, 2531, 2532, 2533, 2534, 2535, 2536, 2537, 2538, 2540, 2541, 2543, 2544, 2546, 2547, 2548, 2549, 2550, 2551, 2552, 2553, 2554, 2555, 2556, 2557, 2558, 2559, 2560, 2561, 2562, 2563, 2564, 2566, 2567, 2568, 2569, 2570, 2572, 2574, 2575, 2576, 2577, 2578, 2579, 2580, 2581, 2582, 2583, 2584, 2585, 2586, 2587, 2590, 2591, 2592, 2593, 2594, 2595, 2596, 2597, 2598, 2599, 2600, 2601, 2603, 2604, 2605, 2606, 2607, 2608, 2609, 2610, 2611, 2612, 2613, 2614, 2615, 2616, 2617, 2620, 2621, 2622, 2623, 2624, 2625, 2626, 2627, 2628, 2629, 2630, 2631, 2632, 2633, 2635, 2636, 2637, 2639, 2640, 2641, 2642, 2643, 2644, 2645, 2646, 2647, 2648, 2649, 2650, 2652, 2653, 2654, 2655, 2656, 2657, 2658, 2659, 2660, 2662, 2664, 2666, 2667, 2668, 2669, 2671, 2672, 2673, 2674, 2677, 2679, 2680, 2681, 2682, 2683, 2684, 2685, 2686, 2687, 2688, 2689, 2690, 2691, 2692, 2693, 2694, 2695, 2696, 2697, 2698, 2699, 2700, 2701, 2703, 2704, 2705, 2706, 2707, 2708, 2709, 2710, 2711, 2712, 2713, 2715, 2716, 2717, 2718, 2720, 2721, 2723, 2724, 2725, 2726, 2727, 2728, 2729, 2730, 2731, 2732, 2733, 2734, 2735, 2736, 2737, 2738, 2739, 2740, 2741, 2744, 2745, 2746, 2747, 2748, 2749, 2750, 2751, 2753, 2754, 2755, 2756, 2757, 2758, 2759, 2760, 2761, 2762, 2763, 2764, 2765, 2766, 2768, 2769, 2770, 2771, 2772, 2773, 2774, 2775, 2776, 2777, 2779, 2780, 2782, 2783, 2784, 2785, 2786, 2787, 2789, 2790, 2791, 2792, 2793, 2794, 2795, 2796, 2797, 2798, 2799, 2800, 2801, 2802, 2803, 2804, 2805, 2806, 2807, 2808, 2809, 2811, 2812, 2813, 2814, 2815, 2816, 2817, 2818, 2819, 2820, 2821, 2822, 2823, 2825, 2826, 2827, 2828, 2830, 2831, 2832, 2833, 2834, 2835, 2836, 2837, 2838, 2839, 2840, 2841, 2842, 2843, 2844, 2845, 2846, 2847, 2848, 2849, 2850, 2851, 2852, 2853, 2854, 2855, 2856, 2857, 2858, 2859, 2860, 2861, 2862, 2863, 2865, 2866, 2867, 2868, 2869, 2870, 2871, 2872, 2873, 2874, 2875, 2877, 2878, 2880, 2883, 2884, 2886, 2887, 2888, 2889, 2890, 2891, 2892, 2893, 2894, 2895, 2896, 2897, 2898, 2899, 2900, 2901, 2902, 2903, 2904, 2905, 2906, 2907, 2908, 2909, 2910, 2911, 2912, 2914, 2915, 2916, 2917, 2918, 2919, 2920, 2921, 2923, 2924, 2925, 2926, 2927, 2930, 2931, 2932, 2933, 2934, 2935, 2937, 2938, 2939, 2940, 2941, 2942, 2943, 2944, 2945, 2946, 2947, 2949, 2950, 2951, 2952, 2953, 2955, 2956, 2957, 2959, 2960, 2961, 2962, 2963, 2965, 2966, 2967, 2968, 2969, 2970, 2971, 2972, 2973, 2974, 2975, 2976, 2977, 2978, 2979, 2980, 2981, 2982, 2983, 2984, 2985, 2986, 2987, 2988, 2989, 2990, 2991, 2992, 2993, 2994, 2995, 2996, 2997, 2998, 2999, 3000, 3001, 3002, 3003, 3004, 3005, 3006, 3007, 3008, 3009, 3010, 3011, 3012, 3014, 3015, 3016, 3017, 3018, 3019, 3020, 3022, 3023, 3024, 3025, 3026, 3027, 3028, 3029, 3030, 3031, 3032, 3033, 3034, 3035, 3036, 3037, 3038, 3039, 3040, 3042, 3043, 3044, 3045, 3046, 3047, 3048, 3049, 3050, 3051, 3052, 3053, 3054, 3055, 3057, 3058, 3059, 3060, 3061, 3062, 3063, 3064, 3065, 3066, 3067, 3068, 3070, 3071, 3072, 3073, 3074, 3075, 3076, 3077, 3079, 3080, 3081, 3082, 3083, 3084, 3086, 3087, 3088, 3089, 3090, 3091, 3093, 3094, 3095, 3096, 3097, 3098, 3099, 3100, 3101, 3102, 3103, 3104, 3105, 3106, 3107, 3108, 3109, 3110, 3111, 3112, 3113, 3114, 3115, 3116, 3118, 3119, 3120, 3121, 3122, 3123, 3124, 3125, 3126, 3127, 3128, 3131, 3132, 3133, 3134, 3135, 3136, 3137, 3138, 3139, 3142, 3143, 3144, 3146, 3147, 3149, 3150, 3151, 3152, 3153, 3155, 3156, 3157, 3158, 3159, 3160, 3162, 3163, 3164, 3165, 3166, 3167, 3169, 3170, 3171, 3172, 3173, 3174, 3175, 3176, 3177, 3178, 3179, 3180, 3181, 3182, 3183, 3184, 3185, 3186, 3187, 3188, 3189, 3190, 3191, 3192, 3193, 3194, 3195, 3196, 3197, 3198, 3199, 3200, 3201, 3202, 3203, 3204, 3205, 3206, 3207, 3208, 3209, 3210, 3211, 3212, 3213, 3214, 3215, 3216, 3217, 3218, 3219, 3222, 3223, 3224, 3225, 3226, 3227, 3228, 3229, 3231, 3232, 3233, 3234, 3236, 3240, 3241, 3242, 3243, 3244, 3245, 3247, 3248, 3249, 3250, 3251, 3252, 3253, 3254, 3255, 3256, 3258, 3259, 3260, 3261, 3262, 3263, 3265, 3269, 3270, 3271, 3272, 3273, 3276, 3277, 3279, 3280, 3281, 3282, 3283, 3284, 3285, 3286, 3287, 3288, 3289, 3291, 3292, 3293, 3294, 3295, 3296, 3298, 3299, 3300, 3301, 3302, 3303, 3304, 3305, 3306, 3307, 3310, 3311, 3312, 3313, 3314, 3316, 3317, 3318, 3319, 3320, 3321, 3322, 3323, 3325, 3326, 3327, 3328, 3329, 3330, 3331, 3332, 3333, 3334, 3335, 3337, 3338, 3339, 3340, 3341, 3342, 3343, 3344, 3345, 3346, 3347, 3349, 3350, 3351, 3352, 3353, 3354, 3355, 3356, 3357, 3358, 3359, 3360, 3362, 3363, 3364, 3366, 3367, 3368, 3369, 3370, 3371, 3372, 3373, 3374, 3375, 3376, 3377, 3378, 3379, 3380, 3381, 3382, 3383, 3384, 3386, 3387, 3388, 3389, 3390, 3391, 3392, 3393, 3394, 3396, 3397, 3398, 3399, 3400, 3401, 3402, 3403, 3404, 3405, 3406, 3407, 3408, 3410, 3411, 3412, 3413, 3414, 3415, 3416, 3417, 3418, 3419, 3421, 3422, 3423, 3424, 3426, 3427, 3428, 3429, 3430, 3431, 3432, 3433, 3434, 3435, 3436, 3437, 3438, 3439, 3440, 3441, 3442, 3443, 3444, 3445, 3446, 3447, 3448, 3449, 3450, 3451, 3452, 3453, 3454, 3455, 3456, 3457, 3459, 3460, 3461, 3462, 3465, 3466, 3467, 3468, 3469, 3470, 3471, 3472, 3473, 3474, 3476, 3477, 3480, 3481, 3482, 3483, 3484, 3485, 3486, 3487, 3488, 3489, 3490, 3491, 3492, 3493, 3494, 3495, 3497, 3498, 3499, 3500, 3501, 3502, 3503, 3504, 3505, 3506, 3507, 3509, 3510, 3511, 3512, 3513, 3514, 3515, 3516, 3519, 3520, 3521, 3522, 3523, 3525, 3526, 3527, 3528, 3529, 3530, 3531, 3532, 3533, 3534, 3535, 3536, 3538, 3539, 3540, 3541, 3542, 3543, 3544, 3545, 3546, 3547, 3548, 3549, 3550, 3551, 3552, 3553, 3556, 3557, 3558, 3562, 3563, 3564, 3565, 3566, 3567, 3568, 3569, 3570, 3571, 3572, 3573, 3574, 3575, 3576, 3577, 3578, 3580, 3581, 3582, 3583, 3584, 3585, 3586, 3588, 3589, 3591, 3592, 3593, 3594, 3595, 3596, 3598, 3599, 3600, 3601, 3602, 3603, 3604, 3605, 3606, 3607, 3608, 3609, 3610, 3611, 3612, 3613, 3614, 3615, 3616, 3617, 3618, 3620, 3621, 3622, 3623, 3624, 3625, 3626, 3627, 3628, 3629, 3630, 3631, 3632, 3633, 3634, 3635, 3636, 3637, 3638, 3639, 3640, 3642, 3644, 3645, 3646, 3647, 3648, 3649, 3650, 3651, 3652, 3653, 3655, 3656, 3657, 3658, 3660, 3661, 3662, 3663, 3664, 3665, 3666, 3667, 3668, 3669, 3670, 3671, 3672, 3673, 3674, 3675, 3676, 3677, 3678, 3679, 3680, 3681, 3682, 3683, 3684, 3685, 3686, 3687, 3688, 3689, 3690, 3691, 3692, 3693, 3694, 3696, 3697, 3698, 3699, 3700, 3701, 3702, 3703, 3704, 3705, 3706, 3707, 3708, 3709, 3710, 3711, 3712, 3713, 3716, 3717, 3718, 3719, 3721, 3722, 3724, 3728, 3729, 3730, 3731, 3732, 3733, 3734, 3735, 3736, 3737, 3738, 3739, 3740, 3743, 3744, 3748, 3749, 3750, 3751, 3752, 3753, 3754, 3756, 3757, 3758, 3759, 3760, 3761, 3762, 3763, 3764, 3765, 3766, 3767, 3768, 3769, 3770, 3772, 3773, 3774, 3775, 3776, 3777, 3778, 3779, 3781, 3782, 3783, 3784, 3785, 3786, 3787, 3788, 3789, 3790, 3791, 3792, 3793, 3794, 3795, 3796, 3797, 3798, 3799, 3800, 3801, 3802, 3803, 3804, 3805, 3806, 3807, 3808, 3809, 3810, 3811, 3812, 3813, 3814, 3815, 3817, 3818, 3819, 3820, 3821, 3822, 3823, 3825, 3826, 3827, 3828, 3829, 3830, 3831, 3832, 3833, 3834, 3835, 3836, 3837, 3838, 3839, 3840, 3841, 3843, 3844, 3845, 3846, 3847, 3848, 3849, 3850, 3851, 3852, 3853, 3854, 3855, 3856, 3857, 3858, 3859, 3860, 3861, 3862, 3863, 3864, 3866, 3867, 3868, 3869, 3870, 3871, 3872, 3873, 3874, 3875, 3877, 3878, 3879, 3880, 3884, 3886, 3887, 3888, 3889, 3890, 3891, 3892, 3893, 3894, 3895, 3896, 3897, 3898, 3899, 3900, 3901, 3902, 3903, 3904, 3905, 3906, 3907, 3908, 3910, 3912, 3913, 3915, 3917, 3918, 3919, 3920, 3921, 3922, 3923, 3924, 3925, 3926, 3927, 3928, 3929, 3930, 3932, 3933, 3934, 3935, 3936, 3937, 3938, 3939, 3940, 3941, 3943, 3944, 3945, 3946, 3947, 3948, 3949, 3950, 3951, 3952, 3953, 3954, 3955, 3956, 3957, 3958, 3959, 3960, 3962, 3963, 3964, 3965, 3966, 3967, 3969, 3972, 3973, 3974, 3975, 3976, 3977, 3978, 3979, 3980, 3981, 3982, 3983, 3984, 3985, 3986, 3987, 3988, 3989, 3990, 3991, 3992, 3993, 3994, 3995, 3996, 3997, 3998, 3999, 4000, 4001, 4002, 4003, 4004, 4005, 4006, 4007, 4008, 4009, 4010, 4011, 4012, 4013, 4014, 4016, 4017, 4018, 4019, 4020, 4021, 4022, 4023, 4024, 4025, 4026, 4027, 4028, 4029, 4030, 4031, 4032, 4033, 4034, 4037, 4038, 4039, 4040, 4041, 4042, 4043, 4044, 4045, 4046, 4047, 4049, 4050, 4053, 4054, 4055, 4056, 4057, 4058, 4059, 4060, 4061, 4062, 4063, 4067, 4068, 4069, 4070, 4071, 4072, 4073, 4074, 4075, 4076, 4077, 4078, 4079, 4080, 4081, 4082, 4083, 4084, 4085, 4086, 4087, 4088, 4089, 4090, 4091, 4092, 4093, 4094, 4095, 4096, 4097, 4098, 4099, 4100, 4101, 4102, 4103, 4104, 4105, 4106, 4107, 4108, 4109, 4111, 4112, 4113, 4114, 4115, 4116, 4117, 4118, 4119, 4120, 4121, 4122, 4123, 4124, 4125, 4126, 4127, 4128, 4129, 4130, 4131, 4132, 4133, 4134, 4135, 4136, 4137, 4138, 4139, 4140, 4141, 4142, 4143, 4144, 4145, 4147, 4148, 4149, 4150, 4151, 4152, 4153, 4154, 4155, 4156, 4157, 4158, 4159, 4160, 4161, 4163, 4164, 4165, 4166, 4167, 4168, 4169, 4170, 4171, 4172, 4173, 4174, 4175, 4176, 4177, 4178, 4179, 4181, 4182, 4183, 4184, 4185, 4186, 4187, 4188, 4189, 4190, 4191, 4192, 4193, 4194, 4195, 4196, 4197, 4198, 4200, 4201, 4202, 4203, 4204, 4205, 4206, 4207, 4208, 4209, 4210, 4211, 4212, 4213, 4214, 4215, 4216, 4217, 4218, 4219, 4221, 4222, 4223, 4224, 4225, 4226, 4227, 4228, 4229, 4230, 4231, 4232, 4233, 4234, 4235, 4237, 4238, 4239, 4240, 4241, 4242, 4243, 4244, 4245, 4246, 4247, 4248, 4249, 4250, 4251, 4252, 4253, 4254, 4255, 4256, 4257, 4258, 4259, 4260, 4261, 4262, 4263, 4264, 4265, 4266, 4267, 4269, 4270, 4271, 4272, 4273, 4275, 4276, 4277, 4278, 4279, 4280, 4281, 4283, 4284, 4286, 4287, 4288, 4289, 4290, 4292, 4293, 4294, 4295, 4297, 4298, 4299, 4300, 4301, 4302, 4303, 4304, 4305, 4306, 4307, 4308, 4309, 4310, 4311, 4312, 4313, 4314, 4315, 4316, 4317, 4318, 4319, 4320, 4321, 4322, 4323, 4325, 4326, 4327, 4328, 4329, 4330, 4331, 4332, 4333, 4334, 4335, 4336, 4337, 4339, 4340, 4341, 4342, 4343, 4344, 4345, 4346, 4347, 4348, 4349, 4350, 4351, 4352, 4353, 4354, 4356, 4357, 4358, 4359, 4361, 4362, 4363, 4364, 4365, 4366, 4367, 4368, 4369, 4370, 4371, 4372, 4373, 4374, 4375, 4376, 4377, 4378, 4379, 4380, 4381, 4382, 4383, 4384, 4385, 4386, 4387, 4388, 4389, 4390, 4391, 4392, 4393, 4394, 4395, 4396, 4397, 4398, 4399, 4400, 4401, 4402, 4403, 4404, 4405, 4406, 4407, 4408, 4409, 4410, 4411, 4412, 4413, 4414, 4415, 4416, 4417, 4418, 4419, 4420, 4421, 4422, 4423, 4424, 4425, 4426, 4427, 4428, 4429, 4430, 4432, 4433, 4434, 4435, 4436, 4437, 4438, 4439, 4440, 4441, 4442, 4443, 4444, 4445, 4446, 4447, 4448, 4449, 4450, 4451, 4452, 4453, 4455, 4456, 4457, 4458, 4459, 4460, 4461, 4463, 4465, 4466, 4467, 4468, 4469, 4471, 4472, 4473, 4474, 4477, 4478, 4479, 4480, 4481, 4482, 4483, 4484, 4485, 4486, 4487, 4488, 4489, 4490, 4491, 4492, 4493, 4494, 4495, 4496, 4497, 4498, 4499, 4500, 4501, 4502, 4503, 4504, 4505, 4506, 4507, 4508, 4509, 4510, 4511, 4512, 4513, 4514, 4515, 4516, 4517, 4518, 4519, 4520, 4521, 4522, 4523, 4524, 4525, 4526, 4527, 4528, 4529, 4530, 4531, 4532, 4533, 4534, 4535, 4536, 4537, 4538, 4539, 4540, 4541, 4542, 4543, 4544, 4545, 4546, 4547, 4548, 4549, 4551, 4552, 4553, 4554, 4555, 4556, 4557, 4558, 4559, 4560, 4561, 4562, 4563, 4564, 4565, 4566, 4567, 4568, 4569, 4570, 4571, 4572, 4573, 4574, 4575, 4576, 4577, 4578, 4579, 4580, 4581, 4582, 4583, 4584, 4585, 4586, 4587, 4588, 4589, 4590, 4591, 4593, 4594, 4595, 4596, 4597, 4598, 4599, 4600, 4601, 4602, 4603, 4604, 4605, 4606, 4607, 4608, 4610, 4611, 4612, 4613, 4614, 4615, 4616, 4618, 4619, 4620, 4621, 4622, 4623, 4624, 4625, 4626, 4627, 4628, 4629, 4630, 4632, 4633, 4634, 4635, 4636, 4637, 4639, 4640, 4641, 4642, 4643, 4644, 4645, 4646, 4647, 4648, 4650, 4651, 4652, 4653, 4654, 4655, 4656, 4657, 4658, 4659, 4660, 4661, 4662, 4663, 4664, 4665, 4666, 4667, 4668, 4669, 4670, 4671, 4672, 4673, 4674, 4675, 4676, 4677, 4678, 4679, 4680, 4681, 4682, 4683, 4684, 4685, 4686, 4687, 4688, 4689, 4690, 4691, 4692, 4693, 4694, 4695, 4696, 4697, 4698, 4699, 4700, 4701, 4702, 4703, 4704, 4705, 4706, 4707, 4708, 4709, 4710, 4711, 4712, 4713, 4715, 4716, 4717, 4718, 4719, 4720, 4722, 4723, 4724, 4725, 4726, 4727, 4728, 4729, 4730, 4731, 4732, 4733, 4734, 4735, 4736, 4737, 4738, 4739, 4740, 4741, 4742, 4743, 4744, 4745, 4746, 4747, 4748, 4749, 4750, 4751, 4752, 4753, 4754, 4755, 4756, 4757, 4758, 4759, 4760, 4761, 4762, 4763, 4764, 4765, 4767, 4768, 4770, 4771, 4772, 4773, 4774, 4775, 4776, 4777, 4778, 4779, 4780, 4781, 4783, 4784, 4785, 4788, 4789, 4790, 4791, 4792, 4793, 4794, 4795, 4796, 4797, 4798, 4799, 4800, 4801, 4802, 4803, 4804, 4805, 4806, 4807, 4808, 4809, 4810, 4811, 4813, 4814, 4815, 4816, 4817, 4818, 4819, 4820, 4821, 4822, 4823, 4826, 4827, 4828, 4829, 4831, 4832, 4833, 4834, 4835, 4836, 4837, 4838, 4839, 4840, 4841, 4842, 4843, 4844, 4845, 4846, 4847, 4848, 4849, 4850, 4851, 4852, 4853, 4854, 4855, 4856, 4857, 4858, 4859, 4860, 4861, 4862, 4863, 4864, 4865, 4866, 4867, 4868, 4869, 4871, 4872, 4873, 4874, 4875, 4876, 4877, 4878, 4879, 4880, 4881, 4882, 4883, 4884, 4885, 4887, 4888, 4889, 4890, 4891, 4892, 4893, 4894, 4895, 4897, 4898, 4899, 4900, 4901, 4902, 4903, 4904, 4905, 4906, 4907, 4908, 4909, 4910, 4911, 4912, 4914, 4915, 4916, 4917, 4918, 4919, 4920, 4921, 4922, 4923, 4925, 4926, 4927, 4928, 4929, 4930, 4931, 4932, 4933, 4934, 4935, 4936, 4937, 4938, 4939, 4940, 4942, 4943, 4944, 4945, 4946, 4947, 4948, 4949, 4950, 4951, 4952, 4953, 4954, 4955, 4956, 4957, 4958, 4959, 4960, 4961, 4962, 4963, 4964, 4965, 4967, 4968, 4969, 4970, 4971, 4972, 4973, 4974, 4975, 4977, 4978, 4979, 4980, 4981, 4982, 4983, 4984, 4986, 4987, 4988, 4989, 4990, 4991, 4993, 4994, 4995, 4996, 4997, 4998, 4999, 5000, 5001, 5002, 5003, 5004, 5005, 5006, 5007, 5009, 5010, 5011, 5012, 5013, 5014, 5015, 5016, 5017, 5018, 5019, 5020, 5021, 5022, 5023, 5024, 5025, 5026, 5027, 5028, 5029, 5031, 5032, 5033, 5034, 5035, 5036, 5037, 5038, 5039, 5040, 5041, 5042, 5043, 5044, 5045, 5046, 5047, 5048, 5049, 5050, 5051, 5052, 5055, 5056, 5057, 5058, 5059, 5060, 5061, 5062, 5063, 5064, 5065, 5066, 5067, 5068, 5069, 5070, 5071, 5072, 5073, 5074, 5075, 5076, 5077, 5078, 5079, 5080, 5081, 5082, 5083, 5084, 5085, 5086, 5087, 5090, 5091, 5092, 5093, 5095, 5096, 5097, 5098, 5099, 5100, 5101, 5102, 5103, 5104, 5105, 5106, 5107, 5108, 5109, 5110, 5111, 5112, 5113, 5114, 5115, 5116, 5117, 5118, 5119, 5120, 5121, 5122, 5123, 5124, 5125, 5126, 5127, 5128, 5129, 5130, 5131, 5132, 5133, 5134, 5135, 5136, 5137, 5138, 5139, 5140, 5141, 5142, 5143, 5144, 5145, 5148, 5149, 5150, 5151, 5152, 5155, 5156, 5157, 5158, 5159, 5160, 5161, 5162, 5163, 5164, 5165, 5166, 5167, 5168, 5169, 5170, 5171, 5172, 5174, 5175, 5176, 5178, 5179, 5181, 5182, 5183, 5185, 5186, 5187, 5188, 5190, 5191, 5192, 5193, 5194, 5195, 5196, 5197, 5198, 5199, 5200, 5201, 5202, 5203, 5204, 5205, 5206, 5207, 5208, 5209, 5210, 5211, 5212, 5213, 5214, 5215, 5216, 5217, 5218, 5219, 5220, 5221, 5224, 5225, 5226, 5229, 5230, 5231, 5232, 5233, 5236, 5237, 5238, 5239, 5240, 5241, 5242, 5243, 5245, 5246, 5247, 5248, 5249, 5250, 5251, 5252, 5253, 5256, 5257, 5258, 5259, 5260, 5261, 5262, 5263, 5264, 5265, 5266, 5267, 5268, 5269, 5270, 5271, 5272, 5273, 5274, 5275, 5276, 5277, 5278, 5279, 5280, 5281, 5282, 5283, 5284, 5285, 5286, 5287, 5288, 5289, 5290, 5291, 5292, 5294, 5295, 5296, 5297, 5298, 5299, 5300, 5301, 5302, 5303, 5304, 5305, 5306, 5307, 5308, 5309, 5310, 5311, 5312, 5313, 5314, 5315, 5316, 5317, 5319, 5320, 5321, 5323, 5324, 5325, 5326, 5327, 5328, 5329, 5330, 5331, 5333, 5334, 5335, 5336, 5337, 5338, 5339, 5340, 5341, 5342, 5343, 5344, 5345, 5346, 5347, 5348, 5350, 5351, 5352, 5353, 5354, 5355, 5356, 5357, 5358, 5359, 5361, 5362, 5363, 5364, 5365, 5366, 5367, 5368, 5369, 5370, 5371, 5372, 5373, 5375, 5376, 5377, 5378, 5379, 5380, 5381, 5383, 5384, 5385, 5386, 5387, 5388, 5389, 5390, 5391, 5392, 5393, 5394, 5396, 5397, 5398, 5399, 5400, 5401, 5402, 5403, 5404, 5405, 5406, 5407, 5408, 5409, 5410, 5411, 5412, 5413, 5414, 5416, 5417, 5418, 5419, 5420, 5422, 5423, 5424, 5425, 5426, 5427, 5428, 5429, 5430, 5431, 5432, 5433, 5434, 5435, 5437, 5438, 5439, 5440, 5441, 5442, 5443, 5444, 5445, 5446, 5447, 5448, 5449, 5450, 5451, 5452, 5453, 5454, 5455, 5456, 5457, 5458, 5459, 5460, 5461, 5462, 5463, 5464, 5465, 5466, 5467, 5468, 5469, 5470, 5471, 5472, 5473, 5474, 5475, 5476, 5477, 5478, 5479, 5480, 5481, 5482, 5483, 5484, 5485, 5486, 5487, 5488, 5489, 5490, 5491, 5492, 5493, 5494, 5495, 5496, 5497, 5498, 5499, 5500, 5501, 5502, 5503, 5504, 5505, 5506, 5507, 5508, 5509, 5510, 5511, 5512, 5513, 5514, 5515, 5516, 5517, 5518, 5519, 5520, 5521, 5522, 5523, 5524, 5525, 5526, 5527, 5529, 5530, 5531, 5532, 5533, 5534, 5535, 5536, 5537, 5538, 5539, 5540, 5541, 5542, 5543, 5544, 5545, 5547, 5548, 5549, 5550, 5551, 5552, 5554, 5555, 5556, 5557, 5558, 5559, 5560, 5561, 5562, 5563, 5564, 5565, 5566, 5567, 5568, 5569, 5570, 5571, 5572, 5573, 5574, 5575, 5576, 5577, 5578, 5579, 5580, 5581, 5582, 5583, 5584, 5585, 5586, 5587, 5588, 5589, 5590, 5591, 5592, 5593, 5594, 5595, 5596, 5597, 5598, 5600, 5601, 5602, 5603, 5604, 5605, 5606, 5607, 5608, 5609, 5610, 5612, 5613, 5614, 5615, 5616, 5617, 5618, 5620, 5622, 5623, 5624, 5625, 5626, 5627, 5628, 5629, 5630, 5631, 5633, 5634, 5635, 5636, 5637, 5639, 5640, 5642, 5643, 5645, 5646, 5647, 5648, 5649, 5650, 5651, 5652, 5653, 5654, 5655, 5656, 5657, 5658, 5659, 5660, 5661, 5662, 5663, 5664, 5665, 5666, 5667, 5668, 5669, 5670, 5671, 5672, 5673, 5674, 5676, 5677, 5678, 5679, 5680, 5681, 5682, 5683, 5684, 5685, 5686, 5688, 5689, 5690, 5691, 5692, 5693, 5694, 5695, 5696, 5697, 5698, 5699, 5700, 5701, 5702, 5703, 5704, 5705, 5706, 5707, 5708, 5709, 5711, 5712, 5713, 5714, 5716, 5717, 5718, 5720, 5721, 5722, 5723, 5724, 5726, 5728, 5729, 5730, 5731, 5732, 5733, 5734, 5735, 5736, 5737, 5739, 5740, 5741, 5742, 5743, 5744, 5745, 5746, 5747, 5748, 5749, 5751, 5752, 5753, 5754, 5755, 5756, 5757, 5758, 5759, 5760, 5761, 5762, 5763, 5764, 5765, 5766, 5767, 5768, 5769, 5771, 5772, 5773, 5774, 5775, 5776, 5777, 5778, 5779, 5780, 5781, 5782, 5783, 5784, 5785, 5786, 5787, 5788, 5789, 5791, 5792, 5793, 5794, 5795, 5796, 5797, 5798, 5799, 5800, 5801, 5802, 5803, 5804, 5805, 5806, 5808, 5809, 5810, 5811, 5813, 5814, 5815, 5816, 5817, 5819, 5820, 5821, 5822, 5823, 5825, 5826, 5827, 5828, 5829, 5830, 5831, 5832, 5833, 5834, 5835, 5836, 5837, 5838, 5839, 5840, 5841, 5842, 5843, 5844, 5846, 5847, 5848, 5849, 5850, 5851, 5852, 5853, 5854, 5855, 5856, 5857, 5858, 5859, 5860, 5861, 5862, 5863, 5864, 5865, 5866, 5868, 5869, 5870, 5871, 5872, 5874, 5875, 5876, 5877, 5878, 5880, 5881, 5882, 5883, 5884, 5886, 5887, 5888, 5889, 5890, 5891, 5892, 5893, 5894, 5895, 5896, 5897, 5898, 5899, 5900, 5901, 5902, 5903, 5904, 5905, 5907, 5908, 5909, 5910, 5912, 5913, 5914, 5915, 5916, 5917, 5918, 5919, 5920, 5921, 5922, 5924, 5925, 5926, 5927, 5928, 5929, 5932, 5933, 5934, 5935, 5936, 5937, 5938, 5939, 5940, 5942, 5943, 5944, 5945, 5946, 5947, 5948, 5949, 5950, 5952, 5953, 5954, 5955, 5956, 5957, 5960, 5962, 5963, 5965, 5966, 5967, 5968, 5969, 5970, 5971, 5972, 5973, 5974, 5975, 5976, 5977, 5978, 5979, 5980, 5981, 5983, 5984, 5985, 5986, 5987, 5988, 5989, 5991, 5992, 5993, 5994, 5995, 5996, 5997, 5998, 5999, 6000, 6001, 6002, 6003, 6004, 6005, 6006, 6007, 6008, 6009, 6010, 6011, 6012, 6013, 6015, 6016, 6017, 6018, 6019, 6021, 6022, 6023, 6024, 6025, 6027, 6028, 6029, 6030, 6031, 6032, 6034, 6036, 6037, 6040, 6041, 6042, 6043, 6044, 6045, 6046, 6047, 6048, 6049, 6051, 6052, 6053, 6055, 6056, 6057, 6058, 6059, 6060, 6061, 6063, 6064, 6065, 6066, 6067, 6068, 6069, 6070, 6071, 6072, 6073, 6074, 6075, 6076, 6077, 6078, 6079, 6080, 6081, 6083, 6084, 6085, 6086, 6087, 6088, 6089, 6090, 6091, 6092, 6093, 6094, 6095, 6096, 6097, 6099, 6100, 6101, 6102, 6103, 6104, 6105, 6106, 6107, 6108, 6109, 6111, 6112, 6113, 6114, 6115, 6116, 6117, 6119, 6120, 6121, 6122, 6123, 6124, 6126, 6127, 6128, 6129, 6130, 6131, 6132, 6133, 6134, 6135, 6136, 6137, 6139, 6140, 6141, 6142, 6143, 6144, 6145, 6146, 6147, 6148, 6149, 6150, 6151, 6152, 6153, 6154, 6155, 6156, 6157, 6158, 6159, 6160, 6161, 6162, 6163, 6164, 6165, 6166, 6167, 6168, 6169, 6170, 6171, 6172, 6173, 6174, 6175, 6176, 6178, 6179, 6180, 6181, 6182, 6183, 6184, 6185, 6186, 6187, 6189, 6190, 6191, 6192, 6193, 6194, 6195, 6196, 6197, 6198, 6200, 6201, 6202, 6203, 6204, 6205, 6206, 6207, 6208, 6209, 6210, 6211, 6212, 6213, 6214, 6215, 6216, 6217, 6218, 6220, 6221, 6222, 6223, 6224, 6225, 6226, 6227, 6228, 6229, 6230, 6231, 6232, 6233, 6234, 6235, 6236, 6237, 6238, 6239, 6240, 6241, 6242, 6243, 6244, 6245, 6246, 6247, 6248, 6249, 6250, 6251, 6252, 6253, 6254, 6255, 6256, 6257, 6258, 6259, 6260, 6261, 6262, 6263, 6264, 6265, 6266, 6267, 6269, 6270, 6271, 6272, 6273, 6274, 6275, 6276, 6277, 6278, 6279, 6280, 6281, 6282, 6283, 6284, 6285, 6286, 6287, 6288, 6289, 6290, 6291, 6292, 6293, 6294, 6295, 6296, 6297, 6298, 6300, 6301, 6302, 6303, 6304, 6305, 6306, 6307, 6308, 6309, 6310, 6311, 6313, 6314, 6315, 6316, 6317, 6318, 6319, 6320, 6321, 6322, 6323, 6324, 6325, 6326, 6327, 6328, 6329, 6330, 6331, 6332, 6333, 6334, 6335, 6336, 6338, 6339, 6340, 6341, 6342, 6343, 6344, 6345, 6346, 6347, 6348, 6349, 6350, 6351, 6352, 6353, 6354, 6355, 6356, 6357, 6358, 6359, 6360, 6361, 6362, 6363, 6364, 6369, 6370, 6371, 6372, 6373, 6374, 6375, 6376, 6377, 6378, 6379, 6380, 6381, 6382, 6383, 6384, 6385, 6386, 6387, 6388, 6389, 6390, 6391, 6392, 6393, 6394, 6395, 6396, 6399, 6401, 6402, 6404, 6405, 6407, 6408, 6410, 6411, 6412, 6413, 6414, 6415, 6416, 6417, 6418, 6419, 6420, 6421, 6422, 6423, 6424, 6425, 6426, 6427, 6428, 6429, 6430, 6431, 6433, 6434, 6435, 6436, 6437, 6438, 6439, 6440, 6441, 6442, 6443, 6444, 6445, 6446, 6447, 6448, 6449, 6450, 6452, 6453, 6454, 6455, 6457, 6458, 6460, 6461, 6462, 6463, 6464, 6467, 6468, 6469, 6470, 6471, 6472, 6473, 6474, 6475, 6476, 6477, 6478, 6479, 6481, 6482, 6483, 6484, 6485, 6486, 6487, 6488, 6489, 6491, 6492, 6493, 6494, 6495, 6496, 6497, 6498, 6499, 6500, 6501, 6502, 6503, 6504, 6505, 6506, 6507, 6508, 6509, 6510, 6511, 6512, 6513, 6514, 6515, 6516, 6517, 6518, 6519, 6520, 6521, 6522, 6523, 6524, 6525, 6526, 6527, 6528, 6529, 6530, 6531, 6532, 6533, 6534, 6535, 6536, 6537, 6538, 6539, 6540, 6541, 6542, 6543, 6544, 6545, 6547, 6548, 6552, 6553, 6554, 6555, 6556, 6557, 6558, 6559, 6560, 6561, 6562, 6563, 6564, 6565, 6566, 6568, 6569, 6570, 6571, 6572, 6573, 6575, 6576, 6577, 6578, 6579, 6580, 6581, 6582, 6583, 6584, 6585, 6586, 6587, 6589, 6590, 6591, 6592, 6593, 6594, 6595, 6596, 6597, 6598, 6600, 6601, 6602, 6603, 6604, 6605, 6606, 6607, 6608, 6609, 6610, 6611, 6612, 6613, 6614, 6615, 6616, 6617, 6618, 6619, 6620, 6621, 6622, 6623, 6624, 6625, 6626, 6627, 6628, 6629, 6630, 6631, 6632, 6633, 6634, 6635, 6636, 6637, 6639, 6640, 6641, 6642, 6643, 6644, 6645, 6646, 6647, 6648, 6649, 6650, 6651, 6652, 6653, 6654, 6655, 6656, 6657, 6658, 6659, 6660, 6661, 6662, 6663, 6664, 6665, 6666, 6667, 6668, 6669, 6670, 6671, 6672, 6673, 6675, 6676, 6677, 6678, 6679, 6680, 6681, 6682, 6683, 6684, 6685, 6686, 6687, 6688, 6689, 6690, 6691, 6692, 6693, 6694, 6695, 6696, 6697, 6698, 6699, 6700, 6701, 6702, 6703, 6704, 6705, 6706, 6707, 6708, 6709, 6710, 6711, 6712, 6713, 6714, 6715, 6716, 6717, 6718, 6719, 6720, 6721, 6722, 6723, 6724, 6725, 6726, 6727, 6728, 6729, 6730, 6731, 6732, 6733, 6734, 6735, 6736, 6737, 6738, 6739, 6740, 6741, 6742, 6743, 6744, 6745, 6747, 6748, 6750, 6751, 6752, 6753, 6754, 6755, 6756, 6757, 6759, 6760, 6762, 6764, 6765, 6766, 6767, 6768, 6769, 6770, 6771, 6773, 6774, 6775, 6776, 6777, 6778, 6779, 6780, 6781, 6782, 6783, 6784, 6785, 6786, 6787, 6788, 6789, 6790, 6791, 6792, 6793}",6260,"{2051, 2443, 2056, 2057, 2058, 2060, 2061, 2062, 2066, 2067, 5652, 2070, 2071, 2073, 5658, 2075, 5663, 5667, 5668, 4654, 5680, 4663, 4664, 1081, 2111, 5699, 4687, 2139, 4701, 4703, 4705, 4706, 4708, 4709, 4710, 4711, 4712, 4713, 4715, 4716, 4717, 2155, 4719, 2164, 2166, 4727, 2168, 4729, 2169, 1145, 2173, 2174, 4739, 4740, 2184, 1160, 2188, 2189, 2191, 2194, 1170, 2197, 4764, 1180, 4767, 2210, 2211, 4772, 4773, 4774, 1187, 4776, 1188, 1191, 4779, 4780, 1197, 5631, 4784, 1201, 1206, 2232, 1208, 1209, 1215, 1216, 1222, 1737, 6362, 4829, 2269, 4833, 4835, 4836, 4332, 4844, 1775, 4848, 2302, 2304, 3848, 3849, 4872, 3851, 2313, 3854, 3855, 3860, 3861, 3862, 3863, 3864, 4887, 3866, 3867, 1819, 5405, 3872, 2339, 4393, 2349, 2350, 2351, 5936, 2354, 5944, 6460, 5950, 4929, 5955, 5957, 5965, 5967, 1871, 2384, 2385, 5972, 5973, 5974, 5975, 5976, 5465, 5978, 2391, 5983, 5989, 5993, 5994, 5995, 4972, 4973, 4974, 4975, 2411, 1900, 6002, 6003, 6008, 6010, 1916, 6013, 5508, 5509, 5512, 6536, 6537, 5003, 6538, 5516, 5006, 6539, 6540, 6541, 5520, 6542, 6544, 1939, 5014, 5017, 5018, 5019, 1945, 6558, 1951, 5027, 1958, 5544, 5545, 1966, 5551, 5043, 5556, 6586, 6591, 6592, 5570, 5572, 5578, 6603, 5581, 1997, 1999, 2001, 2006, 1496, 5594, 989, 2016, 2019, 2023, 5609, 2027, 2028, 2440, 2040, 4606, 2047}",217,"{0, 1, 2, 3, 4, 5, 6, 7, 8, 9, 10, 11, 12, 14, 15, 16, 17, 18, 20, 21, 22, 23, 24, 25, 27, 28, 29, 30, 31, 32, 33, 34, 35, 36, 37, 38, 39, 42, 43, 44, 45, 46, 47, 48, 49, 50, 51, 52, 53, 54, 55, 56, 57, 58, 59, 60, 61, 62, 64, 65, 66, 67, 68, 69, 70, 71, 72, 73, 74, 75, 78, 79, 80, 81, 83, 84, 85, 86, 88, 89, 90, 91, 92, 93, 94, 95, 96, 97, 98, 99, 100, 101, 102, 103, 104, 105, 106, 107, 108, 109, 110, 111, 112, 113, 114, 116, 118, 123, 124, 125, 126, 127, 128, 129, 130, 131, 132, 133, 134, 135, 136, 137, 138, 139, 140, 141, 143, 144, 145, 146, 147, 148, 149, 150, 151, 153, 154, 155, 156, 158, 159, 160, 161, 162, 163, 164, 165, 166, 167, 168, 169, 171, 172, 175, 176, 179, 180, 181, 182, 183, 184, 185, 186, 187, 188, 189, 190, 191, 192, 193, 194, 195, 196, 198, 199, 200, 201, 202, 203, 204, 205, 206, 207, 208, 209, 210, 211, 212, 213, 214, 215, 216, 217, 218, 219, 220, 221, 222, 223, 224, 225, 226, 227, 228, 229, 230, 231, 232, 234, 235, 236, 237, 238, 239, 240, 241, 242, 243, 244, 245, 246, 247, 248, 249, 250, 251, 252, 253, 254, 256, 257, 258, 259, 260, 261, 262, 263, 264, 265, 266, 267, 268, 269, 271, 272, 273, 274, 275, 276, 277, 278, 279, 280, 281, 282, 283, 284, 285, 286, 287, 288, 289, 290, 291, 292, 293, 294, 295, 296, 297, 298, 300, 301, 302, 303, 305, 307, 310, 311, 312, 313, 314, 315, 316, 317, 318, 321, 322, 323, 324, 325, 326, 327, 331, 332, 333, 334, 335, 336, 337, 338, 339, 340, 341, 342, 343, 344, 345, 346, 348, 349, 350, 351, 352, 353, 356, 357, 358, 359, 360, 361, 362, 363, 364, 365, 366, 367, 368, 369, 370, 372, 373, 375, 376, 377, 378, 379, 380, 382, 383, 384, 385, 386, 387, 388, 389, 390, 391, 392, 393, 394, 395, 396, 397, 398, 399, 400, 401, 402, 403, 404, 405, 406, 407, 408, 409, 410, 411, 414, 415, 416, 417, 418, 419, 420, 421, 422, 423, 424, 425, 426, 427, 428, 429, 430, 431, 433, 434, 435, 436, 437, 438, 439, 440, 441, 443, 444, 445, 446, 447, 449, 450, 451, 452, 453, 454, 456, 457, 458, 459, 460, 461, 462, 463, 464, 466, 467, 468, 469, 470, 471, 473, 474, 475, 476, 477, 478, 479, 481, 482, 483, 484, 486, 487, 488, 489, 490, 491, 492, 493, 494, 495, 496, 497, 498, 499, 500, 501, 502, 503, 504, 505, 506, 508, 509, 510, 511, 512, 513, 514, 515, 516, 518, 519, 520, 521, 522, 523, 524, 525, 526, 527, 528, 530, 531, 533, 534, 535, 536, 537, 538, 539, 540, 541, 542, 543, 544, 545, 546, 547, 548, 549, 550, 551, 552, 553, 554, 555, 556, 557, 558, 559, 560, 561, 562, 563, 565, 566, 567, 568, 569, 570, 571, 572, 573, 574, 575, 576, 577, 578, 580, 582, 583, 584, 585, 586, 590, 591, 593, 594, 596, 597, 598, 599, 600, 601, 602, 603, 604, 605, 606, 607, 608, 610, 611, 612, 613, 614, 616, 617, 618, 620, 621, 622, 623, 624, 625, 626, 627, 628, 629, 631, 632, 633, 634, 635, 636, 637, 638, 639, 640, 641, 642, 643, 644, 645, 646, 647, 648, 649, 650, 651, 652, 653, 654, 655, 656, 657, 658, 659, 660, 661, 662, 663, 664, 665, 666, 667, 668, 669, 670, 671, 672, 673, 674, 675, 676, 677, 678, 679, 680, 681, 682, 683, 684, 685, 686, 687, 688, 689, 690, 693, 695, 696, 697, 698, 699, 700, 701, 702, 703, 704, 705, 706, 707, 708, 709, 710, 711, 712, 713, 714, 715, 716, 717, 718, 719, 720, 721, 722, 723, 724, 725, 726, 727, 728, 729, 730, 731, 732, 733, 734, 735, 736, 737, 738, 739, 740, 741, 742, 743, 744, 745, 746, 748, 749, 750, 751, 752, 753, 754, 755, 756, 757, 758, 759, 760, 761, 762, 763, 764, 765, 766, 767, 768, 769, 770, 771, 773, 774, 775, 776, 777, 778, 779, 780, 781, 782, 783, 784, 785, 786, 787, 788, 789, 790, 791, 792, 794, 795, 796, 797, 798, 799, 800, 801, 802, 803, 804, 805, 806, 807, 808, 809, 810, 811, 812, 813, 814, 815, 816, 817, 819, 820, 821, 824, 825, 826, 828, 829, 830, 831, 832, 833, 834, 835, 836, 837, 838, 839, 840, 841, 842, 843, 844, 845, 846, 847, 848, 849, 850, 851, 852, 854, 855, 856, 857, 858, 859, 860, 861, 862, 864, 865, 866, 867, 868, 869, 870, 871, 872, 873, 874, 875, 876, 877, 878, 879, 880, 881, 882, 883, 884, 885, 886, 887, 888, 889, 890, 891, 892, 893, 894, 895, 896, 897, 898, 899, 900, 901, 902, 903, 904, 905, 906, 907, 908, 909, 910, 911, 912, 913, 914, 915, 916, 917, 918, 919, 920, 921, 922, 923, 924, 925, 926, 927, 928, 929, 930, 931, 932, 933, 935, 936, 937, 939, 940, 941, 942, 943, 944, 945, 946, 947, 948, 949, 950, 951, 952, 953, 954, 955, 956, 957, 958, 959, 960, 961, 962, 963, 964, 965, 966, 967, 968, 969, 970, 971, 972, 973, 974, 975, 976, 977, 978, 979, 980, 981, 982, 983, 984, 985, 986, 987, 988, 990, 991, 992, 993, 994, 996, 997, 999, 1000, 1001, 1002, 1003, 1004, 1005, 1006, 1007, 1008, 1009, 1010, 1011, 1012, 1013, 1014, 1015, 1016, 1017, 1018, 1019, 1020, 1021, 1022, 1023, 1024, 1025, 1026, 1028, 1029, 1030, 1031, 1032, 1033, 1034, 1036, 1037, 1038, 1039, 1040, 1041, 1042, 1043, 1044, 1045, 1046, 1047, 1048, 1050, 1051, 1052, 1053, 1054, 1055, 1056, 1057, 1058, 1059, 1060, 1061, 1063, 1064, 1065, 1066, 1067, 1069, 1070, 1071, 1073, 1074, 1075, 1076, 1077, 1078, 1079, 1080, 1082, 1083, 1085, 1086, 1087, 1088, 1089, 1090, 1092, 1093, 1094, 1095, 1096, 1097, 1098, 1099, 1100, 1101, 1103, 1104, 1105, 1106, 1107, 1108, 1109, 1110, 1111, 1112, 1113, 1114, 1115, 1116, 1117, 1118, 1119, 1120, 1121, 1122, 1123, 1124, 1125, 1126, 1127, 1128, 1129, 1130, 1131, 1132, 1133, 1134, 1135, 1136, 1137, 1138, 1140, 1141, 1142, 1143, 1144, 1146, 1147, 1148, 1149, 1150, 1151, 1152, 1153, 1154, 1155, 1156, 1157, 1158, 1159, 1161, 1162, 1163, 1165, 1166, 1167, 1168, 1169, 1171, 1172, 1173, 1174, 1175, 1176, 1177, 1178, 1179, 1181, 1182, 1183, 1184, 1185, 1186, 1189, 1190, 1192, 1193, 1194, 1195, 1196, 1198, 1199, 1200, 1202, 1203, 1204, 1205, 1207, 1210, 1211, 1212, 1213, 1214, 1217, 1218, 1219, 1220, 1221, 1223, 1224, 1225, 1226, 1227, 1228, 1229, 1230, 1231, 1232, 1233, 1234, 1235, 1236, 1237, 1238, 1239, 1240, 1241, 1242, 1243, 1244, 1245, 1246, 1247, 1248, 1249, 1250, 1251, 1252, 1253, 1254, 1255, 1258, 1259, 1260, 1262, 1263, 1264, 1265, 1267, 1268, 1269, 1270, 1271, 1272, 1273, 1274, 1275, 1276, 1277, 1278, 1279, 1280, 1281, 1282, 1283, 1284, 1285, 1286, 1287, 1288, 1289, 1290, 1291, 1292, 1293, 1294, 1295, 1298, 1299, 1300, 1301, 1302, 1303, 1304, 1305, 1306, 1307, 1308, 1309, 1310, 1311, 1313, 1314, 1315, 1316, 1317, 1318, 1320, 1321, 1323, 1324, 1325, 1326, 1327, 1328, 1329, 1330, 1331, 1332, 1333, 1334, 1335, 1336, 1337, 1338, 1339, 1340, 1342, 1343, 1344, 1345, 1346, 1347, 1348, 1349, 1350, 1351, 1352, 1353, 1354, 1355, 1356, 1357, 1358, 1359, 1360, 1361, 1362, 1364, 1365, 1366, 1367, 1368, 1369, 1370, 1371, 1372, 1373, 1374, 1375, 1376, 1377, 1378, 1379, 1380, 1381, 1382, 1383, 1384, 1385, 1386, 1387, 1388, 1389, 1390, 1391, 1392, 1393, 1394, 1395, 1396, 1397, 1399, 1400, 1401, 1402, 1403, 1404, 1405, 1406, 1407, 1408, 1409, 1410, 1411, 1412, 1413, 1414, 1415, 1416, 1418, 1419, 1420, 1421, 1422, 1423, 1424, 1426, 1427, 1428, 1429, 1430, 1431, 1432, 1433, 1434, 1435, 1436, 1437, 1439, 1440, 1441, 1442, 1443, 1445, 1446, 1447, 1448, 1449, 1450, 1451, 1452, 1453, 1454, 1455, 1456, 1457, 1458, 1459, 1460, 1461, 1462, 1464, 1465, 1466, 1467, 1468, 1469, 1470, 1471, 1472, 1473, 1474, 1475, 1476, 1477, 1478, 1479, 1481, 1482, 1483, 1484, 1485, 1487, 1488, 1489, 1491, 1492, 1493, 1494, 1495, 1499, 1500, 1501, 1502, 1503, 1504, 1505, 1506, 1507, 1508, 1509, 1510, 1511, 1512, 1513, 1514, 1515, 1516, 1517, 1518, 1519, 1520, 1521, 1522, 1523, 1524, 1525, 1526, 1527, 1528, 1529, 1530, 1531, 1532, 1533, 1534, 1535, 1536, 1538, 1539, 1540, 1541, 1542, 1543, 1544, 1545, 1546, 1548, 1549, 1550, 1551, 1552, 1553, 1554, 1556, 1557, 1558, 1559, 1560, 1561, 1562, 1563, 1564, 1565, 1566, 1567, 1568, 1569, 1570, 1571, 1572, 1573, 1574, 1575, 1576, 1577, 1578, 1579, 1580, 1581, 1582, 1583, 1584, 1585, 1586, 1587, 1588, 1589, 1590, 1591, 1592, 1593, 1594, 1595, 1596, 1597, 1598, 1599, 1600, 1601, 1602, 1603, 1604, 1605, 1606, 1607, 1608, 1609, 1610, 1612, 1613, 1614, 1615, 1616, 1617, 1618, 1619, 1620, 1621, 1622, 1623, 1624, 1625, 1626, 1627, 1628, 1629, 1630, 1631, 1632, 1633, 1634, 1635, 1636, 1637, 1638, 1639, 1640, 1641, 1642, 1643, 1644, 1645, 1646, 1647, 1648, 1649, 1650, 1651, 1652, 1653, 1654, 1655, 1656, 1657, 1658, 1659, 1660, 1661, 1662, 1663, 1664, 1665, 1666, 1667, 1668, 1669, 1670, 1671, 1672, 1673, 1674, 1675, 1676, 1678, 1679, 1680, 1681, 1682, 1683, 1684, 1685, 1686, 1687, 1688, 1689, 1690, 1691, 1692, 1693, 1694, 1695, 1696, 1697, 1698, 1699, 1700, 1701, 1702, 1703, 1704, 1705, 1706, 1707, 1708, 1709, 1710, 1711, 1712, 1713, 1714, 1715, 1716, 1717, 1718, 1719, 1720, 1721, 1722, 1723, 1724, 1725, 1726, 1727, 1728, 1729, 1730, 1731, 1732, 1734, 1735, 1736, 1738, 1739, 1740, 1741, 1742, 1743, 1744, 1745, 1746, 1747, 1748, 1749, 1752, 1753, 1754, 1755, 1756, 1757, 1758, 1759, 1760, 1761, 1762, 1764, 1765, 1766, 1767, 1768, 1769, 1770, 1771, 1772, 1773, 1774, 1776, 1778, 1779, 1780, 1781, 1782, 1783, 1784, 1785, 1786, 1787, 1788, 1789, 1790, 1791, 1792, 1793, 1795, 1796, 1797, 1798, 1799, 1800, 1801, 1802, 1803, 1804, 1805, 1806, 1807, 1808, 1809, 1810, 1811, 1812, 1813, 1814, 1815, 1816, 1817, 1818, 1820, 1821, 1822, 1823, 1824, 1825, 1826, 1827, 1828, 1829, 1830, 1831, 1832, 1833, 1834, 1835, 1836, 1837, 1838, 1839, 1840, 1841, 1842, 1843, 1844, 1845, 1846, 1847, 1848, 1849, 1850, 1851, 1852, 1853, 1854, 1855, 1857, 1858, 1859, 1860, 1861, 1862, 1863, 1864, 1865, 1866, 1867, 1868, 1869, 1870, 1872, 1873, 1874, 1875, 1876, 1877, 1878, 1879, 1880, 1881, 1882, 1883, 1884, 1885, 1886, 1887, 1888, 1889, 1890, 1891, 1892, 1893, 1894, 1895, 1896, 1897, 1898, 1899, 1901, 1902, 1903, 1904, 1905, 1907, 1908, 1909, 1910, 1911, 1912, 1914, 1915, 1918, 1919, 1920, 1921, 1922, 1923, 1924, 1925, 1926, 1927, 1928, 1929, 1930, 1931, 1932, 1934, 1936, 1937, 1938, 1940, 1941, 1942, 1943, 1944, 1946, 1947, 1948, 1949, 1950, 1952, 1954, 1955, 1956, 1957, 1959, 1960, 1961, 1962, 1963, 1964, 1965, 1967, 1968, 1969, 1970, 1971, 1972, 1973, 1974, 1975, 1976, 1977, 1978, 1979, 1980, 1981, 1982, 1983, 1984, 1985, 1986, 1987, 1988, 1990, 1991, 1992, 1993, 1994, 1995, 1996, 1998, 2000, 2002, 2003, 2004, 2005, 2007, 2008, 2009, 2010, 2011, 2012, 2014, 2015, 2017, 2018, 2020, 2021, 2022, 2024, 2025, 2026, 2029, 2030, 2031, 2032, 2033, 2034, 2035, 2036, 2037, 2038, 2039, 2041, 2042, 2043, 2044, 2045, 2046, 2049, 2050, 2052, 2053, 2055, 2059, 2063, 2064, 2065, 2068, 2069, 2074, 2076, 2077, 2079, 2080, 2081, 2082, 2083, 2084, 2085, 2086, 2087, 2088, 2089, 2090, 2091, 2092, 2094, 2095, 2096, 2097, 2098, 2099, 2100, 2101, 2102, 2103, 2104, 2106, 2107, 2108, 2109, 2110, 2112, 2113, 2114, 2115, 2116, 2117, 2118, 2119, 2120, 2121, 2122, 2123, 2124, 2125, 2126, 2128, 2129, 2130, 2131, 2132, 2133, 2134, 2135, 2137, 2138, 2140, 2141, 2142, 2143, 2144, 2146, 2147, 2148, 2149, 2150, 2151, 2152, 2153, 2154, 2156, 2157, 2158, 2159, 2160, 2161, 2162, 2163, 2167, 2170, 2171, 2172, 2175, 2176, 2177, 2178, 2179, 2180, 2181, 2182, 2183, 2185, 2186, 2187, 2190, 2192, 2193, 2195, 2196, 2198, 2200, 2201, 2202, 2203, 2204, 2205, 2206, 2207, 2208, 2209, 2212, 2213, 2214, 2215, 2216, 2217, 2218, 2219, 2220, 2221, 2222, 2223, 2224, 2225, 2226, 2228, 2229, 2230, 2231, 2233, 2234, 2235, 2236, 2237, 2239, 2240, 2241, 2242, 2243, 2244, 2245, 2246, 2247, 2248, 2249, 2250, 2251, 2252, 2253, 2254, 2255, 2259, 2260, 2261, 2262, 2263, 2264, 2265, 2266, 2267, 2268, 2270, 2271, 2272, 2273, 2274, 2275, 2276, 2277, 2280, 2281, 2282, 2283, 2284, 2285, 2287, 2288, 2289, 2290, 2291, 2292, 2293, 2294, 2295, 2296, 2297, 2298, 2299, 2300, 2301, 2303, 2305, 2306, 2307, 2309, 2310, 2311, 2312, 2315, 2316, 2317, 2318, 2319, 2320, 2321, 2322, 2323, 2324, 2325, 2327, 2328, 2329, 2330, 2331, 2332, 2333, 2334, 2335, 2336, 2337, 2338, 2340, 2341, 2342, 2344, 2345, 2346, 2347, 2348, 2352, 2353, 2355, 2356, 2357, 2358, 2359, 2360, 2361, 2362, 2363, 2364, 2365, 2366, 2367, 2368, 2369, 2370, 2371, 2373, 2374, 2375, 2376, 2377, 2378, 2379, 2380, 2381, 2382, 2383, 2386, 2387, 2388, 2389, 2390, 2392, 2393, 2394, 2395, 2396, 2397, 2398, 2399, 2401, 2402, 2403, 2404, 2405, 2406, 2407, 2408, 2409, 2410, 2412, 2413, 2414, 2415, 2416, 2419, 2420, 2421, 2422, 2423, 2424, 2425, 2426, 2427, 2428, 2429, 2430, 2431, 2432, 2433, 2434, 2435, 2436, 2437, 2438, 2439, 2441, 2442, 2444, 2445, 2448, 2449, 2450, 2452, 2453, 2454, 2455, 2456, 2457, 2458, 2459, 2460, 2461, 2462, 2463, 2464, 2465, 2466, 2467, 2469, 2470, 2471, 2472, 2473, 2474, 2475, 2476, 2477, 2478, 2479, 2480, 2481, 2482, 2483, 2484, 2485, 2486, 2487, 2488, 2489, 2490, 2491, 2492, 2494, 2495, 2496, 2497, 2499, 2500, 2501, 2503, 2504, 2505, 2506, 2508, 2509, 2510, 2511, 2512, 2513, 2514, 2515, 2516, 2517, 2518, 2519, 2520, 2521, 2522, 2523, 2524, 2525, 2526, 2527, 2528, 2529, 2530, 2531, 2532, 2533, 2534, 2535, 2536, 2537, 2538, 2540, 2541, 2543, 2544, 2546, 2547, 2548, 2549, 2550, 2551, 2552, 2553, 2554, 2555, 2556, 2557, 2558, 2559, 2560, 2561, 2562, 2563, 2564, 2566, 2567, 2568, 2569, 2570, 2572, 2574, 2575, 2576, 2577, 2578, 2579, 2580, 2581, 2582, 2583, 2584, 2585, 2586, 2587, 2590, 2591, 2592, 2593, 2594, 2595, 2596, 2597, 2598, 2599, 2600, 2601, 2603, 2604, 2605, 2606, 2607, 2608, 2609, 2610, 2611, 2612, 2613, 2614, 2615, 2616, 2617, 2620, 2621, 2622, 2623, 2624, 2625, 2626, 2627, 2628, 2629, 2630, 2631, 2632, 2633, 2635, 2636, 2637, 2639, 2640, 2641, 2642, 2643, 2644, 2645, 2646, 2647, 2648, 2649, 2650, 2652, 2653, 2654, 2655, 2656, 2657, 2658, 2659, 2660, 2662, 2664, 2666, 2667, 2668, 2669, 2671, 2672, 2673, 2674, 2677, 2679, 2680, 2681, 2682, 2683, 2684, 2685, 2686, 2687, 2688, 2689, 2690, 2691, 2692, 2693, 2694, 2695, 2696, 2697, 2698, 2699, 2700, 2701, 2703, 2704, 2705, 2706, 2707, 2708, 2709, 2710, 2711, 2712, 2713, 2715, 2716, 2717, 2718, 2720, 2721, 2723, 2724, 2725, 2726, 2727, 2728, 2729, 2730, 2731, 2732, 2733, 2734, 2735, 2736, 2737, 2738, 2739, 2740, 2741, 2744, 2745, 2746, 2747, 2748, 2749, 2750, 2751, 2753, 2754, 2755, 2756, 2757, 2758, 2759, 2760, 2761, 2762, 2763, 2764, 2765, 2766, 2768, 2769, 2770, 2771, 2772, 2773, 2774, 2775, 2776, 2777, 2779, 2780, 2782, 2783, 2784, 2785, 2786, 2787, 2789, 2790, 2791, 2792, 2793, 2794, 2795, 2796, 2797, 2798, 2799, 2800, 2801, 2802, 2803, 2804, 2805, 2806, 2807, 2808, 2809, 2811, 2812, 2813, 2814, 2815, 2816, 2817, 2818, 2819, 2820, 2821, 2822, 2823, 2825, 2826, 2827, 2828, 2830, 2831, 2832, 2833, 2834, 2835, 2836, 2837, 2838, 2839, 2840, 2841, 2842, 2843, 2844, 2845, 2846, 2847, 2848, 2849, 2850, 2851, 2852, 2853, 2854, 2855, 2856, 2857, 2858, 2859, 2860, 2861, 2862, 2863, 2865, 2866, 2867, 2868, 2869, 2870, 2871, 2872, 2873, 2874, 2875, 2877, 2878, 2880, 2883, 2884, 2886, 2887, 2888, 2889, 2890, 2891, 2892, 2893, 2894, 2895, 2896, 2897, 2898, 2899, 2900, 2901, 2902, 2903, 2904, 2905, 2906, 2907, 2908, 2909, 2910, 2911, 2912, 2914, 2915, 2916, 2917, 2918, 2919, 2920, 2921, 2923, 2924, 2925, 2926, 2927, 2930, 2931, 2932, 2933, 2934, 2935, 2937, 2938, 2939, 2940, 2941, 2942, 2943, 2944, 2945, 2946, 2947, 2949, 2950, 2951, 2952, 2953, 2955, 2956, 2957, 2959, 2960, 2961, 2962, 2963, 2965, 2966, 2967, 2968, 2969, 2970, 2971, 2972, 2973, 2974, 2975, 2976, 2977, 2978, 2979, 2980, 2981, 2982, 2983, 2984, 2985, 2986, 2987, 2988, 2989, 2990, 2991, 2992, 2993, 2994, 2995, 2996, 2997, 2998, 2999, 3000, 3001, 3002, 3003, 3004, 3005, 3006, 3007, 3008, 3009, 3010, 3011, 3012, 3014, 3015, 3016, 3017, 3018, 3019, 3020, 3022, 3023, 3024, 3025, 3026, 3027, 3028, 3029, 3030, 3031, 3032, 3033, 3034, 3035, 3036, 3037, 3038, 3039, 3040, 3042, 3043, 3044, 3045, 3046, 3047, 3048, 3049, 3050, 3051, 3052, 3053, 3054, 3055, 3057, 3058, 3059, 3060, 3061, 3062, 3063, 3064, 3065, 3066, 3067, 3068, 3070, 3071, 3072, 3073, 3074, 3075, 3076, 3077, 3079, 3080, 3081, 3082, 3083, 3084, 3086, 3087, 3088, 3089, 3090, 3091, 3093, 3094, 3095, 3096, 3097, 3098, 3099, 3100, 3101, 3102, 3103, 3104, 3105, 3106, 3107, 3108, 3109, 3110, 3111, 3112, 3113, 3114, 3115, 3116, 3118, 3119, 3120, 3121, 3122, 3123, 3124, 3125, 3126, 3127, 3128, 3131, 3132, 3133, 3134, 3135, 3136, 3137, 3138, 3139, 3142, 3143, 3144, 3146, 3147, 3149, 3150, 3151, 3152, 3153, 3155, 3156, 3157, 3158, 3159, 3160, 3162, 3163, 3164, 3165, 3166, 3167, 3169, 3170, 3171, 3172, 3173, 3174, 3175, 3176, 3177, 3178, 3179, 3180, 3181, 3182, 3183, 3184, 3185, 3186, 3187, 3188, 3189, 3190, 3191, 3192, 3193, 3194, 3195, 3196, 3197, 3198, 3199, 3200, 3201, 3202, 3203, 3204, 3205, 3206, 3207, 3208, 3209, 3210, 3211, 3212, 3213, 3214, 3215, 3216, 3217, 3218, 3219, 3222, 3223, 3224, 3225, 3226, 3227, 3228, 3229, 3231, 3232, 3233, 3234, 3236, 3240, 3241, 3242, 3243, 3244, 3245, 3247, 3248, 3249, 3250, 3251, 3252, 3253, 3254, 3255, 3256, 3258, 3259, 3260, 3261, 3262, 3263, 3265, 3269, 3270, 3271, 3272, 3273, 3276, 3277, 3279, 3280, 3281, 3282, 3283, 3284, 3285, 3286, 3287, 3288, 3289, 3291, 3292, 3293, 3294, 3295, 3296, 3298, 3299, 3300, 3301, 3302, 3303, 3304, 3305, 3306, 3307, 3310, 3311, 3312, 3313, 3314, 3316, 3317, 3318, 3319, 3320, 3321, 3322, 3323, 3325, 3326, 3327, 3328, 3329, 3330, 3331, 3332, 3333, 3334, 3335, 3337, 3338, 3339, 3340, 3341, 3342, 3343, 3344, 3345, 3346, 3347, 3349, 3350, 3351, 3352, 3353, 3354, 3355, 3356, 3357, 3358, 3359, 3360, 3362, 3363, 3364, 3366, 3367, 3368, 3369, 3370, 3371, 3372, 3373, 3374, 3375, 3376, 3377, 3378, 3379, 3380, 3381, 3382, 3383, 3384, 3386, 3387, 3388, 3389, 3390, 3391, 3392, 3393, 3394, 3396, 3397, 3398, 3399, 3400, 3401, 3402, 3403, 3404, 3405, 3406, 3407, 3408, 3410, 3411, 3412, 3413, 3414, 3415, 3416, 3417, 3418, 3419, 3421, 3422, 3423, 3424, 3426, 3427, 3428, 3429, 3430, 3431, 3432, 3433, 3434, 3435, 3436, 3437, 3438, 3439, 3440, 3441, 3442, 3443, 3444, 3445, 3446, 3447, 3448, 3449, 3450, 3451, 3452, 3453, 3454, 3455, 3456, 3457, 3459, 3460, 3461, 3462, 3465, 3466, 3467, 3468, 3469, 3470, 3471, 3472, 3473, 3474, 3476, 3477, 3480, 3481, 3482, 3483, 3484, 3485, 3486, 3487, 3488, 3489, 3490, 3491, 3492, 3493, 3494, 3495, 3497, 3498, 3499, 3500, 3501, 3502, 3503, 3504, 3505, 3506, 3507, 3509, 3510, 3511, 3512, 3513, 3514, 3515, 3516, 3519, 3520, 3521, 3522, 3523, 3525, 3526, 3527, 3528, 3529, 3530, 3531, 3532, 3533, 3534, 3535, 3536, 3538, 3539, 3540, 3541, 3542, 3543, 3544, 3545, 3546, 3547, 3548, 3549, 3550, 3551, 3552, 3553, 3556, 3557, 3558, 3562, 3563, 3564, 3565, 3566, 3567, 3568, 3569, 3570, 3571, 3572, 3573, 3574, 3575, 3576, 3577, 3578, 3580, 3581, 3582, 3583, 3584, 3585, 3586, 3588, 3589, 3591, 3592, 3593, 3594, 3595, 3596, 3598, 3599, 3600, 3601, 3602, 3603, 3604, 3605, 3606, 3607, 3608, 3609, 3610, 3611, 3612, 3613, 3614, 3615, 3616, 3617, 3618, 3620, 3621, 3622, 3623, 3624, 3625, 3626, 3627, 3628, 3629, 3630, 3631, 3632, 3633, 3634, 3635, 3636, 3637, 3638, 3639, 3640, 3642, 3644, 3645, 3646, 3647, 3648, 3649, 3650, 3651, 3652, 3653, 3655, 3656, 3657, 3658, 3660, 3661, 3662, 3663, 3664, 3665, 3666, 3667, 3668, 3669, 3670, 3671, 3672, 3673, 3674, 3675, 3676, 3677, 3678, 3679, 3680, 3681, 3682, 3683, 3684, 3685, 3686, 3687, 3688, 3689, 3690, 3691, 3692, 3693, 3694, 3696, 3697, 3698, 3699, 3700, 3701, 3702, 3703, 3704, 3705, 3706, 3707, 3708, 3709, 3710, 3711, 3712, 3713, 3716, 3717, 3718, 3719, 3721, 3722, 3724, 3728, 3729, 3730, 3731, 3732, 3733, 3734, 3735, 3736, 3737, 3738, 3739, 3740, 3743, 3744, 3748, 3749, 3750, 3751, 3752, 3753, 3754, 3756, 3757, 3758, 3759, 3760, 3761, 3762, 3763, 3764, 3765, 3766, 3767, 3768, 3769, 3770, 3772, 3773, 3774, 3775, 3776, 3777, 3778, 3779, 3781, 3782, 3783, 3784, 3785, 3786, 3787, 3788, 3789, 3790, 3791, 3792, 3793, 3794, 3795, 3796, 3797, 3798, 3799, 3800, 3801, 3802, 3803, 3804, 3805, 3806, 3807, 3808, 3809, 3810, 3811, 3812, 3813, 3814, 3815, 3817, 3818, 3819, 3820, 3821, 3822, 3823, 3825, 3826, 3827, 3828, 3829, 3830, 3831, 3832, 3833, 3834, 3835, 3836, 3837, 3838, 3839, 3840, 3841, 3843, 3844, 3845, 3846, 3847, 3850, 3852, 3853, 3856, 3857, 3858, 3859, 3868, 3869, 3870, 3871, 3873, 3874, 3875, 3877, 3878, 3879, 3880, 3884, 3886, 3887, 3888, 3889, 3890, 3891, 3892, 3893, 3894, 3895, 3896, 3897, 3898, 3899, 3900, 3901, 3902, 3903, 3904, 3905, 3906, 3907, 3908, 3910, 3912, 3913, 3915, 3917, 3918, 3919, 3920, 3921, 3922, 3923, 3924, 3925, 3926, 3927, 3928, 3929, 3930, 3932, 3933, 3934, 3935, 3936, 3937, 3938, 3939, 3940, 3941, 3943, 3944, 3945, 3946, 3947, 3948, 3949, 3950, 3951, 3952, 3953, 3954, 3955, 3956, 3957, 3958, 3959, 3960, 3962, 3963, 3964, 3965, 3966, 3967, 3969, 3972, 3973, 3974, 3975, 3976, 3977, 3978, 3979, 3980, 3981, 3982, 3983, 3984, 3985, 3986, 3987, 3988, 3989, 3990, 3991, 3992, 3993, 3994, 3995, 3996, 3997, 3998, 3999, 4000, 4001, 4002, 4003, 4004, 4005, 4006, 4007, 4008, 4009, 4010, 4011, 4012, 4013, 4014, 4016, 4017, 4018, 4019, 4020, 4021, 4022, 4023, 4024, 4025, 4026, 4027, 4028, 4029, 4030, 4031, 4032, 4033, 4034, 4037, 4038, 4039, 4040, 4041, 4042, 4043, 4044, 4045, 4046, 4047, 4049, 4050, 4053, 4054, 4055, 4056, 4057, 4058, 4059, 4060, 4061, 4062, 4063, 4067, 4068, 4069, 4070, 4071, 4072, 4073, 4074, 4075, 4076, 4077, 4078, 4079, 4080, 4081, 4082, 4083, 4084, 4085, 4086, 4087, 4088, 4089, 4090, 4091, 4092, 4093, 4094, 4095, 4096, 4097, 4098, 4099, 4100, 4101, 4102, 4103, 4104, 4105, 4106, 4107, 4108, 4109, 4111, 4112, 4113, 4114, 4115, 4116, 4117, 4118, 4119, 4120, 4121, 4122, 4123, 4124, 4125, 4126, 4127, 4128, 4129, 4130, 4131, 4132, 4133, 4134, 4135, 4136, 4137, 4138, 4139, 4140, 4141, 4142, 4143, 4144, 4145, 4147, 4148, 4149, 4150, 4151, 4152, 4153, 4154, 4155, 4156, 4157, 4158, 4159, 4160, 4161, 4163, 4164, 4165, 4166, 4167, 4168, 4169, 4170, 4171, 4172, 4173, 4174, 4175, 4176, 4177, 4178, 4179, 4181, 4182, 4183, 4184, 4185, 4186, 4187, 4188, 4189, 4190, 4191, 4192, 4193, 4194, 4195, 4196, 4197, 4198, 4200, 4201, 4202, 4203, 4204, 4205, 4206, 4207, 4208, 4209, 4210, 4211, 4212, 4213, 4214, 4215, 4216, 4217, 4218, 4219, 4221, 4222, 4223, 4224, 4225, 4226, 4227, 4228, 4229, 4230, 4231, 4232, 4233, 4234, 4235, 4237, 4238, 4239, 4240, 4241, 4242, 4243, 4244, 4245, 4246, 4247, 4248, 4249, 4250, 4251, 4252, 4253, 4254, 4255, 4256, 4257, 4258, 4259, 4260, 4261, 4262, 4263, 4264, 4265, 4266, 4267, 4269, 4270, 4271, 4272, 4273, 4275, 4276, 4277, 4278, 4279, 4280, 4281, 4283, 4284, 4286, 4287, 4288, 4289, 4290, 4292, 4293, 4294, 4295, 4297, 4298, 4299, 4300, 4301, 4302, 4303, 4304, 4305, 4306, 4307, 4308, 4309, 4310, 4311, 4312, 4313, 4314, 4315, 4316, 4317, 4318, 4319, 4320, 4321, 4322, 4323, 4325, 4326, 4327, 4328, 4329, 4330, 4331, 4333, 4334, 4335, 4336, 4337, 4339, 4340, 4341, 4342, 4343, 4344, 4345, 4346, 4347, 4348, 4349, 4350, 4351, 4352, 4353, 4354, 4356, 4357, 4358, 4359, 4361, 4362, 4363, 4364, 4365, 4366, 4367, 4368, 4369, 4370, 4371, 4372, 4373, 4374, 4375, 4376, 4377, 4378, 4379, 4380, 4381, 4382, 4383, 4384, 4385, 4386, 4387, 4388, 4389, 4390, 4391, 4392, 4394, 4395, 4396, 4397, 4398, 4399, 4400, 4401, 4402, 4403, 4404, 4405, 4406, 4407, 4408, 4409, 4410, 4411, 4412, 4413, 4414, 4415, 4416, 4417, 4418, 4419, 4420, 4421, 4422, 4423, 4424, 4425, 4426, 4427, 4428, 4429, 4430, 4432, 4433, 4434, 4435, 4436, 4437, 4438, 4439, 4440, 4441, 4442, 4443, 4444, 4445, 4446, 4447, 4448, 4449, 4450, 4451, 4452, 4453, 4455, 4456, 4457, 4458, 4459, 4460, 4461, 4463, 4465, 4466, 4467, 4468, 4469, 4471, 4472, 4473, 4474, 4477, 4478, 4479, 4480, 4481, 4482, 4483, 4484, 4485, 4486, 4487, 4488, 4489, 4490, 4491, 4492, 4493, 4494, 4495, 4496, 4497, 4498, 4499, 4500, 4501, 4502, 4503, 4504, 4505, 4506, 4507, 4508, 4509, 4510, 4511, 4512, 4513, 4514, 4515, 4516, 4517, 4518, 4519, 4520, 4521, 4522, 4523, 4524, 4525, 4526, 4527, 4528, 4529, 4530, 4531, 4532, 4533, 4534, 4535, 4536, 4537, 4538, 4539, 4540, 4541, 4542, 4543, 4544, 4545, 4546, 4547, 4548, 4549, 4551, 4552, 4553, 4554, 4555, 4556, 4557, 4558, 4559, 4560, 4561, 4562, 4563, 4564, 4565, 4566, 4567, 4568, 4569, 4570, 4571, 4572, 4573, 4574, 4575, 4576, 4577, 4578, 4579, 4580, 4581, 4582, 4583, 4584, 4585, 4586, 4587, 4588, 4589, 4590, 4591, 4593, 4594, 4595, 4596, 4597, 4598, 4599, 4600, 4601, 4602, 4603, 4604, 4605, 4607, 4608, 4610, 4611, 4612, 4613, 4614, 4615, 4616, 4618, 4619, 4620, 4621, 4622, 4623, 4624, 4625, 4626, 4627, 4628, 4629, 4630, 4632, 4633, 4634, 4635, 4636, 4637, 4639, 4640, 4641, 4642, 4643, 4644, 4645, 4646, 4647, 4648, 4650, 4651, 4652, 4653, 4655, 4656, 4657, 4658, 4659, 4660, 4661, 4662, 4665, 4666, 4667, 4668, 4669, 4670, 4671, 4672, 4673, 4674, 4675, 4676, 4677, 4678, 4679, 4680, 4681, 4682, 4683, 4684, 4685, 4686, 4688, 4689, 4690, 4691, 4692, 4693, 4694, 4695, 4696, 4697, 4698, 4699, 4700, 4702, 4704, 4707, 4718, 4720, 4722, 4723, 4724, 4725, 4726, 4728, 4730, 4731, 4732, 4733, 4734, 4735, 4736, 4737, 4738, 4741, 4742, 4743, 4744, 4745, 4746, 4747, 4748, 4749, 4750, 4751, 4752, 4753, 4754, 4755, 4756, 4757, 4758, 4759, 4760, 4761, 4762, 4763, 4765, 4768, 4770, 4771, 4775, 4777, 4778, 4781, 4783, 4785, 4788, 4789, 4790, 4791, 4792, 4793, 4794, 4795, 4796, 4797, 4798, 4799, 4800, 4801, 4802, 4803, 4804, 4805, 4806, 4807, 4808, 4809, 4810, 4811, 4813, 4814, 4815, 4816, 4817, 4818, 4819, 4820, 4821, 4822, 4823, 4826, 4827, 4828, 4831, 4832, 4834, 4837, 4838, 4839, 4840, 4841, 4842, 4843, 4845, 4846, 4847, 4849, 4850, 4851, 4852, 4853, 4854, 4855, 4856, 4857, 4858, 4859, 4860, 4861, 4862, 4863, 4864, 4865, 4866, 4867, 4868, 4869, 4871, 4873, 4874, 4875, 4876, 4877, 4878, 4879, 4880, 4881, 4882, 4883, 4884, 4885, 4888, 4889, 4890, 4891, 4892, 4893, 4894, 4895, 4897, 4898, 4899, 4900, 4901, 4902, 4903, 4904, 4905, 4906, 4907, 4908, 4909, 4910, 4911, 4912, 4914, 4915, 4916, 4917, 4918, 4919, 4920, 4921, 4922, 4923, 4925, 4926, 4927, 4928, 4930, 4931, 4932, 4933, 4934, 4935, 4936, 4937, 4938, 4939, 4940, 4942, 4943, 4944, 4945, 4946, 4947, 4948, 4949, 4950, 4951, 4952, 4953, 4954, 4955, 4956, 4957, 4958, 4959, 4960, 4961, 4962, 4963, 4964, 4965, 4967, 4968, 4969, 4970, 4971, 4977, 4978, 4979, 4980, 4981, 4982, 4983, 4984, 4986, 4987, 4988, 4989, 4990, 4991, 4993, 4994, 4995, 4996, 4997, 4998, 4999, 5000, 5001, 5002, 5004, 5005, 5007, 5009, 5010, 5011, 5012, 5013, 5015, 5016, 5020, 5021, 5022, 5023, 5024, 5025, 5026, 5028, 5029, 5031, 5032, 5033, 5034, 5035, 5036, 5037, 5038, 5039, 5040, 5041, 5042, 5044, 5045, 5046, 5047, 5048, 5049, 5050, 5051, 5052, 5055, 5056, 5057, 5058, 5059, 5060, 5061, 5062, 5063, 5064, 5065, 5066, 5067, 5068, 5069, 5070, 5071, 5072, 5073, 5074, 5075, 5076, 5077, 5078, 5079, 5080, 5081, 5082, 5083, 5084, 5085, 5086, 5087, 5090, 5091, 5092, 5093, 5095, 5096, 5097, 5098, 5099, 5100, 5101, 5102, 5103, 5104, 5105, 5106, 5107, 5108, 5109, 5110, 5111, 5112, 5113, 5114, 5115, 5116, 5117, 5118, 5119, 5120, 5121, 5122, 5123, 5124, 5125, 5126, 5127, 5128, 5129, 5130, 5131, 5132, 5133, 5134, 5135, 5136, 5137, 5138, 5139, 5140, 5141, 5142, 5143, 5144, 5145, 5148, 5149, 5150, 5151, 5152, 5155, 5156, 5157, 5158, 5159, 5160, 5161, 5162, 5163, 5164, 5165, 5166, 5167, 5168, 5169, 5170, 5171, 5172, 5174, 5175, 5176, 5178, 5179, 5181, 5182, 5183, 5185, 5186, 5187, 5188, 5190, 5191, 5192, 5193, 5194, 5195, 5196, 5197, 5198, 5199, 5200, 5201, 5202, 5203, 5204, 5205, 5206, 5207, 5208, 5209, 5210, 5211, 5212, 5213, 5214, 5215, 5216, 5217, 5218, 5219, 5220, 5221, 5224, 5225, 5226, 5229, 5230, 5231, 5232, 5233, 5236, 5237, 5238, 5239, 5240, 5241, 5242, 5243, 5245, 5246, 5247, 5248, 5249, 5250, 5251, 5252, 5253, 5256, 5257, 5258, 5259, 5260, 5261, 5262, 5263, 5264, 5265, 5266, 5267, 5268, 5269, 5270, 5271, 5272, 5273, 5274, 5275, 5276, 5277, 5278, 5279, 5280, 5281, 5282, 5283, 5284, 5285, 5286, 5287, 5288, 5289, 5290, 5291, 5292, 5294, 5295, 5296, 5297, 5298, 5299, 5300, 5301, 5302, 5303, 5304, 5305, 5306, 5307, 5308, 5309, 5310, 5311, 5312, 5313, 5314, 5315, 5316, 5317, 5319, 5320, 5321, 5323, 5324, 5325, 5326, 5327, 5328, 5329, 5330, 5331, 5333, 5334, 5335, 5336, 5337, 5338, 5339, 5340, 5341, 5342, 5343, 5344, 5345, 5346, 5347, 5348, 5350, 5351, 5352, 5353, 5354, 5355, 5356, 5357, 5358, 5359, 5361, 5362, 5363, 5364, 5365, 5366, 5367, 5368, 5369, 5370, 5371, 5372, 5373, 5375, 5376, 5377, 5378, 5379, 5380, 5381, 5383, 5384, 5385, 5386, 5387, 5388, 5389, 5390, 5391, 5392, 5393, 5394, 5396, 5397, 5398, 5399, 5400, 5401, 5402, 5403, 5404, 5406, 5407, 5408, 5409, 5410, 5411, 5412, 5413, 5414, 5416, 5417, 5418, 5419, 5420, 5422, 5423, 5424, 5425, 5426, 5427, 5428, 5429, 5430, 5431, 5432, 5433, 5434, 5435, 5437, 5438, 5439, 5440, 5441, 5442, 5443, 5444, 5445, 5446, 5447, 5448, 5449, 5450, 5451, 5452, 5453, 5454, 5455, 5456, 5457, 5458, 5459, 5460, 5461, 5462, 5463, 5464, 5466, 5467, 5468, 5469, 5470, 5471, 5472, 5473, 5474, 5475, 5476, 5477, 5478, 5479, 5480, 5481, 5482, 5483, 5484, 5485, 5486, 5487, 5488, 5489, 5490, 5491, 5492, 5493, 5494, 5495, 5496, 5497, 5498, 5499, 5500, 5501, 5502, 5503, 5504, 5505, 5506, 5507, 5510, 5511, 5513, 5514, 5515, 5517, 5518, 5519, 5521, 5522, 5523, 5524, 5525, 5526, 5527, 5529, 5530, 5531, 5532, 5533, 5534, 5535, 5536, 5537, 5538, 5539, 5540, 5541, 5542, 5543, 5547, 5548, 5549, 5550, 5552, 5554, 5555, 5557, 5558, 5559, 5560, 5561, 5562, 5563, 5564, 5565, 5566, 5567, 5568, 5569, 5571, 5573, 5574, 5575, 5576, 5577, 5579, 5580, 5582, 5583, 5584, 5585, 5586, 5587, 5588, 5589, 5590, 5591, 5592, 5593, 5595, 5596, 5597, 5598, 5600, 5601, 5602, 5603, 5604, 5605, 5606, 5607, 5608, 5610, 5612, 5613, 5614, 5615, 5616, 5617, 5618, 5620, 5622, 5623, 5624, 5625, 5626, 5627, 5628, 5629, 5630, 5633, 5634, 5635, 5636, 5637, 5639, 5640, 5642, 5643, 5645, 5646, 5647, 5648, 5649, 5650, 5651, 5653, 5654, 5655, 5656, 5657, 5659, 5660, 5661, 5662, 5664, 5665, 5666, 5669, 5670, 5671, 5672, 5673, 5674, 5676, 5677, 5678, 5679, 5681, 5682, 5683, 5684, 5685, 5686, 5688, 5689, 5690, 5691, 5692, 5693, 5694, 5695, 5696, 5697, 5698, 5700, 5701, 5702, 5703, 5704, 5705, 5706, 5707, 5708, 5709, 5711, 5712, 5713, 5714, 5716, 5717, 5718, 5720, 5721, 5722, 5723, 5724, 5726, 5728, 5729, 5730, 5731, 5732, 5733, 5734, 5735, 5736, 5737, 5739, 5740, 5741, 5742, 5743, 5744, 5745, 5746, 5747, 5748, 5749, 5751, 5752, 5753, 5754, 5755, 5756, 5757, 5758, 5759, 5760, 5761, 5762, 5763, 5764, 5765, 5766, 5767, 5768, 5769, 5771, 5772, 5773, 5774, 5775, 5776, 5777, 5778, 5779, 5780, 5781, 5782, 5783, 5784, 5785, 5786, 5787, 5788, 5789, 5791, 5792, 5793, 5794, 5795, 5796, 5797, 5798, 5799, 5800, 5801, 5802, 5803, 5804, 5805, 5806, 5808, 5809, 5810, 5811, 5813, 5814, 5815, 5816, 5817, 5819, 5820, 5821, 5822, 5823, 5825, 5826, 5827, 5828, 5829, 5830, 5831, 5832, 5833, 5834, 5835, 5836, 5837, 5838, 5839, 5840, 5841, 5842, 5843, 5844, 5846, 5847, 5848, 5849, 5850, 5851, 5852, 5853, 5854, 5855, 5856, 5857, 5858, 5859, 5860, 5861, 5862, 5863, 5864, 5865, 5866, 5868, 5869, 5870, 5871, 5872, 5874, 5875, 5876, 5877, 5878, 5880, 5881, 5882, 5883, 5884, 5886, 5887, 5888, 5889, 5890, 5891, 5892, 5893, 5894, 5895, 5896, 5897, 5898, 5899, 5900, 5901, 5902, 5903, 5904, 5905, 5907, 5908, 5909, 5910, 5912, 5913, 5914, 5915, 5916, 5917, 5918, 5919, 5920, 5921, 5922, 5924, 5925, 5926, 5927, 5928, 5929, 5932, 5933, 5934, 5935, 5937, 5938, 5939, 5940, 5942, 5943, 5945, 5946, 5947, 5948, 5949, 5952, 5953, 5954, 5956, 5960, 5962, 5963, 5966, 5968, 5969, 5970, 5971, 5977, 5979, 5980, 5981, 5984, 5985, 5986, 5987, 5988, 5991, 5992, 5996, 5997, 5998, 5999, 6000, 6001, 6004, 6005, 6006, 6007, 6009, 6011, 6012, 6015, 6016, 6017, 6018, 6019, 6021, 6022, 6023, 6024, 6025, 6027, 6028, 6029, 6030, 6031, 6032, 6034, 6036, 6037, 6040, 6041, 6042, 6043, 6044, 6045, 6046, 6047, 6048, 6049, 6051, 6052, 6053, 6055, 6056, 6057, 6058, 6059, 6060, 6061, 6063, 6064, 6065, 6066, 6067, 6068, 6069, 6070, 6071, 6072, 6073, 6074, 6075, 6076, 6077, 6078, 6079, 6080, 6081, 6083, 6084, 6085, 6086, 6087, 6088, 6089, 6090, 6091, 6092, 6093, 6094, 6095, 6096, 6097, 6099, 6100, 6101, 6102, 6103, 6104, 6105, 6106, 6107, 6108, 6109, 6111, 6112, 6113, 6114, 6115, 6116, 6117, 6119, 6120, 6121, 6122, 6123, 6124, 6126, 6127, 6128, 6129, 6130, 6131, 6132, 6133, 6134, 6135, 6136, 6137, 6139, 6140, 6141, 6142, 6143, 6144, 6145, 6146, 6147, 6148, 6149, 6150, 6151, 6152, 6153, 6154, 6155, 6156, 6157, 6158, 6159, 6160, 6161, 6162, 6163, 6164, 6165, 6166, 6167, 6168, 6169, 6170, 6171, 6172, 6173, 6174, 6175, 6176, 6178, 6179, 6180, 6181, 6182, 6183, 6184, 6185, 6186, 6187, 6189, 6190, 6191, 6192, 6193, 6194, 6195, 6196, 6197, 6198, 6200, 6201, 6202, 6203, 6204, 6205, 6206, 6207, 6208, 6209, 6210, 6211, 6212, 6213, 6214, 6215, 6216, 6217, 6218, 6220, 6221, 6222, 6223, 6224, 6225, 6226, 6227, 6228, 6229, 6230, 6231, 6232, 6233, 6234, 6235, 6236, 6237, 6238, 6239, 6240, 6241, 6242, 6243, 6244, 6245, 6246, 6247, 6248, 6249, 6250, 6251, 6252, 6253, 6254, 6255, 6256, 6257, 6258, 6259, 6260, 6261, 6262, 6263, 6264, 6265, 6266, 6267, 6269, 6270, 6271, 6272, 6273, 6274, 6275, 6276, 6277, 6278, 6279, 6280, 6281, 6282, 6283, 6284, 6285, 6286, 6287, 6288, 6289, 6290, 6291, 6292, 6293, 6294, 6295, 6296, 6297, 6298, 6300, 6301, 6302, 6303, 6304, 6305, 6306, 6307, 6308, 6309, 6310, 6311, 6313, 6314, 6315, 6316, 6317, 6318, 6319, 6320, 6321, 6322, 6323, 6324, 6325, 6326, 6327, 6328, 6329, 6330, 6331, 6332, 6333, 6334, 6335, 6336, 6338, 6339, 6340, 6341, 6342, 6343, 6344, 6345, 6346, 6347, 6348, 6349, 6350, 6351, 6352, 6353, 6354, 6355, 6356, 6357, 6358, 6359, 6360, 6361, 6363, 6364, 6369, 6370, 6371, 6372, 6373, 6374, 6375, 6376, 6377, 6378, 6379, 6380, 6381, 6382, 6383, 6384, 6385, 6386, 6387, 6388, 6389, 6390, 6391, 6392, 6393, 6394, 6395, 6396, 6399, 6401, 6402, 6404, 6405, 6407, 6408, 6410, 6411, 6412, 6413, 6414, 6415, 6416, 6417, 6418, 6419, 6420, 6421, 6422, 6423, 6424, 6425, 6426, 6427, 6428, 6429, 6430, 6431, 6433, 6434, 6435, 6436, 6437, 6438, 6439, 6440, 6441, 6442, 6443, 6444, 6445, 6446, 6447, 6448, 6449, 6450, 6452, 6453, 6454, 6455, 6457, 6458, 6461, 6462, 6463, 6464, 6467, 6468, 6469, 6470, 6471, 6472, 6473, 6474, 6475, 6476, 6477, 6478, 6479, 6481, 6482, 6483, 6484, 6485, 6486, 6487, 6488, 6489, 6491, 6492, 6493, 6494, 6495, 6496, 6497, 6498, 6499, 6500, 6501, 6502, 6503, 6504, 6505, 6506, 6507, 6508, 6509, 6510, 6511, 6512, 6513, 6514, 6515, 6516, 6517, 6518, 6519, 6520, 6521, 6522, 6523, 6524, 6525, 6526, 6527, 6528, 6529, 6530, 6531, 6532, 6533, 6534, 6535, 6543, 6545, 6547, 6548, 6552, 6553, 6554, 6555, 6556, 6557, 6559, 6560, 6561, 6562, 6563, 6564, 6565, 6566, 6568, 6569, 6570, 6571, 6572, 6573, 6575, 6576, 6577, 6578, 6579, 6580, 6581, 6582, 6583, 6584, 6585, 6587, 6589, 6590, 6593, 6594, 6595, 6596, 6597, 6598, 6600, 6601, 6602, 6604, 6605, 6606, 6607, 6608, 6609, 6610, 6611, 6612, 6613, 6614, 6615, 6616, 6617, 6618, 6619, 6620, 6621, 6622, 6623, 6624, 6625, 6626, 6627, 6628, 6629, 6630, 6631, 6632, 6633, 6634, 6635, 6636, 6637, 6639, 6640, 6641, 6642, 6643, 6644, 6645, 6646, 6647, 6648, 6649, 6650, 6651, 6652, 6653, 6654, 6655, 6656, 6657, 6658, 6659, 6660, 6661, 6662, 6663, 6664, 6665, 6666, 6667, 6668, 6669, 6670, 6671, 6672, 6673, 6675, 6676, 6677, 6678, 6679, 6680, 6681, 6682, 6683, 6684, 6685, 6686, 6687, 6688, 6689, 6690, 6691, 6692, 6693, 6694, 6695, 6696, 6697, 6698, 6699, 6700, 6701, 6702, 6703, 6704, 6705, 6706, 6707, 6708, 6709, 6710, 6711, 6712, 6713, 6714, 6715, 6716, 6717, 6718, 6719, 6720, 6721, 6722, 6723, 6724, 6725, 6726, 6727, 6728, 6729, 6730, 6731, 6732, 6733, 6734, 6735, 6736, 6737, 6738, 6739, 6740, 6741, 6742, 6743, 6744, 6745, 6747, 6748, 6750, 6751, 6752, 6753, 6754, 6755, 6756, 6757, 6759, 6760, 6762, 6764, 6765, 6766, 6767, 6768, 6769, 6770, 6771, 6773, 6774, 6775, 6776, 6777, 6778, 6779, 6780, 6781, 6782, 6783, 6784, 6785, 6786, 6787, 6788, 6789, 6790, 6791, 6792, 6793}",6043
18,"(('batch', ('Request For Payment SUBMITTED by EMPLOYEE', 'Request For Payment APPROVED by ADMINISTRATION')),)",1,15,"{989, 1078, 1081, 1084, 1085, 1086, 1087, 1088, 1089, 1090, 1092, 1093, 1094, 1095, 1096, 1097, 1098, 1099, 1100, 1101, 1103, 1104, 1105, 1106, 1107, 1108, 1109, 1110, 1111, 1112, 1113, 1114, 1115, 1116, 1117, 1118, 1119, 1120, 1121, 1122, 1123, 1124, 1125, 1126, 1127, 1128, 1129, 1130, 1131, 1132, 1133, 1134, 1135, 1136, 1137, 1138, 1139, 1140, 1141, 1142, 1143, 1144, 1145, 1146, 1147, 1148, 1149, 1150, 1151, 1152, 1153, 1154, 1155, 1156, 1157, 1158, 1159, 1160, 1161, 1162, 1163, 1164, 1165, 1166, 1167, 1168, 1169, 1170, 1171, 1172, 1173, 1174, 1175, 1176, 1177, 1178, 1179, 1180, 1181, 1182, 1183, 1184, 1185, 1186, 1187, 1188, 1189, 1190, 1191, 1192, 1193, 1194, 1195, 1196, 1197, 1198, 1199, 1200, 1201, 1202, 1203, 1204, 1205, 1206, 1207, 1208, 1209, 1210, 1211, 1212, 1213, 1214, 1215, 1216, 1217, 1218, 1219, 1220, 1221, 1222, 1223, 1224, 1225, 1226, 1227, 1228, 1229, 1230, 1231, 1232, 1233, 1234, 1235, 1236, 1237, 1238, 1239, 1240, 1241, 1242, 1243, 1244, 1245, 1246, 1247, 1248, 1249, 1250, 1251, 1252, 1253, 1254, 1255, 1258, 1259, 1260, 1262, 1263, 1264, 1265, 1267, 1268, 1269, 1270, 1271, 1272, 1273, 1274, 1275, 1276, 1277, 1278, 1279, 1280, 1281, 1282, 1283, 1284, 1285, 1286, 1287, 1288, 1289, 1290, 1291, 1292, 1293, 1294, 1295, 1296, 1297, 1298, 1299, 1300, 1301, 1302, 1303, 1304, 1305, 1306, 1307, 1308, 1309, 1310, 1311, 1313, 1314, 1315, 1316, 1317, 1318, 1320, 1321, 1323, 1324, 1325, 1326, 1327, 1328, 1329, 1330, 1331, 1332, 1333, 1334, 1335, 1336, 1337, 1338, 1339, 1340, 1342, 1343, 1344, 1345, 1346, 1347, 1348, 1349, 1350, 1351, 1352, 1353, 1354, 1355, 1356, 1357, 1358, 1359, 1360, 1361, 1362, 1363, 1364, 1365, 1366, 1367, 1368, 1369, 1370, 1371, 1372, 1373, 1374, 1375, 1376, 1377, 1378, 1379, 1380, 1381, 1382, 1383, 1384, 1385, 1386, 1387, 1388, 1389, 1390, 1391, 1392, 1393, 1394, 1395, 1396, 1397, 1399, 1400, 1401, 1402, 1403, 1404, 1405, 1406, 1407, 1408, 1409, 1410, 1411, 1412, 1413, 1414, 1415, 1416, 1418, 1419, 1420, 1421, 1422, 1423, 1424, 1426, 1427, 1428, 1429, 1430, 1431, 1432, 1433, 1434, 1435, 1436, 1437, 1439, 1440, 1441, 1442, 1443, 1445, 1446, 1447, 1448, 1449, 1450, 1451, 1452, 1453, 1454, 1455, 1456, 1457, 1458, 1459, 1460, 1461, 1462, 1463, 1464, 1465, 1466, 1467, 1468, 1469, 1470, 1471, 1472, 1473, 1474, 1475, 1476, 1477, 1478, 1479, 1480, 1481, 1482, 1483, 1484, 1485, 1487, 1488, 1489, 1490, 1491, 1492, 1493, 1494, 1495, 1496, 1497, 1499, 1500, 1501, 1502, 1503, 1504, 1505, 1506, 1507, 1508, 1509, 1510, 1511, 1512, 1513, 1514, 1515, 1516, 1517, 1518, 1519, 1520, 1521, 1522, 1523, 1524, 1525, 1526, 1527, 1528, 1529, 1530, 1531, 1532, 1533, 1534, 1535, 1536, 1537, 1538, 1539, 1540, 1541, 1542, 1543, 1544, 1545, 1546, 1548, 1549, 1550, 1551, 1552, 1553, 1554, 1556, 1557, 1558, 1559, 1560, 1561, 1562, 1563, 1564, 1565, 1566, 1567, 1568, 1569, 1570, 1571, 1572, 1573, 1574, 1575, 1576, 1577, 1578, 1579, 1580, 1581, 1582, 1583, 1584, 1585, 1586, 1587, 1588, 1589, 1590, 1591, 1592, 1593, 1594, 1595, 1596, 1597, 1598, 1599, 1600, 1601, 1602, 1603, 1604, 1605, 1606, 1607, 1608, 1609, 1610, 1612, 1613, 1614, 1615, 1616, 1617, 1618, 1619, 1620, 1621, 1622, 1623, 1624, 1625, 1626, 1627, 1628, 1629, 1630, 1631, 1632, 1633, 1634, 1635, 1636, 1637, 1638, 1639, 1640, 1641, 1642, 1643, 1644, 1645, 1646, 1647, 1648, 1649, 1650, 1651, 1652, 1653, 1654, 1655, 1656, 1657, 1658, 1659, 1660, 1661, 1662, 1663, 1664, 1665, 1666, 1667, 1668, 1669, 1670, 1671, 1672, 1673, 1674, 1675, 1676, 1677, 1678, 1679, 1680, 1681, 1682, 1683, 1684, 1685, 1686, 1687, 1688, 1689, 1690, 1691, 1692, 1693, 1694, 1695, 1696, 1697, 1698, 1699, 1700, 1701, 1702, 1703, 1704, 1705, 1706, 1707, 1708, 1709, 1710, 1711, 1712, 1713, 1714, 1715, 1716, 1717, 1718, 1719, 1720, 1721, 1722, 1723, 1724, 1725, 1726, 1727, 1728, 1729, 1730, 1731, 1732, 1734, 1735, 1736, 1737, 1738, 1739, 1740, 1741, 1742, 1743, 1744, 1745, 1746, 1747, 1748, 1749, 1752, 1753, 1754, 1755, 1756, 1757, 1758, 1759, 1760, 1761, 1762, 1764, 1765, 1766, 1767, 1768, 1769, 1770, 1771, 1772, 1773, 1774, 1775, 1776, 1778, 1779, 1780, 1781, 1782, 1783, 1784, 1785, 1786, 1787, 1788, 1789, 1790, 1791, 1792, 1793, 1795, 1796, 1797, 1798, 1799, 1800, 1801, 1802, 1803, 1804, 1805, 1806, 1807, 1808, 1809, 1810, 1811, 1812, 1813, 1814, 1815, 1816, 1817, 1818, 1819, 1820, 1821, 1822, 1823, 1824, 1825, 1826, 1827, 1828, 1829, 1830, 1831, 1832, 1833, 1834, 1835, 1836, 1837, 1838, 1839, 1840, 1841, 1842, 1843, 1844, 1845, 1846, 1847, 1848, 1849, 1850, 1851, 1852, 1853, 1854, 1855, 1857, 1858, 1859, 1860, 1861, 1862, 1863, 1864, 1865, 1866, 1867, 1868, 1869, 1870, 1871, 1872, 1873, 1874, 1875, 1876, 1877, 1878, 1879, 1880, 1881, 1882, 1883, 1884, 1885, 1886, 1887, 1888, 1889, 1890, 1891, 1892, 1893, 1894, 1895, 1896, 1897, 1898, 1899, 1900, 1901, 1902, 1903, 1904, 1905, 1907, 1908, 1909, 1910, 1911, 1912, 1914, 1915, 1916, 1918, 1919, 1920, 1921, 1922, 1923, 1924, 1925, 1926, 1927, 1928, 1929, 1930, 1931, 1932, 1934, 1936, 1937, 1938, 1939, 1940, 1941, 1942, 1943, 1944, 1945, 1946, 1947, 1948, 1949, 1950, 1951, 1952, 1954, 1955, 1956, 1957, 1958, 1959, 1960, 1961, 1962, 1963, 1964, 1965, 1966, 1967, 1968, 1969, 1970, 1971, 1972, 1973, 1974, 1975, 1976, 1977, 1978, 1979, 1980, 1981, 1982, 1983, 1984, 1985, 1986, 1987, 1988, 1990, 1991, 1992, 1993, 1994, 1995, 1996, 1997, 1998, 1999, 2000, 2001, 2002, 2003, 2004, 2005, 2006, 2007, 2008, 2009, 2010, 2011, 2012, 2014, 2015, 2016, 2017, 2018, 2019, 2020, 2021, 2022, 2023, 2024, 2025, 2026, 2027, 2028, 2029, 2030, 2031, 2032, 2033, 2034, 2035, 2036, 2037, 2038, 2039, 2040, 2041, 2042, 2043, 2044, 2045, 2046, 2047, 2048, 2049, 2050, 2051, 2052, 2053, 2055, 2056, 2057, 2058, 2059, 2060, 2061, 2062, 2063, 2064, 2065, 2066, 2067, 2068, 2069, 2070, 2071, 2073, 2074, 2075, 2076, 2077, 2079, 2080, 2081, 2082, 2083, 2084, 2085, 2086, 2087, 2088, 2089, 2090, 2091, 2092, 2094, 2095, 2096, 2097, 2098, 2099, 2100, 2101, 2102, 2103, 2104, 2106, 2107, 2108, 2109, 2110, 2111, 2112, 2113, 2114, 2115, 2116, 2117, 2118, 2119, 2120, 2121, 2122, 2123, 2124, 2125, 2126, 2128, 2129, 2130, 2131, 2132, 2133, 2134, 2135, 2137, 2138, 2139, 2140, 2141, 2142, 2143, 2144, 2145, 2146, 2147, 2148, 2149, 2150, 2151, 2152, 2153, 2154, 2155, 2156, 2157, 2158, 2159, 2160, 2161, 2162, 2163, 2164, 2166, 2167, 2168, 2169, 2170, 2171, 2172, 2173, 2174, 2175, 2176, 2177, 2178, 2179, 2180, 2181, 2182, 2183, 2184, 2185, 2186, 2187, 2188, 2189, 2190, 2191, 2192, 2193, 2194, 2195, 2196, 2197, 2198, 2200, 2201, 2202, 2203, 2204, 2205, 2206, 2207, 2208, 2209, 2210, 2211, 2212, 2213, 2214, 2215, 2216, 2217, 2218, 2219, 2220, 2221, 2222, 2223, 2224, 2225, 2226, 2228, 2229, 2230, 2231, 2232, 2233, 2234, 2235, 2236, 2237, 2239, 2240, 2241, 2242, 2243, 2244, 2245, 2246, 2247, 2248, 2249, 2250, 2251, 2252, 2253, 2254, 2255, 2259, 2260, 2261, 2262, 2263, 2264, 2265, 2266, 2267, 2268, 2269, 2270, 2271, 2272, 2273, 2274, 2275, 2276, 2277, 2280, 2281, 2282, 2283, 2284, 2285, 2287, 2288, 2289, 2290, 2291, 2292, 2293, 2294, 2295, 2296, 2297, 2298, 2299, 2300, 2301, 2302, 2303, 2304, 2305, 2306, 2307, 2309, 2310, 2311, 2312, 2313, 2314, 2315, 2316, 2317, 2318, 2319, 2320, 2321, 2322, 2323, 2324, 2325, 2327, 2328, 2329, 2330, 2331, 2332, 2333, 2334, 2335, 2336, 2337, 2338, 2339, 2340, 2341, 2342, 2344, 2345, 2346, 2347, 2348, 2349, 2350, 2351, 2352, 2353, 2354, 2355, 2356, 2357, 2358, 2359, 2360, 2361, 2362, 2363, 2364, 2365, 2366, 2367, 2368, 2369, 2370, 2371, 2373, 2374, 2375, 2376, 2377, 2378, 2379, 2380, 2381, 2382, 2383, 2384, 2385, 2386, 2387, 2388, 2389, 2390, 2391, 2392, 2393, 2394, 2395, 2396, 2397, 2398, 2399, 2401, 2402, 2403, 2404, 2405, 2406, 2407, 2408, 2409, 2410, 2411, 2412, 2413, 2414, 2415, 2416, 2419, 2420, 2421, 2422, 2423, 2424, 2425, 2426, 2427, 2428, 2429, 2430, 2431, 2432, 2433, 2434, 2435, 2436, 2437, 2438, 2439, 2440, 2441, 2442, 2443, 2444, 2445, 2446, 2447, 2448, 2449, 2450, 2452, 2453, 2454, 2455, 2456, 2457, 2458, 2459, 2460, 2461, 2462, 2463, 2464, 2465, 2466, 2467, 2469, 2470, 2471, 2472, 2473, 2474, 2475, 2476, 2477, 2478, 2479, 2480, 2481, 2482, 2483, 2484, 2485, 2486, 2487, 2488, 2489, 2490, 2491, 2492, 2494, 2495, 2496, 2497, 2498, 2499, 2500, 2501, 2502, 2503, 2504, 2505, 2506, 2508, 2509, 2510, 2511, 2512, 2513, 2514, 2515, 2516, 2517, 2518, 2519, 2520, 2521, 2522, 2523, 2524, 2525, 2526, 2527, 2528, 2529, 2530, 2531, 2532, 2533, 2534, 2535, 2536, 2537, 2538, 2540, 2541, 2542, 2543, 2544, 2545, 2546, 2547, 2548, 2549, 2550, 2551, 2552, 2553, 2554, 2555, 2556, 2557, 2558, 2559, 2560, 2561, 2562, 2563, 2564, 2566, 2567, 2568, 2569, 2570, 2572, 2573, 2574, 2575, 2576, 2577, 2578, 2579, 2580, 2581, 2582, 2583, 2584, 2585, 2586, 2587, 2590, 2591, 2592, 2593, 2594, 2595, 2596, 2597, 2598, 2599, 2600, 2601, 2603, 2604, 2605, 2606, 2607, 2608, 2609, 2610, 2611, 2612, 2613, 2614, 2615, 2616, 2617, 2620, 2621, 2622, 2623, 2624, 2625, 2626, 2627, 2628, 2629, 2630, 2631, 2632, 2633, 2635, 2636, 2637, 2638, 2639, 2640, 2641, 2642, 2643, 2644, 2645, 2646, 2647, 2648, 2649, 2650, 2652, 2653, 2654, 2655, 2656, 2657, 2658, 2659, 2660, 2662, 2664, 2665, 2666, 2667, 2668, 2669, 2671, 2672, 2673, 2674, 2677, 2679, 2680, 2681, 2682, 2683, 2684, 2685, 2686, 2687, 2688, 2689, 2690, 2691, 2692, 2693, 2694, 2695, 2696, 2697, 2698, 2699, 2700, 2701, 2703, 2704, 2705, 2706, 2707, 2708, 2709, 2710, 2711, 2712, 2713, 2715, 2716, 2717, 2718, 2720, 2721, 2723, 2724, 2725, 2726, 2727, 2728, 2729, 2730, 2731, 2732, 2733, 2734, 2735, 2736, 2737, 2738, 2739, 2740, 2741, 2744, 2745, 2746, 2747, 2748, 2749, 2750, 2751, 2753, 2754, 2755, 2756, 2757, 2758, 2759, 2760, 2761, 2762, 2763, 2764, 2765, 2766, 2768, 2769, 2770, 2771, 2772, 2773, 2774, 2775, 2776, 2777, 2778, 2779, 2780, 2782, 2783, 2784, 2785, 2786, 2787, 2789, 2790, 2791, 2792, 2793, 2794, 2795, 2796, 2797, 2798, 2799, 2800, 2801, 2802, 2803, 2804, 2805, 2806, 2807, 2808, 2809, 2811, 2812, 2813, 2814, 2815, 2816, 2817, 2818, 2819, 2820, 2821, 2822, 2823, 2825, 2826, 2827, 2828, 2830, 2831, 2832, 2833, 2834, 2835, 2836, 2837, 2838, 2839, 2840, 2841, 2842, 2843, 2844, 2845, 2846, 2847, 2848, 2849, 2850, 2851, 2852, 2853, 2854, 2855, 2856, 2857, 2858, 2859, 2860, 2861, 2862, 2863, 2865, 2866, 2867, 2868, 2869, 2870, 2871, 2872, 2873, 2874, 2875, 2877, 2878, 2880, 2883, 2884, 2886, 2887, 2888, 2889, 2890, 2891, 2892, 2893, 2894, 2895, 2896, 2897, 2898, 2899, 2900, 2901, 2902, 2903, 2904, 2905, 2906, 2907, 2908, 2909, 2910, 2911, 2912, 2914, 2915, 2916, 2917, 2918, 2919, 2920, 2921, 2923, 2924, 2925, 2926, 2927, 2930, 2931, 2932, 2933, 2934, 2935, 2937, 2938, 2939, 2940, 2941, 2942, 2943, 2944, 2945, 2946, 2947, 2949, 2950, 2951, 2952, 2953, 2955, 2956, 2957, 2959, 2960, 2961, 2962, 2963, 2965, 2966, 2967, 2968, 2969, 2970, 2971, 2972, 2973, 2974, 2975, 2976, 2977, 2978, 2979, 2980, 2981, 2982, 2983, 2984, 2985, 2986, 2987, 2988, 2989, 2990, 2991, 2992, 2993, 2994, 2995, 2996, 2997, 2998, 2999, 3000, 3001, 3002, 3003, 3004, 3005, 3006, 3007, 3008, 3009, 3010, 3011, 3012, 3014, 3015, 3016, 3017, 3018, 3019, 3020, 3022, 3023, 3024, 3025, 3026, 3027, 3028, 3029, 3030, 3031, 3032, 3033, 3034, 3035, 3036, 3037, 3038, 3039, 3040, 3042, 3043, 3044, 3045, 3046, 3047, 3048, 3049, 3050, 3051, 3052, 3053, 3054, 3055, 3057, 3058, 3059, 3060, 3061, 3062, 3063, 3064, 3065, 3066, 3067, 3068, 3070, 3071, 3072, 3073, 3074, 3075, 3076, 3077, 3079, 3080, 3081, 3082, 3083, 3084, 3086, 3087, 3088, 3089, 3090, 3091, 3093, 3094, 3095, 3096, 3097, 3098, 3099, 3100, 3101, 3102, 3103, 3104, 3105, 3106, 3107, 3108, 3109, 3110, 3111, 3112, 3113, 3114, 3115, 3116, 3118, 3119, 3120, 3121, 3122, 3123, 3124, 3125, 3126, 3127, 3128, 3131, 3132, 3133, 3134, 3135, 3136, 3137, 3138, 3139, 3141, 3142, 3143, 3144, 3146, 3147, 3149, 3150, 3151, 3152, 3153, 3154, 3155, 3156, 3157, 3158, 3159, 3160, 3162, 3163, 3164, 3165, 3166, 3167, 3168, 3169, 3170, 3171, 3172, 3173, 3174, 3175, 3176, 3177, 3178, 3179, 3180, 3181, 3182, 3183, 3184, 3185, 3186, 3187, 3188, 3189, 3190, 3191, 3192, 3193, 3194, 3195, 3196, 3197, 3198, 3199, 3200, 3201, 3202, 3203, 3204, 3205, 3206, 3207, 3208, 3209, 3210, 3211, 3212, 3213, 3214, 3215, 3216, 3217, 3218, 3219, 3222, 3223, 3224, 3225, 3226, 3227, 3228, 3229, 3231, 3232, 3233, 3234, 3236, 3240, 3241, 3242, 3243, 3244, 3245, 3247, 3248, 3249, 3250, 3251, 3252, 3253, 3254, 3255, 3256, 3257, 3258, 3259, 3260, 3261, 3262, 3263, 3265, 3269, 3270, 3271, 3272, 3273, 3276, 3277, 3279, 3280, 3281, 3282, 3283, 3284, 3285, 3286, 3287, 3288, 3289, 3291, 3292, 3293, 3294, 3295, 3296, 3298, 3299, 3300, 3301, 3302, 3303, 3304, 3305, 3306, 3307, 3308, 3310, 3311, 3312, 3313, 3314, 3316, 3317, 3318, 3319, 3320, 3321, 3322, 3323, 3325, 3326, 3327, 3328, 3329, 3330, 3331, 3332, 3333, 3334, 3335, 3336, 3337, 3338, 3339, 3340, 3341, 3342, 3343, 3344, 3345, 3346, 3347, 3349, 3350, 3351, 3352, 3353, 3354, 3355, 3356, 3357, 3358, 3359, 3360, 3362, 3363, 3364, 3365, 3366, 3367, 3368, 3369, 3370, 3371, 3372, 3373, 3374, 3375, 3376, 3377, 3378, 3379, 3380, 3381, 3382, 3383, 3384, 3386, 3387, 3388, 3389, 3390, 3391, 3392, 3393, 3394, 3396, 3397, 3398, 3399, 3400, 3401, 3402, 3403, 3404, 3405, 3406, 3407, 3408, 3410, 3411, 3412, 3413, 3414, 3415, 3416, 3417, 3418, 3419, 3421, 3422, 3423, 3424, 3426, 3427, 3428, 3429, 3430, 3431, 3432, 3433, 3434, 3435, 3436, 3437, 3438, 3439, 3440, 3441, 3442, 3443, 3444, 3445, 3446, 3447, 3448, 3449, 3450, 3451, 3452, 3453, 3454, 3455, 3456, 3457, 3459, 3460, 3461, 3462, 3463, 3465, 3466, 3467, 3468, 3469, 3470, 3471, 3472, 3473, 3474, 3475, 3476, 3477, 3480, 3481, 3482, 3483, 3484, 3485, 3486, 3487, 3488, 3489, 3490, 3491, 3492, 3493, 3494, 3495, 3497, 3498, 3499, 3500, 3501, 3502, 3503, 3504, 3505, 3506, 3507, 3509, 3510, 3511, 3512, 3513, 3514, 3515, 3516, 3519, 3520, 3521, 3522, 3523, 3525, 3526, 3527, 3528, 3529, 3530, 3531, 3532, 3533, 3534, 3535, 3536, 3538, 3539, 3540, 3541, 3542, 3543, 3544, 3545, 3546, 3547, 3548, 3549, 3550, 3551, 3552, 3553, 3554, 3556, 3557, 3558, 3559, 3562, 3563, 3564, 3565, 3566, 3567, 3568, 3569, 3570, 3571, 3572, 3573, 3574, 3575, 3576, 3577, 3578, 3580, 3581, 3582, 3583, 3584, 3585, 3586, 3588, 3589, 3591, 3592, 3593, 3594, 3595, 3596, 3598, 3599, 3600, 3601, 3602, 3603, 3604, 3605, 3606, 3607, 3608, 3609, 3610, 3611, 3612, 3613, 3614, 3615, 3616, 3617, 3618, 3620, 3621, 3622, 3623, 3624, 3625, 3626, 3627, 3628, 3629, 3630, 3631, 3632, 3633, 3634, 3635, 3636, 3637, 3638, 3639, 3640, 3642, 3644, 3645, 3646, 3647, 3648, 3649, 3650, 3651, 3652, 3653, 3655, 3656, 3657, 3658, 3660, 3661, 3662, 3663, 3664, 3665, 3666, 3667, 3668, 3669, 3670, 3671, 3672, 3673, 3674, 3675, 3676, 3677, 3678, 3679, 3680, 3681, 3682, 3683, 3684, 3685, 3686, 3687, 3688, 3689, 3690, 3691, 3692, 3693, 3694, 3696, 3697, 3698, 3699, 3700, 3701, 3702, 3703, 3704, 3705, 3706, 3707, 3708, 3709, 3710, 3711, 3712, 3713, 3716, 3717, 3718, 3719, 3721, 3722, 3724, 3728, 3729, 3730, 3731, 3732, 3733, 3734, 3735, 3736, 3737, 3738, 3739, 3740, 3743, 3744, 3748, 3749, 3750, 3751, 3752, 3753, 3754, 3756, 3757, 3758, 3759, 3760, 3761, 3762, 3763, 3764, 3765, 3766, 3767, 3768, 3769, 3770, 3772, 3773, 3774, 3775, 3776, 3777, 3778, 3779, 3781, 3782, 3783, 3784, 3785, 3786, 3787, 3788, 3789, 3790, 3791, 3792, 3793, 3794, 3795, 3796, 3797, 3798, 3799, 3800, 3801, 3802, 3803, 3804, 3805, 3806, 3807, 3808, 3809, 3810, 3811, 3812, 3813, 3814, 3815, 3817, 3818, 3819, 3820, 3821, 3822, 3823, 3825, 3826, 3827, 3828, 3829, 3830, 3831, 3832, 3833, 3834, 3835, 3836, 3837, 3838, 3839, 3840, 3841, 3843, 3844, 3845, 3846, 3847, 3848, 3849, 3850, 3851, 3852, 3853, 3854, 3855, 3856, 3857, 3858, 3859, 3860, 3861, 3862, 3863, 3864, 3866, 3867, 3868, 3869, 3870, 3871, 3872, 3873, 3874, 3875, 3877, 3878, 3879, 3880, 3884, 3886, 3887, 3888, 3889, 3890, 3891, 3892, 3893, 3894, 3895, 3896, 3897, 3898, 3899, 3900, 3901, 3902, 3903, 3904, 3905, 3906, 3907, 3908, 3910, 3912, 3913, 3915, 3917, 3918, 3919, 3920, 3921, 3922, 3923, 3924, 3925, 3926, 3927, 3928, 3929, 3930, 3932, 3933, 3934, 3935, 3936, 3937, 3938, 3939, 3940, 3941, 3943, 3944, 3945, 3946, 3947, 3948, 3949, 3950, 3951, 3952, 3953, 3954, 3955, 3956, 3957, 3958, 3959, 3960, 3962, 3963, 3964, 3965, 3966, 3967, 3969, 3972, 3973, 3974, 3975, 3976, 3977, 3978, 3979, 3980, 3981, 3982, 3983, 3984, 3985, 3986, 3987, 3988, 3989, 3990, 3991, 3992, 3993, 3994, 3995, 3996, 3997, 3998, 3999, 4000, 4001, 4002, 4003, 4004, 4005, 4006, 4007, 4008, 4009, 4010, 4011, 4012, 4013, 4014, 4016, 4017, 4018, 4019, 4020, 4021, 4022, 4023, 4024, 4025, 4026, 4027, 4028, 4029, 4030, 4031, 4032, 4033, 4034, 4037, 4038, 4039, 4040, 4041, 4042, 4043, 4044, 4045, 4046, 4047, 4049, 4050, 4053, 4054, 4055, 4056, 4057, 4058, 4059, 4060, 4061, 4062, 4063, 4066, 4067, 4068, 4069, 4070, 4071, 4072, 4073, 4074, 4075, 4076, 4077, 4078, 4079, 4080, 4081, 4082, 4083, 4084, 4085, 4086, 4087, 4088, 4089, 4090, 4091, 4092, 4093, 4094, 4095, 4096, 4097, 4098, 4099, 4100, 4101, 4102, 4103, 4104, 4105, 4106, 4107, 4108, 4109, 4110, 4111, 4112, 4113, 4114, 4115, 4116, 4117, 4118, 4119, 4120, 4121, 4122, 4123, 4124, 4125, 4126, 4127, 4128, 4129, 4130, 4131, 4132, 4133, 4134, 4135, 4136, 4137, 4138, 4139, 4140, 4141, 4142, 4143, 4144, 4145, 4147, 4148, 4149, 4150, 4151, 4152, 4153, 4154, 4155, 4156, 4157, 4158, 4159, 4160, 4161, 4163, 4164, 4165, 4166, 4167, 4168, 4169, 4170, 4171, 4172, 4173, 4174, 4175, 4176, 4177, 4178, 4179, 4181, 4182, 4183, 4184, 4185, 4186, 4187, 4188, 4189, 4190, 4191, 4192, 4193, 4194, 4195, 4196, 4197, 4198, 4200, 4201, 4202, 4203, 4204, 4205, 4206, 4207, 4208, 4209, 4210, 4211, 4212, 4213, 4214, 4215, 4216, 4217, 4218, 4219, 4221, 4222, 4223, 4224, 4225, 4226, 4227, 4228, 4229, 4230, 4231, 4232, 4233, 4234, 4235, 4237, 4238, 4239, 4240, 4241, 4242, 4243, 4244, 4245, 4246, 4247, 4248, 4249, 4250, 4251, 4252, 4253, 4254, 4255, 4256, 4257, 4258, 4259, 4260, 4261, 4262, 4263, 4264, 4265, 4266, 4267, 4269, 4270, 4271, 4272, 4273, 4274, 4275, 4276, 4277, 4278, 4279, 4280, 4281, 4282, 4283, 4284, 4286, 4287, 4288, 4289, 4290, 4292, 4293, 4294, 4295, 4297, 4298, 4299, 4300, 4301, 4302, 4303, 4304, 4305, 4306, 4307, 4308, 4309, 4310, 4311, 4312, 4313, 4314, 4315, 4316, 4317, 4318, 4319, 4320, 4321, 4322, 4323, 4325, 4326, 4327, 4328, 4329, 4330, 4331, 4332, 4333, 4334, 4335, 4336, 4337, 4339, 4340, 4341, 4342, 4343, 4344, 4345, 4346, 4347, 4348, 4349, 4350, 4351, 4352, 4353, 4354, 4355, 4356, 4357, 4358, 4359, 4361, 4362, 4363, 4364, 4365, 4366, 4367, 4368, 4369, 4370, 4371, 4372, 4373, 4374, 4375, 4376, 4377, 4378, 4379, 4380, 4381, 4382, 4383, 4384, 4385, 4386, 4387, 4388, 4389, 4390, 4391, 4392, 4393, 4394, 4395, 4396, 4397, 4398, 4399, 4400, 4401, 4402, 4403, 4404, 4405, 4406, 4407, 4408, 4409, 4410, 4411, 4412, 4413, 4414, 4415, 4416, 4417, 4418, 4419, 4420, 4421, 4422, 4423, 4424, 4425, 4426, 4427, 4428, 4429, 4430, 4432, 4433, 4434, 4435, 4436, 4437, 4438, 4439, 4440, 4441, 4442, 4443, 4444, 4445, 4446, 4447, 4448, 4449, 4450, 4451, 4452, 4453, 4455, 4456, 4457, 4458, 4459, 4460, 4461, 4463, 4465, 4466, 4467, 4468, 4469, 4471, 4472, 4473, 4474, 4477, 4478, 4479, 4480, 4481, 4482, 4483, 4484, 4485, 4486, 4487, 4488, 4489, 4490, 4491, 4492, 4493, 4494, 4495, 4496, 4497, 4498, 4499, 4500, 4501, 4502, 4503, 4504, 4505, 4506, 4507, 4508, 4509, 4510, 4511, 4512, 4513, 4514, 4515, 4516, 4517, 4518, 4519, 4520, 4521, 4522, 4523, 4524, 4525, 4526, 4527, 4528, 4529, 4530, 4531, 4532, 4533, 4534, 4535, 4536, 4537, 4538, 4539, 4540, 4541, 4542, 4543, 4544, 4545, 4546, 4547, 4548, 4549, 4551, 4552, 4553, 4554, 4555, 4556, 4557, 4558, 4559, 4560, 4561, 4562, 4563, 4564, 4565, 4566, 4567, 4568, 4569, 4570, 4571, 4572, 4573, 4574, 4575, 4576, 4577, 4578, 4579, 4580, 4581, 4582, 4583, 4584, 4585, 4586, 4587, 4588, 4589, 4590, 4591, 4593, 4594, 4595, 4596, 4597, 4598, 4599, 4600, 4601, 4602, 4603, 4604, 4605, 4606, 4607, 4608, 4610, 4611, 4612, 4613, 4614, 4615, 4616, 4618, 4619, 4620, 4621, 4622, 4623, 4624, 4625, 4626, 4627, 4628, 4629, 4630, 4632, 4633, 4634, 4635, 4636, 4637, 4639, 4640, 4641, 4642, 4643, 4644, 4645, 4646, 4647, 4648, 4650, 4651, 4652, 4653, 4654, 4655, 4656, 4657, 4658, 4659, 4660, 4661, 4662, 4663, 4664, 4665, 4666, 4667, 4668, 4669, 4670, 4671, 4672, 4673, 4674, 4675, 4676, 4677, 4678, 4679, 4680, 4681, 4682, 4683, 4684, 4685, 4686, 4687, 4688, 4689, 4690, 4691, 4692, 4693, 4694, 4695, 4696, 4697, 4698, 4699, 4700, 4701, 4702, 4703, 4704, 4705, 4706, 4707, 4708, 4709, 4710, 4711, 4712, 4713, 4714, 4715, 4716, 4717, 4718, 4719, 4720, 4722, 4723, 4724, 4725, 4726, 4727, 4728, 4729, 4730, 4731, 4732, 4733, 4734, 4735, 4736, 4737, 4738, 4739, 4740, 4741, 4742, 4743, 4744, 4745, 4746, 4747, 4748, 4749, 4750, 4751, 4752, 4753, 4754, 4755, 4756, 4757, 4758, 4759, 4760, 4761, 4762, 4763, 4764, 4765, 4767, 4768, 4770, 4771, 4772, 4773, 4774, 4775, 4776, 4777, 4778, 4779, 4780, 4781, 4782, 4783, 4784, 4785, 4788, 4789, 4790, 4791, 4792, 4793, 4794, 4795, 4796, 4797, 4798, 4799, 4800, 4801, 4802, 4803, 4804, 4805, 4806, 4807, 4808, 4809, 4810, 4811, 4813, 4814, 4815, 4816, 4817, 4818, 4819, 4820, 4821, 4822, 4823, 4825, 4826, 4827, 4828, 4829, 4830, 4831, 4832, 4833, 4834, 4835, 4836, 4837, 4838, 4839, 4840, 4841, 4842, 4843, 4844, 4845, 4846, 4847, 4848, 4849, 4850, 4851, 4852, 4853, 4854, 4855, 4856, 4857, 4858, 4859, 4860, 4861, 4862, 4863, 4864, 4865, 4866, 4867, 4868, 4869, 4871, 4872, 4873, 4874, 4875, 4876, 4877, 4878, 4879, 4880, 4881, 4882, 4883, 4884, 4885, 4887, 4888, 4889, 4890, 4891, 4892, 4893, 4894, 4895, 4897, 4898, 4899, 4900, 4901, 4902, 4903, 4904, 4905, 4906, 4907, 4908, 4909, 4910, 4911, 4912, 4914, 4915, 4916, 4917, 4918, 4919, 4920, 4921, 4922, 4923, 4924, 4925, 4926, 4927, 4928, 4929, 4930, 4931, 4932, 4933, 4934, 4935, 4936, 4937, 4938, 4939, 4940, 4942, 4943, 4944, 4945, 4946, 4947, 4948, 4949, 4950, 4951, 4952, 4953, 4954, 4955, 4956, 4957, 4958, 4959, 4960, 4961, 4962, 4963, 4964, 4965, 4967, 4968, 4969, 4970, 4971, 4972, 4973, 4974, 4975, 4977, 4978, 4979, 4980, 4981, 4982, 4983, 4984, 4986, 4987, 4988, 4989, 4990, 4991, 4993, 4994, 4995, 4996, 4997, 4998, 4999, 5000, 5001, 5002, 5003, 5004, 5005, 5006, 5007, 5009, 5010, 5011, 5012, 5013, 5014, 5015, 5016, 5017, 5018, 5019, 5020, 5021, 5022, 5023, 5024, 5025, 5026, 5027, 5028, 5029, 5031, 5032, 5033, 5034, 5035, 5036, 5037, 5038, 5039, 5040, 5041, 5042, 5043, 5044, 5045, 5046, 5047, 5048, 5049, 5050, 5051, 5052, 5053, 5055, 5056, 5057, 5058, 5059, 5060, 5061, 5062, 5063, 5064, 5065, 5066, 5067, 5068, 5069, 5070, 5071, 5072, 5073, 5074, 5075, 5076, 5077, 5078, 5079, 5080, 5081, 5082, 5083, 5084, 5085, 5086, 5087, 5090, 5091, 5092, 5093, 5094, 5095, 5096, 5097, 5098, 5099, 5100, 5101, 5102, 5103, 5104, 5105, 5106, 5107, 5108, 5109, 5110, 5111, 5112, 5113, 5114, 5115, 5116, 5117, 5118, 5119, 5120, 5121, 5122, 5123, 5124, 5125, 5126, 5127, 5128, 5129, 5130, 5131, 5132, 5133, 5134, 5135, 5136, 5137, 5138, 5139, 5140, 5141, 5142, 5143, 5144, 5145, 5147, 5148, 5149, 5150, 5151, 5152, 5153, 5155, 5156, 5157, 5158, 5159, 5160, 5161, 5162, 5163, 5164, 5165, 5166, 5167, 5168, 5169, 5170, 5171, 5172, 5174, 5175, 5176, 5178, 5179, 5181, 5182, 5183, 5185, 5186, 5187, 5188, 5190, 5191, 5192, 5193, 5194, 5195, 5196, 5197, 5198, 5199, 5200, 5201, 5202, 5203, 5204, 5205, 5206, 5207, 5208, 5209, 5210, 5211, 5212, 5213, 5214, 5215, 5216, 5217, 5218, 5219, 5220, 5221, 5224, 5225, 5226, 5229, 5230, 5231, 5232, 5233, 5234, 5236, 5237, 5238, 5239, 5240, 5241, 5242, 5243, 5245, 5246, 5247, 5248, 5249, 5250, 5251, 5252, 5253, 5254, 5256, 5257, 5258, 5259, 5260, 5261, 5262, 5263, 5264, 5265, 5266, 5267, 5268, 5269, 5270, 5271, 5272, 5273, 5274, 5275, 5276, 5277, 5278, 5279, 5280, 5281, 5282, 5283, 5284, 5285, 5286, 5287, 5288, 5289, 5290, 5291, 5292, 5294, 5295, 5296, 5297, 5298, 5299, 5300, 5301, 5302, 5303, 5304, 5305, 5306, 5307, 5308, 5309, 5310, 5311, 5312, 5313, 5314, 5315, 5316, 5317, 5319, 5320, 5321, 5323, 5324, 5325, 5326, 5327, 5328, 5329, 5330, 5331, 5332, 5333, 5334, 5335, 5336, 5337, 5338, 5339, 5340, 5341, 5342, 5343, 5344, 5345, 5346, 5347, 5348, 5349, 5350, 5351, 5352, 5353, 5354, 5355, 5356, 5357, 5358, 5359, 5361, 5362, 5363, 5364, 5365, 5366, 5367, 5368, 5369, 5370, 5371, 5372, 5373, 5375, 5376, 5377, 5378, 5379, 5380, 5381, 5383, 5384, 5385, 5386, 5387, 5388, 5389, 5390, 5391, 5392, 5393, 5394, 5396, 5397, 5398, 5399, 5400, 5401, 5402, 5403, 5404, 5405, 5406, 5407, 5408, 5409, 5410, 5411, 5412, 5413, 5414, 5416, 5417, 5418, 5419, 5420, 5422, 5423, 5424, 5425, 5426, 5427, 5428, 5429, 5430, 5431, 5432, 5433, 5434, 5435, 5437, 5438, 5439, 5440, 5441, 5442, 5443, 5444, 5445, 5446, 5447, 5448, 5449, 5450, 5451, 5452, 5453, 5454, 5455, 5456, 5457, 5458, 5459, 5460, 5461, 5462, 5463, 5464, 5465, 5466, 5467, 5468, 5469, 5470, 5471, 5472, 5473, 5474, 5475, 5476, 5477, 5478, 5479, 5480, 5481, 5482, 5483, 5484, 5485, 5486, 5487, 5488, 5489, 5490, 5491, 5492, 5493, 5494, 5495, 5496, 5497, 5498, 5499, 5500, 5501, 5502, 5503, 5504, 5505, 5506, 5507, 5508, 5509, 5510, 5511, 5512, 5513, 5514, 5515, 5516, 5517, 5518, 5519, 5520, 5521, 5522, 5523, 5524, 5525, 5526, 5527, 5529, 5530, 5531, 5532, 5533, 5534, 5535, 5536, 5537, 5538, 5539, 5540, 5541, 5542, 5543, 5544, 5545, 5546, 5547, 5548, 5549, 5550, 5551, 5552, 5554, 5555, 5556, 5557, 5558, 5559, 5560, 5561, 5562, 5563, 5564, 5565, 5566, 5567, 5568, 5569, 5570, 5571, 5572, 5573, 5574, 5575, 5576, 5577, 5578, 5579, 5580, 5581, 5582, 5583, 5584, 5585, 5586, 5587, 5588, 5589, 5590, 5591, 5592, 5593, 5594, 5595, 5596, 5597, 5598, 5600, 5601, 5602, 5603, 5604, 5605, 5606, 5607, 5608, 5609, 5610, 5612, 5613, 5614, 5615, 5616, 5617, 5618, 5620, 5621, 5622, 5623, 5624, 5625, 5626, 5627, 5628, 5629, 5630, 5631, 5632, 5633, 5634, 5635, 5636, 5637, 5638, 5639, 5640, 5642, 5643, 5645, 5646, 5647, 5648, 5649, 5650, 5651, 5652, 5653, 5654, 5655, 5656, 5657, 5658, 5659, 5660, 5661, 5662, 5663, 5664, 5665, 5666, 5667, 5668, 5669, 5670, 5671, 5672, 5673, 5674, 5676, 5677, 5678, 5679, 5680, 5681, 5682, 5683, 5684, 5685, 5686, 5688, 5689, 5690, 5691, 5692, 5693, 5694, 5695, 5696, 5697, 5698, 5699, 5700, 5701, 5702, 5703, 5704, 5705, 5706, 5707, 5708, 5709, 5711, 5712, 5713, 5714, 5716, 5717, 5718, 5720, 5721, 5722, 5723, 5724, 5726, 5728, 5729, 5730, 5731, 5732, 5733, 5734, 5735, 5736, 5737, 5739, 5740, 5741, 5742, 5743, 5744, 5745, 5746, 5747, 5748, 5749, 5751, 5752, 5753, 5754, 5755, 5756, 5757, 5758, 5759, 5760, 5761, 5762, 5763, 5764, 5765, 5766, 5767, 5768, 5769, 5771, 5772, 5773, 5774, 5775, 5776, 5777, 5778, 5779, 5780, 5781, 5782, 5783, 5784, 5785, 5786, 5787, 5788, 5789, 5791, 5792, 5793, 5794, 5795, 5796, 5797, 5798, 5799, 5800, 5801, 5802, 5803, 5804, 5805, 5806, 5808, 5809, 5810, 5811, 5813, 5814, 5815, 5816, 5817, 5819, 5820, 5821, 5822, 5823, 5825, 5826, 5827, 5828, 5829, 5830, 5831, 5832, 5833, 5834, 5835, 5836, 5837, 5838, 5839, 5840, 5841, 5842, 5843, 5844, 5846, 5847, 5848, 5849, 5850, 5851, 5852, 5853, 5854, 5855, 5856, 5857, 5858, 5859, 5860, 5861, 5862, 5863, 5864, 5865, 5866, 5868, 5869, 5870, 5871, 5872, 5874, 5875, 5876, 5877, 5878, 5880, 5881, 5882, 5883, 5884, 5886, 5887, 5888, 5889, 5890, 5891, 5892, 5893, 5894, 5895, 5896, 5897, 5898, 5899, 5900, 5901, 5902, 5903, 5904, 5905, 5906, 5907, 5908, 5909, 5910, 5912, 5913, 5914, 5915, 5916, 5917, 5918, 5919, 5920, 5921, 5922, 5924, 5925, 5926, 5927, 5928, 5929, 5932, 5933, 5934, 5935, 5936, 5937, 5938, 5939, 5940, 5942, 5943, 5944, 5945, 5946, 5947, 5948, 5949, 5950, 5952, 5953, 5954, 5955, 5956, 5957, 5960, 5962, 5963, 5965, 5966, 5967, 5968, 5969, 5970, 5971, 5972, 5973, 5974, 5975, 5976, 5977, 5978, 5979, 5980, 5981, 5983, 5984, 5985, 5986, 5987, 5988, 5989, 5990, 5991, 5992, 5993, 5994, 5995, 5996, 5997, 5998, 5999, 6000, 6001, 6002, 6003, 6004, 6005, 6006, 6007, 6008, 6009, 6010, 6011, 6012, 6013, 6015, 6016, 6017, 6018, 6019, 6021, 6022, 6023, 6024, 6025, 6027, 6028, 6029, 6030, 6031, 6032, 6034, 6036, 6037, 6038, 6039, 6040, 6041, 6042, 6043, 6044, 6045, 6046, 6047, 6048, 6049, 6051, 6052, 6053, 6055, 6056, 6057, 6058, 6059, 6060, 6061, 6063, 6064, 6065, 6066, 6067, 6068, 6069, 6070, 6071, 6072, 6073, 6074, 6075, 6076, 6077, 6078, 6079, 6080, 6081, 6083, 6084, 6085, 6086, 6087, 6088, 6089, 6090, 6091, 6092, 6093, 6094, 6095, 6096, 6097, 6099, 6100, 6101, 6102, 6103, 6104, 6105, 6106, 6107, 6108, 6109, 6111, 6112, 6113, 6114, 6115, 6116, 6117, 6118, 6119, 6120, 6121, 6122, 6123, 6124, 6126, 6127, 6128, 6129, 6130, 6131, 6132, 6133, 6134, 6135, 6136, 6137, 6139, 6140, 6141, 6142, 6143, 6144, 6145, 6146, 6147, 6148, 6149, 6150, 6151, 6152, 6153, 6154, 6155, 6156, 6157, 6158, 6159, 6160, 6161, 6162, 6163, 6164, 6165, 6166, 6167, 6168, 6169, 6170, 6171, 6172, 6173, 6174, 6175, 6176, 6178, 6179, 6180, 6181, 6182, 6183, 6184, 6185, 6186, 6187, 6189, 6190, 6191, 6192, 6193, 6194, 6195, 6196, 6197, 6198, 6200, 6201, 6202, 6203, 6204, 6205, 6206, 6207, 6208, 6209, 6210, 6211, 6212, 6213, 6214, 6215, 6216, 6217, 6218, 6219, 6220, 6221, 6222, 6223, 6224, 6225, 6226, 6227, 6228, 6229, 6230, 6231, 6232, 6233, 6234, 6235, 6236, 6237, 6238, 6239, 6240, 6241, 6242, 6243, 6244, 6245, 6246, 6247, 6248, 6249, 6250, 6251, 6252, 6253, 6254, 6255, 6256, 6257, 6258, 6259, 6260, 6261, 6262, 6263, 6264, 6265, 6266, 6267, 6269, 6270, 6271, 6272, 6273, 6274, 6275, 6276, 6277, 6278, 6279, 6280, 6281, 6282, 6283, 6284, 6285, 6286, 6287, 6288, 6289, 6290, 6291, 6292, 6293, 6294, 6295, 6296, 6297, 6298, 6299, 6300, 6301, 6302, 6303, 6304, 6305, 6306, 6307, 6308, 6309, 6310, 6311, 6313, 6314, 6315, 6316, 6317, 6318, 6319, 6320, 6321, 6322, 6323, 6324, 6325, 6326, 6327, 6328, 6329, 6330, 6331, 6332, 6333, 6334, 6335, 6336, 6337, 6338, 6339, 6340, 6341, 6342, 6343, 6344, 6345, 6346, 6347, 6348, 6349, 6350, 6351, 6352, 6353, 6354, 6355, 6356, 6357, 6358, 6359, 6360, 6361, 6362, 6363, 6364, 6365, 6369, 6370, 6371, 6372, 6373, 6374, 6375, 6376, 6377, 6378, 6379, 6380, 6381, 6382, 6383, 6384, 6385, 6386, 6387, 6388, 6389, 6390, 6391, 6392, 6393, 6394, 6395, 6396, 6398, 6399, 6401, 6402, 6404, 6405, 6407, 6408, 6410, 6411, 6412, 6413, 6414, 6415, 6416, 6417, 6418, 6419, 6420, 6421, 6422, 6423, 6424, 6425, 6426, 6427, 6428, 6429, 6430, 6431, 6433, 6434, 6435, 6436, 6437, 6438, 6439, 6440, 6441, 6442, 6443, 6444, 6445, 6446, 6447, 6448, 6449, 6450, 6452, 6453, 6454, 6455, 6457, 6458, 6460, 6461, 6462, 6463, 6464, 6466, 6467, 6468, 6469, 6470, 6471, 6472, 6473, 6474, 6475, 6476, 6477, 6478, 6479, 6480, 6481, 6482, 6483, 6484, 6485, 6486, 6487, 6488, 6489, 6491, 6492, 6493, 6494, 6495, 6496, 6497, 6498, 6499, 6500, 6501, 6502, 6503, 6504, 6505, 6506, 6507, 6508, 6509, 6510, 6511, 6512, 6513, 6514, 6515, 6516, 6517, 6518, 6519, 6520, 6521, 6522, 6523, 6524, 6525, 6526, 6527, 6528, 6529, 6530, 6531, 6532, 6533, 6534, 6535, 6536, 6537, 6538, 6539, 6540, 6541, 6542, 6543, 6544, 6545, 6547, 6548, 6552, 6553, 6554, 6555, 6556, 6557, 6558, 6559, 6560, 6561, 6562, 6563, 6564, 6565, 6566, 6567, 6568, 6569, 6570, 6571, 6572, 6573, 6575, 6576, 6577, 6578, 6579, 6580, 6581, 6582, 6583, 6584, 6585, 6586, 6587, 6589, 6590, 6591, 6592, 6593, 6594, 6595, 6596, 6597, 6598, 6600, 6601, 6602, 6603, 6604, 6605, 6606, 6607, 6608, 6609, 6610, 6611, 6612, 6613, 6614, 6615, 6616, 6617, 6618, 6619, 6620, 6621, 6622, 6623, 6624, 6625, 6626, 6627, 6628, 6629, 6630, 6631, 6632, 6633, 6634, 6635, 6636, 6637, 6639, 6640, 6641, 6642, 6643, 6644, 6645, 6646, 6647, 6648, 6649, 6650, 6651, 6652, 6653, 6654, 6655, 6656, 6657, 6658, 6659, 6660, 6661, 6662, 6663, 6664, 6665, 6666, 6667, 6668, 6669, 6670, 6671, 6672, 6673, 6675, 6676, 6677, 6678, 6679, 6680, 6681, 6682, 6683, 6684, 6685, 6686, 6687, 6688, 6689, 6690, 6691, 6692, 6693, 6694, 6695, 6696, 6697, 6698, 6699, 6700, 6701, 6702, 6703, 6704, 6705, 6706, 6707, 6708, 6709, 6710, 6711, 6712, 6713, 6714, 6715, 6716, 6717, 6718, 6719, 6720, 6721, 6722, 6723, 6724, 6725, 6726, 6727, 6728, 6729, 6730, 6731, 6732, 6733, 6734, 6735, 6736, 6737, 6738, 6739, 6740, 6741, 6742, 6743, 6744, 6745, 6747, 6748, 6750, 6751, 6752, 6753, 6754, 6755, 6756, 6757, 6758, 6759, 6760, 6762, 6764, 6765, 6766, 6767, 6768, 6769, 6770, 6771, 6772, 6773, 6774, 6775, 6776, 6777, 6778, 6779, 6780, 6781, 6782, 6783, 6784, 6785, 6786, 6787, 6788, 6789, 6790, 6791, 6792, 6793}",5344,"{2179, 2180, 1400, 2182, 4367, 4368, 3857, 3858, 4371, 4755, 3868, 4776, 1580, 1581, 1582, 2224, 2225, 1982, 6591, 6592, 1985, 4298, 1994, 4305, 1496, 1248, 2275, 2276, 1253, 3688, 4978, 4979, 3187, 3190, 3704, 3195}",36,"{989, 1078, 1081, 1084, 1085, 1086, 1087, 1088, 1089, 1090, 1092, 1093, 1094, 1095, 1096, 1097, 1098, 1099, 1100, 1101, 1103, 1104, 1105, 1106, 1107, 1108, 1109, 1110, 1111, 1112, 1113, 1114, 1115, 1116, 1117, 1118, 1119, 1120, 1121, 1122, 1123, 1124, 1125, 1126, 1127, 1128, 1129, 1130, 1131, 1132, 1133, 1134, 1135, 1136, 1137, 1138, 1139, 1140, 1141, 1142, 1143, 1144, 1145, 1146, 1147, 1148, 1149, 1150, 1151, 1152, 1153, 1154, 1155, 1156, 1157, 1158, 1159, 1160, 1161, 1162, 1163, 1164, 1165, 1166, 1167, 1168, 1169, 1170, 1171, 1172, 1173, 1174, 1175, 1176, 1177, 1178, 1179, 1180, 1181, 1182, 1183, 1184, 1185, 1186, 1187, 1188, 1189, 1190, 1191, 1192, 1193, 1194, 1195, 1196, 1197, 1198, 1199, 1200, 1201, 1202, 1203, 1204, 1205, 1206, 1207, 1208, 1209, 1210, 1211, 1212, 1213, 1214, 1215, 1216, 1217, 1218, 1219, 1220, 1221, 1222, 1223, 1224, 1225, 1226, 1227, 1228, 1229, 1230, 1231, 1232, 1233, 1234, 1235, 1236, 1237, 1238, 1239, 1240, 1241, 1242, 1243, 1244, 1245, 1246, 1247, 1249, 1250, 1251, 1252, 1254, 1255, 1258, 1259, 1260, 1262, 1263, 1264, 1265, 1267, 1268, 1269, 1270, 1271, 1272, 1273, 1274, 1275, 1276, 1277, 1278, 1279, 1280, 1281, 1282, 1283, 1284, 1285, 1286, 1287, 1288, 1289, 1290, 1291, 1292, 1293, 1294, 1295, 1296, 1297, 1298, 1299, 1300, 1301, 1302, 1303, 1304, 1305, 1306, 1307, 1308, 1309, 1310, 1311, 1313, 1314, 1315, 1316, 1317, 1318, 1320, 1321, 1323, 1324, 1325, 1326, 1327, 1328, 1329, 1330, 1331, 1332, 1333, 1334, 1335, 1336, 1337, 1338, 1339, 1340, 1342, 1343, 1344, 1345, 1346, 1347, 1348, 1349, 1350, 1351, 1352, 1353, 1354, 1355, 1356, 1357, 1358, 1359, 1360, 1361, 1362, 1363, 1364, 1365, 1366, 1367, 1368, 1369, 1370, 1371, 1372, 1373, 1374, 1375, 1376, 1377, 1378, 1379, 1380, 1381, 1382, 1383, 1384, 1385, 1386, 1387, 1388, 1389, 1390, 1391, 1392, 1393, 1394, 1395, 1396, 1397, 1399, 1401, 1402, 1403, 1404, 1405, 1406, 1407, 1408, 1409, 1410, 1411, 1412, 1413, 1414, 1415, 1416, 1418, 1419, 1420, 1421, 1422, 1423, 1424, 1426, 1427, 1428, 1429, 1430, 1431, 1432, 1433, 1434, 1435, 1436, 1437, 1439, 1440, 1441, 1442, 1443, 1445, 1446, 1447, 1448, 1449, 1450, 1451, 1452, 1453, 1454, 1455, 1456, 1457, 1458, 1459, 1460, 1461, 1462, 1463, 1464, 1465, 1466, 1467, 1468, 1469, 1470, 1471, 1472, 1473, 1474, 1475, 1476, 1477, 1478, 1479, 1480, 1481, 1482, 1483, 1484, 1485, 1487, 1488, 1489, 1490, 1491, 1492, 1493, 1494, 1495, 1497, 1499, 1500, 1501, 1502, 1503, 1504, 1505, 1506, 1507, 1508, 1509, 1510, 1511, 1512, 1513, 1514, 1515, 1516, 1517, 1518, 1519, 1520, 1521, 1522, 1523, 1524, 1525, 1526, 1527, 1528, 1529, 1530, 1531, 1532, 1533, 1534, 1535, 1536, 1537, 1538, 1539, 1540, 1541, 1542, 1543, 1544, 1545, 1546, 1548, 1549, 1550, 1551, 1552, 1553, 1554, 1556, 1557, 1558, 1559, 1560, 1561, 1562, 1563, 1564, 1565, 1566, 1567, 1568, 1569, 1570, 1571, 1572, 1573, 1574, 1575, 1576, 1577, 1578, 1579, 1583, 1584, 1585, 1586, 1587, 1588, 1589, 1590, 1591, 1592, 1593, 1594, 1595, 1596, 1597, 1598, 1599, 1600, 1601, 1602, 1603, 1604, 1605, 1606, 1607, 1608, 1609, 1610, 1612, 1613, 1614, 1615, 1616, 1617, 1618, 1619, 1620, 1621, 1622, 1623, 1624, 1625, 1626, 1627, 1628, 1629, 1630, 1631, 1632, 1633, 1634, 1635, 1636, 1637, 1638, 1639, 1640, 1641, 1642, 1643, 1644, 1645, 1646, 1647, 1648, 1649, 1650, 1651, 1652, 1653, 1654, 1655, 1656, 1657, 1658, 1659, 1660, 1661, 1662, 1663, 1664, 1665, 1666, 1667, 1668, 1669, 1670, 1671, 1672, 1673, 1674, 1675, 1676, 1677, 1678, 1679, 1680, 1681, 1682, 1683, 1684, 1685, 1686, 1687, 1688, 1689, 1690, 1691, 1692, 1693, 1694, 1695, 1696, 1697, 1698, 1699, 1700, 1701, 1702, 1703, 1704, 1705, 1706, 1707, 1708, 1709, 1710, 1711, 1712, 1713, 1714, 1715, 1716, 1717, 1718, 1719, 1720, 1721, 1722, 1723, 1724, 1725, 1726, 1727, 1728, 1729, 1730, 1731, 1732, 1734, 1735, 1736, 1737, 1738, 1739, 1740, 1741, 1742, 1743, 1744, 1745, 1746, 1747, 1748, 1749, 1752, 1753, 1754, 1755, 1756, 1757, 1758, 1759, 1760, 1761, 1762, 1764, 1765, 1766, 1767, 1768, 1769, 1770, 1771, 1772, 1773, 1774, 1775, 1776, 1778, 1779, 1780, 1781, 1782, 1783, 1784, 1785, 1786, 1787, 1788, 1789, 1790, 1791, 1792, 1793, 1795, 1796, 1797, 1798, 1799, 1800, 1801, 1802, 1803, 1804, 1805, 1806, 1807, 1808, 1809, 1810, 1811, 1812, 1813, 1814, 1815, 1816, 1817, 1818, 1819, 1820, 1821, 1822, 1823, 1824, 1825, 1826, 1827, 1828, 1829, 1830, 1831, 1832, 1833, 1834, 1835, 1836, 1837, 1838, 1839, 1840, 1841, 1842, 1843, 1844, 1845, 1846, 1847, 1848, 1849, 1850, 1851, 1852, 1853, 1854, 1855, 1857, 1858, 1859, 1860, 1861, 1862, 1863, 1864, 1865, 1866, 1867, 1868, 1869, 1870, 1871, 1872, 1873, 1874, 1875, 1876, 1877, 1878, 1879, 1880, 1881, 1882, 1883, 1884, 1885, 1886, 1887, 1888, 1889, 1890, 1891, 1892, 1893, 1894, 1895, 1896, 1897, 1898, 1899, 1900, 1901, 1902, 1903, 1904, 1905, 1907, 1908, 1909, 1910, 1911, 1912, 1914, 1915, 1916, 1918, 1919, 1920, 1921, 1922, 1923, 1924, 1925, 1926, 1927, 1928, 1929, 1930, 1931, 1932, 1934, 1936, 1937, 1938, 1939, 1940, 1941, 1942, 1943, 1944, 1945, 1946, 1947, 1948, 1949, 1950, 1951, 1952, 1954, 1955, 1956, 1957, 1958, 1959, 1960, 1961, 1962, 1963, 1964, 1965, 1966, 1967, 1968, 1969, 1970, 1971, 1972, 1973, 1974, 1975, 1976, 1977, 1978, 1979, 1980, 1981, 1983, 1984, 1986, 1987, 1988, 1990, 1991, 1992, 1993, 1995, 1996, 1997, 1998, 1999, 2000, 2001, 2002, 2003, 2004, 2005, 2006, 2007, 2008, 2009, 2010, 2011, 2012, 2014, 2015, 2016, 2017, 2018, 2019, 2020, 2021, 2022, 2023, 2024, 2025, 2026, 2027, 2028, 2029, 2030, 2031, 2032, 2033, 2034, 2035, 2036, 2037, 2038, 2039, 2040, 2041, 2042, 2043, 2044, 2045, 2046, 2047, 2048, 2049, 2050, 2051, 2052, 2053, 2055, 2056, 2057, 2058, 2059, 2060, 2061, 2062, 2063, 2064, 2065, 2066, 2067, 2068, 2069, 2070, 2071, 2073, 2074, 2075, 2076, 2077, 2079, 2080, 2081, 2082, 2083, 2084, 2085, 2086, 2087, 2088, 2089, 2090, 2091, 2092, 2094, 2095, 2096, 2097, 2098, 2099, 2100, 2101, 2102, 2103, 2104, 2106, 2107, 2108, 2109, 2110, 2111, 2112, 2113, 2114, 2115, 2116, 2117, 2118, 2119, 2120, 2121, 2122, 2123, 2124, 2125, 2126, 2128, 2129, 2130, 2131, 2132, 2133, 2134, 2135, 2137, 2138, 2139, 2140, 2141, 2142, 2143, 2144, 2145, 2146, 2147, 2148, 2149, 2150, 2151, 2152, 2153, 2154, 2155, 2156, 2157, 2158, 2159, 2160, 2161, 2162, 2163, 2164, 2166, 2167, 2168, 2169, 2170, 2171, 2172, 2173, 2174, 2175, 2176, 2177, 2178, 2181, 2183, 2184, 2185, 2186, 2187, 2188, 2189, 2190, 2191, 2192, 2193, 2194, 2195, 2196, 2197, 2198, 2200, 2201, 2202, 2203, 2204, 2205, 2206, 2207, 2208, 2209, 2210, 2211, 2212, 2213, 2214, 2215, 2216, 2217, 2218, 2219, 2220, 2221, 2222, 2223, 2226, 2228, 2229, 2230, 2231, 2232, 2233, 2234, 2235, 2236, 2237, 2239, 2240, 2241, 2242, 2243, 2244, 2245, 2246, 2247, 2248, 2249, 2250, 2251, 2252, 2253, 2254, 2255, 2259, 2260, 2261, 2262, 2263, 2264, 2265, 2266, 2267, 2268, 2269, 2270, 2271, 2272, 2273, 2274, 2277, 2280, 2281, 2282, 2283, 2284, 2285, 2287, 2288, 2289, 2290, 2291, 2292, 2293, 2294, 2295, 2296, 2297, 2298, 2299, 2300, 2301, 2302, 2303, 2304, 2305, 2306, 2307, 2309, 2310, 2311, 2312, 2313, 2314, 2315, 2316, 2317, 2318, 2319, 2320, 2321, 2322, 2323, 2324, 2325, 2327, 2328, 2329, 2330, 2331, 2332, 2333, 2334, 2335, 2336, 2337, 2338, 2339, 2340, 2341, 2342, 2344, 2345, 2346, 2347, 2348, 2349, 2350, 2351, 2352, 2353, 2354, 2355, 2356, 2357, 2358, 2359, 2360, 2361, 2362, 2363, 2364, 2365, 2366, 2367, 2368, 2369, 2370, 2371, 2373, 2374, 2375, 2376, 2377, 2378, 2379, 2380, 2381, 2382, 2383, 2384, 2385, 2386, 2387, 2388, 2389, 2390, 2391, 2392, 2393, 2394, 2395, 2396, 2397, 2398, 2399, 2401, 2402, 2403, 2404, 2405, 2406, 2407, 2408, 2409, 2410, 2411, 2412, 2413, 2414, 2415, 2416, 2419, 2420, 2421, 2422, 2423, 2424, 2425, 2426, 2427, 2428, 2429, 2430, 2431, 2432, 2433, 2434, 2435, 2436, 2437, 2438, 2439, 2440, 2441, 2442, 2443, 2444, 2445, 2446, 2447, 2448, 2449, 2450, 2452, 2453, 2454, 2455, 2456, 2457, 2458, 2459, 2460, 2461, 2462, 2463, 2464, 2465, 2466, 2467, 2469, 2470, 2471, 2472, 2473, 2474, 2475, 2476, 2477, 2478, 2479, 2480, 2481, 2482, 2483, 2484, 2485, 2486, 2487, 2488, 2489, 2490, 2491, 2492, 2494, 2495, 2496, 2497, 2498, 2499, 2500, 2501, 2502, 2503, 2504, 2505, 2506, 2508, 2509, 2510, 2511, 2512, 2513, 2514, 2515, 2516, 2517, 2518, 2519, 2520, 2521, 2522, 2523, 2524, 2525, 2526, 2527, 2528, 2529, 2530, 2531, 2532, 2533, 2534, 2535, 2536, 2537, 2538, 2540, 2541, 2542, 2543, 2544, 2545, 2546, 2547, 2548, 2549, 2550, 2551, 2552, 2553, 2554, 2555, 2556, 2557, 2558, 2559, 2560, 2561, 2562, 2563, 2564, 2566, 2567, 2568, 2569, 2570, 2572, 2573, 2574, 2575, 2576, 2577, 2578, 2579, 2580, 2581, 2582, 2583, 2584, 2585, 2586, 2587, 2590, 2591, 2592, 2593, 2594, 2595, 2596, 2597, 2598, 2599, 2600, 2601, 2603, 2604, 2605, 2606, 2607, 2608, 2609, 2610, 2611, 2612, 2613, 2614, 2615, 2616, 2617, 2620, 2621, 2622, 2623, 2624, 2625, 2626, 2627, 2628, 2629, 2630, 2631, 2632, 2633, 2635, 2636, 2637, 2638, 2639, 2640, 2641, 2642, 2643, 2644, 2645, 2646, 2647, 2648, 2649, 2650, 2652, 2653, 2654, 2655, 2656, 2657, 2658, 2659, 2660, 2662, 2664, 2665, 2666, 2667, 2668, 2669, 2671, 2672, 2673, 2674, 2677, 2679, 2680, 2681, 2682, 2683, 2684, 2685, 2686, 2687, 2688, 2689, 2690, 2691, 2692, 2693, 2694, 2695, 2696, 2697, 2698, 2699, 2700, 2701, 2703, 2704, 2705, 2706, 2707, 2708, 2709, 2710, 2711, 2712, 2713, 2715, 2716, 2717, 2718, 2720, 2721, 2723, 2724, 2725, 2726, 2727, 2728, 2729, 2730, 2731, 2732, 2733, 2734, 2735, 2736, 2737, 2738, 2739, 2740, 2741, 2744, 2745, 2746, 2747, 2748, 2749, 2750, 2751, 2753, 2754, 2755, 2756, 2757, 2758, 2759, 2760, 2761, 2762, 2763, 2764, 2765, 2766, 2768, 2769, 2770, 2771, 2772, 2773, 2774, 2775, 2776, 2777, 2778, 2779, 2780, 2782, 2783, 2784, 2785, 2786, 2787, 2789, 2790, 2791, 2792, 2793, 2794, 2795, 2796, 2797, 2798, 2799, 2800, 2801, 2802, 2803, 2804, 2805, 2806, 2807, 2808, 2809, 2811, 2812, 2813, 2814, 2815, 2816, 2817, 2818, 2819, 2820, 2821, 2822, 2823, 2825, 2826, 2827, 2828, 2830, 2831, 2832, 2833, 2834, 2835, 2836, 2837, 2838, 2839, 2840, 2841, 2842, 2843, 2844, 2845, 2846, 2847, 2848, 2849, 2850, 2851, 2852, 2853, 2854, 2855, 2856, 2857, 2858, 2859, 2860, 2861, 2862, 2863, 2865, 2866, 2867, 2868, 2869, 2870, 2871, 2872, 2873, 2874, 2875, 2877, 2878, 2880, 2883, 2884, 2886, 2887, 2888, 2889, 2890, 2891, 2892, 2893, 2894, 2895, 2896, 2897, 2898, 2899, 2900, 2901, 2902, 2903, 2904, 2905, 2906, 2907, 2908, 2909, 2910, 2911, 2912, 2914, 2915, 2916, 2917, 2918, 2919, 2920, 2921, 2923, 2924, 2925, 2926, 2927, 2930, 2931, 2932, 2933, 2934, 2935, 2937, 2938, 2939, 2940, 2941, 2942, 2943, 2944, 2945, 2946, 2947, 2949, 2950, 2951, 2952, 2953, 2955, 2956, 2957, 2959, 2960, 2961, 2962, 2963, 2965, 2966, 2967, 2968, 2969, 2970, 2971, 2972, 2973, 2974, 2975, 2976, 2977, 2978, 2979, 2980, 2981, 2982, 2983, 2984, 2985, 2986, 2987, 2988, 2989, 2990, 2991, 2992, 2993, 2994, 2995, 2996, 2997, 2998, 2999, 3000, 3001, 3002, 3003, 3004, 3005, 3006, 3007, 3008, 3009, 3010, 3011, 3012, 3014, 3015, 3016, 3017, 3018, 3019, 3020, 3022, 3023, 3024, 3025, 3026, 3027, 3028, 3029, 3030, 3031, 3032, 3033, 3034, 3035, 3036, 3037, 3038, 3039, 3040, 3042, 3043, 3044, 3045, 3046, 3047, 3048, 3049, 3050, 3051, 3052, 3053, 3054, 3055, 3057, 3058, 3059, 3060, 3061, 3062, 3063, 3064, 3065, 3066, 3067, 3068, 3070, 3071, 3072, 3073, 3074, 3075, 3076, 3077, 3079, 3080, 3081, 3082, 3083, 3084, 3086, 3087, 3088, 3089, 3090, 3091, 3093, 3094, 3095, 3096, 3097, 3098, 3099, 3100, 3101, 3102, 3103, 3104, 3105, 3106, 3107, 3108, 3109, 3110, 3111, 3112, 3113, 3114, 3115, 3116, 3118, 3119, 3120, 3121, 3122, 3123, 3124, 3125, 3126, 3127, 3128, 3131, 3132, 3133, 3134, 3135, 3136, 3137, 3138, 3139, 3141, 3142, 3143, 3144, 3146, 3147, 3149, 3150, 3151, 3152, 3153, 3154, 3155, 3156, 3157, 3158, 3159, 3160, 3162, 3163, 3164, 3165, 3166, 3167, 3168, 3169, 3170, 3171, 3172, 3173, 3174, 3175, 3176, 3177, 3178, 3179, 3180, 3181, 3182, 3183, 3184, 3185, 3186, 3188, 3189, 3191, 3192, 3193, 3194, 3196, 3197, 3198, 3199, 3200, 3201, 3202, 3203, 3204, 3205, 3206, 3207, 3208, 3209, 3210, 3211, 3212, 3213, 3214, 3215, 3216, 3217, 3218, 3219, 3222, 3223, 3224, 3225, 3226, 3227, 3228, 3229, 3231, 3232, 3233, 3234, 3236, 3240, 3241, 3242, 3243, 3244, 3245, 3247, 3248, 3249, 3250, 3251, 3252, 3253, 3254, 3255, 3256, 3257, 3258, 3259, 3260, 3261, 3262, 3263, 3265, 3269, 3270, 3271, 3272, 3273, 3276, 3277, 3279, 3280, 3281, 3282, 3283, 3284, 3285, 3286, 3287, 3288, 3289, 3291, 3292, 3293, 3294, 3295, 3296, 3298, 3299, 3300, 3301, 3302, 3303, 3304, 3305, 3306, 3307, 3308, 3310, 3311, 3312, 3313, 3314, 3316, 3317, 3318, 3319, 3320, 3321, 3322, 3323, 3325, 3326, 3327, 3328, 3329, 3330, 3331, 3332, 3333, 3334, 3335, 3336, 3337, 3338, 3339, 3340, 3341, 3342, 3343, 3344, 3345, 3346, 3347, 3349, 3350, 3351, 3352, 3353, 3354, 3355, 3356, 3357, 3358, 3359, 3360, 3362, 3363, 3364, 3365, 3366, 3367, 3368, 3369, 3370, 3371, 3372, 3373, 3374, 3375, 3376, 3377, 3378, 3379, 3380, 3381, 3382, 3383, 3384, 3386, 3387, 3388, 3389, 3390, 3391, 3392, 3393, 3394, 3396, 3397, 3398, 3399, 3400, 3401, 3402, 3403, 3404, 3405, 3406, 3407, 3408, 3410, 3411, 3412, 3413, 3414, 3415, 3416, 3417, 3418, 3419, 3421, 3422, 3423, 3424, 3426, 3427, 3428, 3429, 3430, 3431, 3432, 3433, 3434, 3435, 3436, 3437, 3438, 3439, 3440, 3441, 3442, 3443, 3444, 3445, 3446, 3447, 3448, 3449, 3450, 3451, 3452, 3453, 3454, 3455, 3456, 3457, 3459, 3460, 3461, 3462, 3463, 3465, 3466, 3467, 3468, 3469, 3470, 3471, 3472, 3473, 3474, 3475, 3476, 3477, 3480, 3481, 3482, 3483, 3484, 3485, 3486, 3487, 3488, 3489, 3490, 3491, 3492, 3493, 3494, 3495, 3497, 3498, 3499, 3500, 3501, 3502, 3503, 3504, 3505, 3506, 3507, 3509, 3510, 3511, 3512, 3513, 3514, 3515, 3516, 3519, 3520, 3521, 3522, 3523, 3525, 3526, 3527, 3528, 3529, 3530, 3531, 3532, 3533, 3534, 3535, 3536, 3538, 3539, 3540, 3541, 3542, 3543, 3544, 3545, 3546, 3547, 3548, 3549, 3550, 3551, 3552, 3553, 3554, 3556, 3557, 3558, 3559, 3562, 3563, 3564, 3565, 3566, 3567, 3568, 3569, 3570, 3571, 3572, 3573, 3574, 3575, 3576, 3577, 3578, 3580, 3581, 3582, 3583, 3584, 3585, 3586, 3588, 3589, 3591, 3592, 3593, 3594, 3595, 3596, 3598, 3599, 3600, 3601, 3602, 3603, 3604, 3605, 3606, 3607, 3608, 3609, 3610, 3611, 3612, 3613, 3614, 3615, 3616, 3617, 3618, 3620, 3621, 3622, 3623, 3624, 3625, 3626, 3627, 3628, 3629, 3630, 3631, 3632, 3633, 3634, 3635, 3636, 3637, 3638, 3639, 3640, 3642, 3644, 3645, 3646, 3647, 3648, 3649, 3650, 3651, 3652, 3653, 3655, 3656, 3657, 3658, 3660, 3661, 3662, 3663, 3664, 3665, 3666, 3667, 3668, 3669, 3670, 3671, 3672, 3673, 3674, 3675, 3676, 3677, 3678, 3679, 3680, 3681, 3682, 3683, 3684, 3685, 3686, 3687, 3689, 3690, 3691, 3692, 3693, 3694, 3696, 3697, 3698, 3699, 3700, 3701, 3702, 3703, 3705, 3706, 3707, 3708, 3709, 3710, 3711, 3712, 3713, 3716, 3717, 3718, 3719, 3721, 3722, 3724, 3728, 3729, 3730, 3731, 3732, 3733, 3734, 3735, 3736, 3737, 3738, 3739, 3740, 3743, 3744, 3748, 3749, 3750, 3751, 3752, 3753, 3754, 3756, 3757, 3758, 3759, 3760, 3761, 3762, 3763, 3764, 3765, 3766, 3767, 3768, 3769, 3770, 3772, 3773, 3774, 3775, 3776, 3777, 3778, 3779, 3781, 3782, 3783, 3784, 3785, 3786, 3787, 3788, 3789, 3790, 3791, 3792, 3793, 3794, 3795, 3796, 3797, 3798, 3799, 3800, 3801, 3802, 3803, 3804, 3805, 3806, 3807, 3808, 3809, 3810, 3811, 3812, 3813, 3814, 3815, 3817, 3818, 3819, 3820, 3821, 3822, 3823, 3825, 3826, 3827, 3828, 3829, 3830, 3831, 3832, 3833, 3834, 3835, 3836, 3837, 3838, 3839, 3840, 3841, 3843, 3844, 3845, 3846, 3847, 3848, 3849, 3850, 3851, 3852, 3853, 3854, 3855, 3856, 3859, 3860, 3861, 3862, 3863, 3864, 3866, 3867, 3869, 3870, 3871, 3872, 3873, 3874, 3875, 3877, 3878, 3879, 3880, 3884, 3886, 3887, 3888, 3889, 3890, 3891, 3892, 3893, 3894, 3895, 3896, 3897, 3898, 3899, 3900, 3901, 3902, 3903, 3904, 3905, 3906, 3907, 3908, 3910, 3912, 3913, 3915, 3917, 3918, 3919, 3920, 3921, 3922, 3923, 3924, 3925, 3926, 3927, 3928, 3929, 3930, 3932, 3933, 3934, 3935, 3936, 3937, 3938, 3939, 3940, 3941, 3943, 3944, 3945, 3946, 3947, 3948, 3949, 3950, 3951, 3952, 3953, 3954, 3955, 3956, 3957, 3958, 3959, 3960, 3962, 3963, 3964, 3965, 3966, 3967, 3969, 3972, 3973, 3974, 3975, 3976, 3977, 3978, 3979, 3980, 3981, 3982, 3983, 3984, 3985, 3986, 3987, 3988, 3989, 3990, 3991, 3992, 3993, 3994, 3995, 3996, 3997, 3998, 3999, 4000, 4001, 4002, 4003, 4004, 4005, 4006, 4007, 4008, 4009, 4010, 4011, 4012, 4013, 4014, 4016, 4017, 4018, 4019, 4020, 4021, 4022, 4023, 4024, 4025, 4026, 4027, 4028, 4029, 4030, 4031, 4032, 4033, 4034, 4037, 4038, 4039, 4040, 4041, 4042, 4043, 4044, 4045, 4046, 4047, 4049, 4050, 4053, 4054, 4055, 4056, 4057, 4058, 4059, 4060, 4061, 4062, 4063, 4066, 4067, 4068, 4069, 4070, 4071, 4072, 4073, 4074, 4075, 4076, 4077, 4078, 4079, 4080, 4081, 4082, 4083, 4084, 4085, 4086, 4087, 4088, 4089, 4090, 4091, 4092, 4093, 4094, 4095, 4096, 4097, 4098, 4099, 4100, 4101, 4102, 4103, 4104, 4105, 4106, 4107, 4108, 4109, 4110, 4111, 4112, 4113, 4114, 4115, 4116, 4117, 4118, 4119, 4120, 4121, 4122, 4123, 4124, 4125, 4126, 4127, 4128, 4129, 4130, 4131, 4132, 4133, 4134, 4135, 4136, 4137, 4138, 4139, 4140, 4141, 4142, 4143, 4144, 4145, 4147, 4148, 4149, 4150, 4151, 4152, 4153, 4154, 4155, 4156, 4157, 4158, 4159, 4160, 4161, 4163, 4164, 4165, 4166, 4167, 4168, 4169, 4170, 4171, 4172, 4173, 4174, 4175, 4176, 4177, 4178, 4179, 4181, 4182, 4183, 4184, 4185, 4186, 4187, 4188, 4189, 4190, 4191, 4192, 4193, 4194, 4195, 4196, 4197, 4198, 4200, 4201, 4202, 4203, 4204, 4205, 4206, 4207, 4208, 4209, 4210, 4211, 4212, 4213, 4214, 4215, 4216, 4217, 4218, 4219, 4221, 4222, 4223, 4224, 4225, 4226, 4227, 4228, 4229, 4230, 4231, 4232, 4233, 4234, 4235, 4237, 4238, 4239, 4240, 4241, 4242, 4243, 4244, 4245, 4246, 4247, 4248, 4249, 4250, 4251, 4252, 4253, 4254, 4255, 4256, 4257, 4258, 4259, 4260, 4261, 4262, 4263, 4264, 4265, 4266, 4267, 4269, 4270, 4271, 4272, 4273, 4274, 4275, 4276, 4277, 4278, 4279, 4280, 4281, 4282, 4283, 4284, 4286, 4287, 4288, 4289, 4290, 4292, 4293, 4294, 4295, 4297, 4299, 4300, 4301, 4302, 4303, 4304, 4306, 4307, 4308, 4309, 4310, 4311, 4312, 4313, 4314, 4315, 4316, 4317, 4318, 4319, 4320, 4321, 4322, 4323, 4325, 4326, 4327, 4328, 4329, 4330, 4331, 4332, 4333, 4334, 4335, 4336, 4337, 4339, 4340, 4341, 4342, 4343, 4344, 4345, 4346, 4347, 4348, 4349, 4350, 4351, 4352, 4353, 4354, 4355, 4356, 4357, 4358, 4359, 4361, 4362, 4363, 4364, 4365, 4366, 4369, 4370, 4372, 4373, 4374, 4375, 4376, 4377, 4378, 4379, 4380, 4381, 4382, 4383, 4384, 4385, 4386, 4387, 4388, 4389, 4390, 4391, 4392, 4393, 4394, 4395, 4396, 4397, 4398, 4399, 4400, 4401, 4402, 4403, 4404, 4405, 4406, 4407, 4408, 4409, 4410, 4411, 4412, 4413, 4414, 4415, 4416, 4417, 4418, 4419, 4420, 4421, 4422, 4423, 4424, 4425, 4426, 4427, 4428, 4429, 4430, 4432, 4433, 4434, 4435, 4436, 4437, 4438, 4439, 4440, 4441, 4442, 4443, 4444, 4445, 4446, 4447, 4448, 4449, 4450, 4451, 4452, 4453, 4455, 4456, 4457, 4458, 4459, 4460, 4461, 4463, 4465, 4466, 4467, 4468, 4469, 4471, 4472, 4473, 4474, 4477, 4478, 4479, 4480, 4481, 4482, 4483, 4484, 4485, 4486, 4487, 4488, 4489, 4490, 4491, 4492, 4493, 4494, 4495, 4496, 4497, 4498, 4499, 4500, 4501, 4502, 4503, 4504, 4505, 4506, 4507, 4508, 4509, 4510, 4511, 4512, 4513, 4514, 4515, 4516, 4517, 4518, 4519, 4520, 4521, 4522, 4523, 4524, 4525, 4526, 4527, 4528, 4529, 4530, 4531, 4532, 4533, 4534, 4535, 4536, 4537, 4538, 4539, 4540, 4541, 4542, 4543, 4544, 4545, 4546, 4547, 4548, 4549, 4551, 4552, 4553, 4554, 4555, 4556, 4557, 4558, 4559, 4560, 4561, 4562, 4563, 4564, 4565, 4566, 4567, 4568, 4569, 4570, 4571, 4572, 4573, 4574, 4575, 4576, 4577, 4578, 4579, 4580, 4581, 4582, 4583, 4584, 4585, 4586, 4587, 4588, 4589, 4590, 4591, 4593, 4594, 4595, 4596, 4597, 4598, 4599, 4600, 4601, 4602, 4603, 4604, 4605, 4606, 4607, 4608, 4610, 4611, 4612, 4613, 4614, 4615, 4616, 4618, 4619, 4620, 4621, 4622, 4623, 4624, 4625, 4626, 4627, 4628, 4629, 4630, 4632, 4633, 4634, 4635, 4636, 4637, 4639, 4640, 4641, 4642, 4643, 4644, 4645, 4646, 4647, 4648, 4650, 4651, 4652, 4653, 4654, 4655, 4656, 4657, 4658, 4659, 4660, 4661, 4662, 4663, 4664, 4665, 4666, 4667, 4668, 4669, 4670, 4671, 4672, 4673, 4674, 4675, 4676, 4677, 4678, 4679, 4680, 4681, 4682, 4683, 4684, 4685, 4686, 4687, 4688, 4689, 4690, 4691, 4692, 4693, 4694, 4695, 4696, 4697, 4698, 4699, 4700, 4701, 4702, 4703, 4704, 4705, 4706, 4707, 4708, 4709, 4710, 4711, 4712, 4713, 4714, 4715, 4716, 4717, 4718, 4719, 4720, 4722, 4723, 4724, 4725, 4726, 4727, 4728, 4729, 4730, 4731, 4732, 4733, 4734, 4735, 4736, 4737, 4738, 4739, 4740, 4741, 4742, 4743, 4744, 4745, 4746, 4747, 4748, 4749, 4750, 4751, 4752, 4753, 4754, 4756, 4757, 4758, 4759, 4760, 4761, 4762, 4763, 4764, 4765, 4767, 4768, 4770, 4771, 4772, 4773, 4774, 4775, 4777, 4778, 4779, 4780, 4781, 4782, 4783, 4784, 4785, 4788, 4789, 4790, 4791, 4792, 4793, 4794, 4795, 4796, 4797, 4798, 4799, 4800, 4801, 4802, 4803, 4804, 4805, 4806, 4807, 4808, 4809, 4810, 4811, 4813, 4814, 4815, 4816, 4817, 4818, 4819, 4820, 4821, 4822, 4823, 4825, 4826, 4827, 4828, 4829, 4830, 4831, 4832, 4833, 4834, 4835, 4836, 4837, 4838, 4839, 4840, 4841, 4842, 4843, 4844, 4845, 4846, 4847, 4848, 4849, 4850, 4851, 4852, 4853, 4854, 4855, 4856, 4857, 4858, 4859, 4860, 4861, 4862, 4863, 4864, 4865, 4866, 4867, 4868, 4869, 4871, 4872, 4873, 4874, 4875, 4876, 4877, 4878, 4879, 4880, 4881, 4882, 4883, 4884, 4885, 4887, 4888, 4889, 4890, 4891, 4892, 4893, 4894, 4895, 4897, 4898, 4899, 4900, 4901, 4902, 4903, 4904, 4905, 4906, 4907, 4908, 4909, 4910, 4911, 4912, 4914, 4915, 4916, 4917, 4918, 4919, 4920, 4921, 4922, 4923, 4924, 4925, 4926, 4927, 4928, 4929, 4930, 4931, 4932, 4933, 4934, 4935, 4936, 4937, 4938, 4939, 4940, 4942, 4943, 4944, 4945, 4946, 4947, 4948, 4949, 4950, 4951, 4952, 4953, 4954, 4955, 4956, 4957, 4958, 4959, 4960, 4961, 4962, 4963, 4964, 4965, 4967, 4968, 4969, 4970, 4971, 4972, 4973, 4974, 4975, 4977, 4980, 4981, 4982, 4983, 4984, 4986, 4987, 4988, 4989, 4990, 4991, 4993, 4994, 4995, 4996, 4997, 4998, 4999, 5000, 5001, 5002, 5003, 5004, 5005, 5006, 5007, 5009, 5010, 5011, 5012, 5013, 5014, 5015, 5016, 5017, 5018, 5019, 5020, 5021, 5022, 5023, 5024, 5025, 5026, 5027, 5028, 5029, 5031, 5032, 5033, 5034, 5035, 5036, 5037, 5038, 5039, 5040, 5041, 5042, 5043, 5044, 5045, 5046, 5047, 5048, 5049, 5050, 5051, 5052, 5053, 5055, 5056, 5057, 5058, 5059, 5060, 5061, 5062, 5063, 5064, 5065, 5066, 5067, 5068, 5069, 5070, 5071, 5072, 5073, 5074, 5075, 5076, 5077, 5078, 5079, 5080, 5081, 5082, 5083, 5084, 5085, 5086, 5087, 5090, 5091, 5092, 5093, 5094, 5095, 5096, 5097, 5098, 5099, 5100, 5101, 5102, 5103, 5104, 5105, 5106, 5107, 5108, 5109, 5110, 5111, 5112, 5113, 5114, 5115, 5116, 5117, 5118, 5119, 5120, 5121, 5122, 5123, 5124, 5125, 5126, 5127, 5128, 5129, 5130, 5131, 5132, 5133, 5134, 5135, 5136, 5137, 5138, 5139, 5140, 5141, 5142, 5143, 5144, 5145, 5147, 5148, 5149, 5150, 5151, 5152, 5153, 5155, 5156, 5157, 5158, 5159, 5160, 5161, 5162, 5163, 5164, 5165, 5166, 5167, 5168, 5169, 5170, 5171, 5172, 5174, 5175, 5176, 5178, 5179, 5181, 5182, 5183, 5185, 5186, 5187, 5188, 5190, 5191, 5192, 5193, 5194, 5195, 5196, 5197, 5198, 5199, 5200, 5201, 5202, 5203, 5204, 5205, 5206, 5207, 5208, 5209, 5210, 5211, 5212, 5213, 5214, 5215, 5216, 5217, 5218, 5219, 5220, 5221, 5224, 5225, 5226, 5229, 5230, 5231, 5232, 5233, 5234, 5236, 5237, 5238, 5239, 5240, 5241, 5242, 5243, 5245, 5246, 5247, 5248, 5249, 5250, 5251, 5252, 5253, 5254, 5256, 5257, 5258, 5259, 5260, 5261, 5262, 5263, 5264, 5265, 5266, 5267, 5268, 5269, 5270, 5271, 5272, 5273, 5274, 5275, 5276, 5277, 5278, 5279, 5280, 5281, 5282, 5283, 5284, 5285, 5286, 5287, 5288, 5289, 5290, 5291, 5292, 5294, 5295, 5296, 5297, 5298, 5299, 5300, 5301, 5302, 5303, 5304, 5305, 5306, 5307, 5308, 5309, 5310, 5311, 5312, 5313, 5314, 5315, 5316, 5317, 5319, 5320, 5321, 5323, 5324, 5325, 5326, 5327, 5328, 5329, 5330, 5331, 5332, 5333, 5334, 5335, 5336, 5337, 5338, 5339, 5340, 5341, 5342, 5343, 5344, 5345, 5346, 5347, 5348, 5349, 5350, 5351, 5352, 5353, 5354, 5355, 5356, 5357, 5358, 5359, 5361, 5362, 5363, 5364, 5365, 5366, 5367, 5368, 5369, 5370, 5371, 5372, 5373, 5375, 5376, 5377, 5378, 5379, 5380, 5381, 5383, 5384, 5385, 5386, 5387, 5388, 5389, 5390, 5391, 5392, 5393, 5394, 5396, 5397, 5398, 5399, 5400, 5401, 5402, 5403, 5404, 5405, 5406, 5407, 5408, 5409, 5410, 5411, 5412, 5413, 5414, 5416, 5417, 5418, 5419, 5420, 5422, 5423, 5424, 5425, 5426, 5427, 5428, 5429, 5430, 5431, 5432, 5433, 5434, 5435, 5437, 5438, 5439, 5440, 5441, 5442, 5443, 5444, 5445, 5446, 5447, 5448, 5449, 5450, 5451, 5452, 5453, 5454, 5455, 5456, 5457, 5458, 5459, 5460, 5461, 5462, 5463, 5464, 5465, 5466, 5467, 5468, 5469, 5470, 5471, 5472, 5473, 5474, 5475, 5476, 5477, 5478, 5479, 5480, 5481, 5482, 5483, 5484, 5485, 5486, 5487, 5488, 5489, 5490, 5491, 5492, 5493, 5494, 5495, 5496, 5497, 5498, 5499, 5500, 5501, 5502, 5503, 5504, 5505, 5506, 5507, 5508, 5509, 5510, 5511, 5512, 5513, 5514, 5515, 5516, 5517, 5518, 5519, 5520, 5521, 5522, 5523, 5524, 5525, 5526, 5527, 5529, 5530, 5531, 5532, 5533, 5534, 5535, 5536, 5537, 5538, 5539, 5540, 5541, 5542, 5543, 5544, 5545, 5546, 5547, 5548, 5549, 5550, 5551, 5552, 5554, 5555, 5556, 5557, 5558, 5559, 5560, 5561, 5562, 5563, 5564, 5565, 5566, 5567, 5568, 5569, 5570, 5571, 5572, 5573, 5574, 5575, 5576, 5577, 5578, 5579, 5580, 5581, 5582, 5583, 5584, 5585, 5586, 5587, 5588, 5589, 5590, 5591, 5592, 5593, 5594, 5595, 5596, 5597, 5598, 5600, 5601, 5602, 5603, 5604, 5605, 5606, 5607, 5608, 5609, 5610, 5612, 5613, 5614, 5615, 5616, 5617, 5618, 5620, 5621, 5622, 5623, 5624, 5625, 5626, 5627, 5628, 5629, 5630, 5631, 5632, 5633, 5634, 5635, 5636, 5637, 5638, 5639, 5640, 5642, 5643, 5645, 5646, 5647, 5648, 5649, 5650, 5651, 5652, 5653, 5654, 5655, 5656, 5657, 5658, 5659, 5660, 5661, 5662, 5663, 5664, 5665, 5666, 5667, 5668, 5669, 5670, 5671, 5672, 5673, 5674, 5676, 5677, 5678, 5679, 5680, 5681, 5682, 5683, 5684, 5685, 5686, 5688, 5689, 5690, 5691, 5692, 5693, 5694, 5695, 5696, 5697, 5698, 5699, 5700, 5701, 5702, 5703, 5704, 5705, 5706, 5707, 5708, 5709, 5711, 5712, 5713, 5714, 5716, 5717, 5718, 5720, 5721, 5722, 5723, 5724, 5726, 5728, 5729, 5730, 5731, 5732, 5733, 5734, 5735, 5736, 5737, 5739, 5740, 5741, 5742, 5743, 5744, 5745, 5746, 5747, 5748, 5749, 5751, 5752, 5753, 5754, 5755, 5756, 5757, 5758, 5759, 5760, 5761, 5762, 5763, 5764, 5765, 5766, 5767, 5768, 5769, 5771, 5772, 5773, 5774, 5775, 5776, 5777, 5778, 5779, 5780, 5781, 5782, 5783, 5784, 5785, 5786, 5787, 5788, 5789, 5791, 5792, 5793, 5794, 5795, 5796, 5797, 5798, 5799, 5800, 5801, 5802, 5803, 5804, 5805, 5806, 5808, 5809, 5810, 5811, 5813, 5814, 5815, 5816, 5817, 5819, 5820, 5821, 5822, 5823, 5825, 5826, 5827, 5828, 5829, 5830, 5831, 5832, 5833, 5834, 5835, 5836, 5837, 5838, 5839, 5840, 5841, 5842, 5843, 5844, 5846, 5847, 5848, 5849, 5850, 5851, 5852, 5853, 5854, 5855, 5856, 5857, 5858, 5859, 5860, 5861, 5862, 5863, 5864, 5865, 5866, 5868, 5869, 5870, 5871, 5872, 5874, 5875, 5876, 5877, 5878, 5880, 5881, 5882, 5883, 5884, 5886, 5887, 5888, 5889, 5890, 5891, 5892, 5893, 5894, 5895, 5896, 5897, 5898, 5899, 5900, 5901, 5902, 5903, 5904, 5905, 5906, 5907, 5908, 5909, 5910, 5912, 5913, 5914, 5915, 5916, 5917, 5918, 5919, 5920, 5921, 5922, 5924, 5925, 5926, 5927, 5928, 5929, 5932, 5933, 5934, 5935, 5936, 5937, 5938, 5939, 5940, 5942, 5943, 5944, 5945, 5946, 5947, 5948, 5949, 5950, 5952, 5953, 5954, 5955, 5956, 5957, 5960, 5962, 5963, 5965, 5966, 5967, 5968, 5969, 5970, 5971, 5972, 5973, 5974, 5975, 5976, 5977, 5978, 5979, 5980, 5981, 5983, 5984, 5985, 5986, 5987, 5988, 5989, 5990, 5991, 5992, 5993, 5994, 5995, 5996, 5997, 5998, 5999, 6000, 6001, 6002, 6003, 6004, 6005, 6006, 6007, 6008, 6009, 6010, 6011, 6012, 6013, 6015, 6016, 6017, 6018, 6019, 6021, 6022, 6023, 6024, 6025, 6027, 6028, 6029, 6030, 6031, 6032, 6034, 6036, 6037, 6038, 6039, 6040, 6041, 6042, 6043, 6044, 6045, 6046, 6047, 6048, 6049, 6051, 6052, 6053, 6055, 6056, 6057, 6058, 6059, 6060, 6061, 6063, 6064, 6065, 6066, 6067, 6068, 6069, 6070, 6071, 6072, 6073, 6074, 6075, 6076, 6077, 6078, 6079, 6080, 6081, 6083, 6084, 6085, 6086, 6087, 6088, 6089, 6090, 6091, 6092, 6093, 6094, 6095, 6096, 6097, 6099, 6100, 6101, 6102, 6103, 6104, 6105, 6106, 6107, 6108, 6109, 6111, 6112, 6113, 6114, 6115, 6116, 6117, 6118, 6119, 6120, 6121, 6122, 6123, 6124, 6126, 6127, 6128, 6129, 6130, 6131, 6132, 6133, 6134, 6135, 6136, 6137, 6139, 6140, 6141, 6142, 6143, 6144, 6145, 6146, 6147, 6148, 6149, 6150, 6151, 6152, 6153, 6154, 6155, 6156, 6157, 6158, 6159, 6160, 6161, 6162, 6163, 6164, 6165, 6166, 6167, 6168, 6169, 6170, 6171, 6172, 6173, 6174, 6175, 6176, 6178, 6179, 6180, 6181, 6182, 6183, 6184, 6185, 6186, 6187, 6189, 6190, 6191, 6192, 6193, 6194, 6195, 6196, 6197, 6198, 6200, 6201, 6202, 6203, 6204, 6205, 6206, 6207, 6208, 6209, 6210, 6211, 6212, 6213, 6214, 6215, 6216, 6217, 6218, 6219, 6220, 6221, 6222, 6223, 6224, 6225, 6226, 6227, 6228, 6229, 6230, 6231, 6232, 6233, 6234, 6235, 6236, 6237, 6238, 6239, 6240, 6241, 6242, 6243, 6244, 6245, 6246, 6247, 6248, 6249, 6250, 6251, 6252, 6253, 6254, 6255, 6256, 6257, 6258, 6259, 6260, 6261, 6262, 6263, 6264, 6265, 6266, 6267, 6269, 6270, 6271, 6272, 6273, 6274, 6275, 6276, 6277, 6278, 6279, 6280, 6281, 6282, 6283, 6284, 6285, 6286, 6287, 6288, 6289, 6290, 6291, 6292, 6293, 6294, 6295, 6296, 6297, 6298, 6299, 6300, 6301, 6302, 6303, 6304, 6305, 6306, 6307, 6308, 6309, 6310, 6311, 6313, 6314, 6315, 6316, 6317, 6318, 6319, 6320, 6321, 6322, 6323, 6324, 6325, 6326, 6327, 6328, 6329, 6330, 6331, 6332, 6333, 6334, 6335, 6336, 6337, 6338, 6339, 6340, 6341, 6342, 6343, 6344, 6345, 6346, 6347, 6348, 6349, 6350, 6351, 6352, 6353, 6354, 6355, 6356, 6357, 6358, 6359, 6360, 6361, 6362, 6363, 6364, 6365, 6369, 6370, 6371, 6372, 6373, 6374, 6375, 6376, 6377, 6378, 6379, 6380, 6381, 6382, 6383, 6384, 6385, 6386, 6387, 6388, 6389, 6390, 6391, 6392, 6393, 6394, 6395, 6396, 6398, 6399, 6401, 6402, 6404, 6405, 6407, 6408, 6410, 6411, 6412, 6413, 6414, 6415, 6416, 6417, 6418, 6419, 6420, 6421, 6422, 6423, 6424, 6425, 6426, 6427, 6428, 6429, 6430, 6431, 6433, 6434, 6435, 6436, 6437, 6438, 6439, 6440, 6441, 6442, 6443, 6444, 6445, 6446, 6447, 6448, 6449, 6450, 6452, 6453, 6454, 6455, 6457, 6458, 6460, 6461, 6462, 6463, 6464, 6466, 6467, 6468, 6469, 6470, 6471, 6472, 6473, 6474, 6475, 6476, 6477, 6478, 6479, 6480, 6481, 6482, 6483, 6484, 6485, 6486, 6487, 6488, 6489, 6491, 6492, 6493, 6494, 6495, 6496, 6497, 6498, 6499, 6500, 6501, 6502, 6503, 6504, 6505, 6506, 6507, 6508, 6509, 6510, 6511, 6512, 6513, 6514, 6515, 6516, 6517, 6518, 6519, 6520, 6521, 6522, 6523, 6524, 6525, 6526, 6527, 6528, 6529, 6530, 6531, 6532, 6533, 6534, 6535, 6536, 6537, 6538, 6539, 6540, 6541, 6542, 6543, 6544, 6545, 6547, 6548, 6552, 6553, 6554, 6555, 6556, 6557, 6558, 6559, 6560, 6561, 6562, 6563, 6564, 6565, 6566, 6567, 6568, 6569, 6570, 6571, 6572, 6573, 6575, 6576, 6577, 6578, 6579, 6580, 6581, 6582, 6583, 6584, 6585, 6586, 6587, 6589, 6590, 6593, 6594, 6595, 6596, 6597, 6598, 6600, 6601, 6602, 6603, 6604, 6605, 6606, 6607, 6608, 6609, 6610, 6611, 6612, 6613, 6614, 6615, 6616, 6617, 6618, 6619, 6620, 6621, 6622, 6623, 6624, 6625, 6626, 6627, 6628, 6629, 6630, 6631, 6632, 6633, 6634, 6635, 6636, 6637, 6639, 6640, 6641, 6642, 6643, 6644, 6645, 6646, 6647, 6648, 6649, 6650, 6651, 6652, 6653, 6654, 6655, 6656, 6657, 6658, 6659, 6660, 6661, 6662, 6663, 6664, 6665, 6666, 6667, 6668, 6669, 6670, 6671, 6672, 6673, 6675, 6676, 6677, 6678, 6679, 6680, 6681, 6682, 6683, 6684, 6685, 6686, 6687, 6688, 6689, 6690, 6691, 6692, 6693, 6694, 6695, 6696, 6697, 6698, 6699, 6700, 6701, 6702, 6703, 6704, 6705, 6706, 6707, 6708, 6709, 6710, 6711, 6712, 6713, 6714, 6715, 6716, 6717, 6718, 6719, 6720, 6721, 6722, 6723, 6724, 6725, 6726, 6727, 6728, 6729, 6730, 6731, 6732, 6733, 6734, 6735, 6736, 6737, 6738, 6739, 6740, 6741, 6742, 6743, 6744, 6745, 6747, 6748, 6750, 6751, 6752, 6753, 6754, 6755, 6756, 6757, 6758, 6759, 6760, 6762, 6764, 6765, 6766, 6767, 6768, 6769, 6770, 6771, 6772, 6773, 6774, 6775, 6776, 6777, 6778, 6779, 6780, 6781, 6782, 6783, 6784, 6785, 6786, 6787, 6788, 6789, 6790, 6791, 6792, 6793}",5308
